Poker Hand #RC3795454761: Hold'em No Limit ($0.02/$0.05) - 2025/08/10 02:42:00
Table 'RushAndCash10970021' 6-max Seat #1 is the button
Seat 1: 5c225889 ($5.89 in chips)
Seat 2: 12d4819b ($11.69 in chips)
Seat 3: eb4f0463 ($5 in chips)
Seat 4: 898fba ($24.8 in chips)
Seat 5: Hero ($6.83 in chips)
Seat 6: 44d9ee4 ($5.64 in chips)
12d4819b: posts small blind $0.02
eb4f0463: posts big blind $0.05
*** HOLE CARDS ***
Dealt to 5c225889 
Dealt to 12d4819b 
Dealt to eb4f0463 
Dealt to 898fba 
Dealt to Hero [7h 7s]
Dealt to 44d9ee4 
898fba: folds
Hero: raises $0.05 to $0.1
44d9ee4: folds
5c225889: folds
12d4819b: folds
eb4f0463: folds
Uncalled bet ($0.05) returned to Hero
*** SHOWDOWN ***
Hero collected $0.12 from pot
*** SUMMARY ***
Total pot $0.12 | Rake $0 | Jackpot $0 | Bingo $0 | Fortune $0 | Tax $0
Seat 1: 5c225889 (button) folded before Flop (didn't bet)
Seat 2: 12d4819b (small blind) folded before Flop
Seat 3: eb4f0463 (big blind) folded before Flop
Seat 4: 898fba folded before Flop (didn't bet)
Seat 5: Hero collected ($0.12)
Seat 6: 44d9ee4 folded before Flop (didn't bet)


Poker Hand #RC3795424677: Hold'em No Limit ($0.02/$0.05) - 2025/08/10 02:41:46
Table 'RushAndCash10969937' 6-max Seat #1 is the button
Seat 1: 2e4c4ec9 ($5.54 in chips)
Seat 2: 906eb6e0 ($6.67 in chips)
Seat 3: f32deb6b ($8.81 in chips)
Seat 4: 9a763e3c ($15.07 in chips)
Seat 5: 19fde344 ($6.64 in chips)
Seat 6: Hero ($6.76 in chips)
906eb6e0: posts small blind $0.02
f32deb6b: posts big blind $0.05
*** HOLE CARDS ***
Dealt to 2e4c4ec9 
Dealt to 906eb6e0 
Dealt to f32deb6b 
Dealt to 9a763e3c 
Dealt to 19fde344 
Dealt to Hero [Td Tc]
9a763e3c: folds
19fde344: folds
Hero: raises $0.07 to $0.12
2e4c4ec9: folds
906eb6e0: folds
f32deb6b: folds
Uncalled bet ($0.07) returned to Hero
*** SHOWDOWN ***
Hero collected $0.12 from pot
*** SUMMARY ***
Total pot $0.12 | Rake $0 | Jackpot $0 | Bingo $0 | Fortune $0 | Tax $0
Seat 1: 2e4c4ec9 (button) folded before Flop (didn't bet)
Seat 2: 906eb6e0 (small blind) folded before Flop
Seat 3: f32deb6b (big blind) folded before Flop
Seat 4: 9a763e3c folded before Flop (didn't bet)
Seat 5: 19fde344 folded before Flop (didn't bet)
Seat 6: Hero collected ($0.12)


Poker Hand #RC3795424656: Hold'em No Limit ($0.02/$0.05) - 2025/08/10 02:41:43
Table 'RushAndCash10969916' 6-max Seat #1 is the button
Seat 1: db9525e1 ($9.39 in chips)
Seat 2: 2e4c4ec9 ($5.56 in chips)
Seat 3: c4e2527e ($7.22 in chips)
Seat 4: Hero ($6.76 in chips)
Seat 5: 9a763e3c ($15.07 in chips)
Seat 6: 12d4819b ($11.67 in chips)
2e4c4ec9: posts small blind $0.02
c4e2527e: posts big blind $0.05
*** HOLE CARDS ***
Dealt to db9525e1 
Dealt to 2e4c4ec9 
Dealt to c4e2527e 
Dealt to Hero [5h 9c]
Dealt to 9a763e3c 
Dealt to 12d4819b 
Hero: folds
9a763e3c: folds
12d4819b: raises $0.05 to $0.1
db9525e1: folds
2e4c4ec9: folds
c4e2527e: folds
Uncalled bet ($0.05) returned to 12d4819b
*** SHOWDOWN ***
12d4819b collected $0.12 from pot
*** SUMMARY ***
Total pot $0.12 | Rake $0 | Jackpot $0 | Bingo $0 | Fortune $0 | Tax $0
Seat 1: db9525e1 (button) folded before Flop (didn't bet)
Seat 2: 2e4c4ec9 (small blind) folded before Flop
Seat 3: c4e2527e (big blind) folded before Flop
Seat 4: Hero folded before Flop (didn't bet)
Seat 5: 9a763e3c folded before Flop (didn't bet)
Seat 6: 12d4819b collected ($0.12)


Poker Hand #RC3795424605: Hold'em No Limit ($0.02/$0.05) - 2025/08/10 02:41:34
Table 'RushAndCash10969865' 6-max Seat #1 is the button
Seat 1: 69f37b0e ($6.32 in chips)
Seat 2: 359b44cd ($7.59 in chips)
Seat 3: Hero ($6.74 in chips)
Seat 4: 9b0588a9 ($6.68 in chips)
Seat 5: 62d10ee ($16.05 in chips)
Seat 6: 96188863 ($5.32 in chips)
359b44cd: posts small blind $0.02
Hero: posts big blind $0.05
*** HOLE CARDS ***
Dealt to 69f37b0e 
Dealt to 359b44cd 
Dealt to Hero [6h 9h]
Dealt to 9b0588a9 
Dealt to 62d10ee 
Dealt to 96188863 
9b0588a9: folds
62d10ee: folds
96188863: folds
69f37b0e: folds
359b44cd: folds
Uncalled bet ($0.03) returned to Hero
*** SHOWDOWN ***
Hero collected $0.04 from pot
*** SUMMARY ***
Total pot $0.04 | Rake $0 | Jackpot $0 | Bingo $0 | Fortune $0 | Tax $0
Seat 1: 69f37b0e (button) folded before Flop (didn't bet)
Seat 2: 359b44cd (small blind) folded before Flop
Seat 3: Hero (big blind) collected ($0.04)
Seat 4: 9b0588a9 folded before Flop (didn't bet)
Seat 5: 62d10ee folded before Flop (didn't bet)
Seat 6: 96188863 folded before Flop (didn't bet)


Poker Hand #RC3795424540: Hold'em No Limit ($0.02/$0.05) - 2025/08/10 02:41:24
Table 'RushAndCash10969800' 6-max Seat #1 is the button
Seat 1: Hero ($6.74 in chips)
Seat 2: 2f8e24fe ($4.79 in chips)
Seat 3: 7eb01695 ($2.73 in chips)
Seat 4: a4931689 ($11.04 in chips)
Seat 5: a79d47fb ($5 in chips)
Seat 6: f32deb6b ($8.83 in chips)
2f8e24fe: posts small blind $0.02
7eb01695: posts big blind $0.05
*** HOLE CARDS ***
Dealt to Hero [2h 7c]
Dealt to 2f8e24fe 
Dealt to 7eb01695 
Dealt to a4931689 
Dealt to a79d47fb 
Dealt to f32deb6b 
a4931689: folds
a79d47fb: folds
f32deb6b: folds
Hero: folds
2f8e24fe: raises $0.08 to $0.13
7eb01695: calls $0.08
*** FLOP *** [8h Ad 9d]
2f8e24fe: bets $0.08
7eb01695: calls $0.08
*** TURN *** [8h Ad 9d] [7h]
2f8e24fe: checks
7eb01695: bets $0.42
2f8e24fe: folds
Uncalled bet ($0.42) returned to 7eb01695
*** SHOWDOWN ***
7eb01695 collected $0.4 from pot
*** SUMMARY ***
Total pot $0.42 | Rake $0.02 | Jackpot $0 | Bingo $0 | Fortune $0 | Tax $0
Board [8h Ad 9d 7h]
Seat 1: Hero (button) folded before Flop (didn't bet)
Seat 2: 2f8e24fe (small blind) folded on the Turn
Seat 3: 7eb01695 (big blind) won ($0.4)
Seat 4: a4931689 folded before Flop (didn't bet)
Seat 5: a79d47fb folded before Flop (didn't bet)
Seat 6: f32deb6b folded before Flop (didn't bet)


Poker Hand #RC3795424475: Hold'em No Limit ($0.02/$0.05) - 2025/08/10 02:41:15
Table 'RushAndCash10969735' 6-max Seat #1 is the button
Seat 1: fa9ba740 ($5 in chips)
Seat 2: Hero ($6.76 in chips)
Seat 3: 70f0529c ($6.58 in chips)
Seat 4: 1cf0a957 ($5.21 in chips)
Seat 5: 6d3c5b2a ($5.15 in chips)
Seat 6: c4e2527e ($6.81 in chips)
Hero: posts small blind $0.02
70f0529c: posts big blind $0.05
*** HOLE CARDS ***
Dealt to fa9ba740 
Dealt to Hero [Js Qh]
Dealt to 70f0529c 
Dealt to 1cf0a957 
Dealt to 6d3c5b2a 
Dealt to c4e2527e 
1cf0a957: folds
6d3c5b2a: folds
c4e2527e: raises $0.08 to $0.13
fa9ba740: calls $0.13
Hero: folds
70f0529c: folds
*** FLOP *** [Kc Th 5d]
c4e2527e: checks
fa9ba740: checks
*** TURN *** [Kc Th 5d] [9s]
c4e2527e: bets $0.25
fa9ba740: calls $0.25
*** RIVER *** [Kc Th 5d 9s] [2h]
c4e2527e: bets $0.8
fa9ba740: folds
Uncalled bet ($0.8) returned to c4e2527e
*** SHOWDOWN ***
c4e2527e collected $0.79 from pot
*** SUMMARY ***
Total pot $0.83 | Rake $0.04 | Jackpot $0 | Bingo $0 | Fortune $0 | Tax $0
Board [Kc Th 5d 9s 2h]
Seat 1: fa9ba740 (button) folded on the River
Seat 2: Hero (small blind) folded before Flop
Seat 3: 70f0529c (big blind) folded before Flop
Seat 4: 1cf0a957 folded before Flop (didn't bet)
Seat 5: 6d3c5b2a folded before Flop (didn't bet)
Seat 6: c4e2527e won ($0.79)


Poker Hand #RC3795424451: Hold'em No Limit ($0.02/$0.05) - 2025/08/10 02:41:11
Table 'RushAndCash10969711' 6-max Seat #1 is the button
Seat 1: deda3364 ($5.16 in chips)
Seat 2: a18f15bd ($5.18 in chips)
Seat 3: bc3d0893 ($10.37 in chips)
Seat 4: b028db6a ($5 in chips)
Seat 5: 69f37b0e ($6.39 in chips)
Seat 6: Hero ($6.76 in chips)
a18f15bd: posts small blind $0.02
bc3d0893: posts big blind $0.05
*** HOLE CARDS ***
Dealt to deda3364 
Dealt to a18f15bd 
Dealt to bc3d0893 
Dealt to b028db6a 
Dealt to 69f37b0e 
Dealt to Hero [8s 2h]
b028db6a: folds
69f37b0e: folds
Hero: folds
deda3364: folds
a18f15bd: raises $0.1 to $0.15
bc3d0893: folds
Uncalled bet ($0.1) returned to a18f15bd
*** SHOWDOWN ***
a18f15bd collected $0.1 from pot
*** SUMMARY ***
Total pot $0.1 | Rake $0 | Jackpot $0 | Bingo $0 | Fortune $0 | Tax $0
Seat 1: deda3364 (button) folded before Flop (didn't bet)
Seat 2: a18f15bd (small blind) collected ($0.1)
Seat 3: bc3d0893 (big blind) folded before Flop
Seat 4: b028db6a folded before Flop (didn't bet)
Seat 5: 69f37b0e folded before Flop (didn't bet)
Seat 6: Hero folded before Flop (didn't bet)


Poker Hand #RC3795424430: Hold'em No Limit ($0.02/$0.05) - 2025/08/10 02:41:07
Table 'RushAndCash10969690' 6-max Seat #1 is the button
Seat 1: 96188863 ($5.32 in chips)
Seat 2: f7b1defe ($10.99 in chips)
Seat 3: 9ae88339 ($2.37 in chips)
Seat 4: Hero ($6.76 in chips)
Seat 5: deda3364 ($5.16 in chips)
Seat 6: c251cc1b ($4.6 in chips)
f7b1defe: posts small blind $0.02
9ae88339: posts big blind $0.05
*** HOLE CARDS ***
Dealt to 96188863 
Dealt to f7b1defe 
Dealt to 9ae88339 
Dealt to Hero [Ad 7c]
Dealt to deda3364 
Dealt to c251cc1b 
Hero: folds
deda3364: folds
c251cc1b: folds
96188863: folds
f7b1defe: folds
Uncalled bet ($0.03) returned to 9ae88339
*** SHOWDOWN ***
9ae88339 collected $0.04 from pot
*** SUMMARY ***
Total pot $0.04 | Rake $0 | Jackpot $0 | Bingo $0 | Fortune $0 | Tax $0
Seat 1: 96188863 (button) folded before Flop (didn't bet)
Seat 2: f7b1defe (small blind) folded before Flop
Seat 3: 9ae88339 (big blind) collected ($0.04)
Seat 4: Hero folded before Flop (didn't bet)
Seat 5: deda3364 folded before Flop (didn't bet)
Seat 6: c251cc1b folded before Flop (didn't bet)


Poker Hand #RC3795424408: Hold'em No Limit ($0.02/$0.05) - 2025/08/10 02:41:04
Table 'RushAndCash10969668' 6-max Seat #1 is the button
Seat 1: 9a205ab3 ($5 in chips)
Seat 2: 3ceb324 ($5.34 in chips)
Seat 3: cfdc3190 ($4.61 in chips)
Seat 4: 13f80275 ($7.21 in chips)
Seat 5: d1e5e132 ($7.17 in chips)
Seat 6: Hero ($6.76 in chips)
3ceb324: posts small blind $0.02
cfdc3190: posts big blind $0.05
*** HOLE CARDS ***
Dealt to 9a205ab3 
Dealt to 3ceb324 
Dealt to cfdc3190 
Dealt to 13f80275 
Dealt to d1e5e132 
Dealt to Hero [Kd 7s]
13f80275: folds
d1e5e132: folds
Hero: folds
9a205ab3: raises $0.1 to $0.15
3ceb324: raises $0.27 to $0.42
cfdc3190: folds
9a205ab3: calls $0.27
*** FLOP *** [2c 9s Ts]
3ceb324: bets $0.68
9a205ab3: calls $0.68
*** TURN *** [2c 9s Ts] [Js]
3ceb324: checks
9a205ab3: bets $1.13
3ceb324: calls $1.13
*** RIVER *** [2c 9s Ts Js] [7h]
3ceb324: checks
9a205ab3: bets $2.77 and is all-in
3ceb324: calls $2.77
9a205ab3: shows [9c 8c] (a straight, Jack to Seven)
3ceb324: shows [Th Ah] (a pair of Tens)
*** SHOWDOWN ***
9a205ab3 collected $9.83 from pot
*** SUMMARY ***
Total pot $10.05 | Rake $0.15 | Jackpot $0.07 | Bingo $0 | Fortune $0 | Tax $0
Board [2c 9s Ts Js 7h]
Seat 1: 9a205ab3 (button) showed [9c 8c] and won ($9.83) with a straight, Jack to Seven
Seat 2: 3ceb324 (small blind) showed [Th Ah] and lost with a pair of Tens
Seat 3: cfdc3190 (big blind) folded before Flop
Seat 4: 13f80275 folded before Flop (didn't bet)
Seat 5: d1e5e132 folded before Flop (didn't bet)
Seat 6: Hero folded before Flop (didn't bet)


Poker Hand #RC3795424382: Hold'em No Limit ($0.02/$0.05) - 2025/08/10 02:41:00
Table 'RushAndCash10969642' 6-max Seat #1 is the button
Seat 1: Hero ($6.76 in chips)
Seat 2: 9a205ab3 ($4.95 in chips)
Seat 3: 13f80275 ($7.26 in chips)
Seat 4: 2732db68 ($6.84 in chips)
Seat 5: 25345929 ($8 in chips)
Seat 6: 15876d02 ($7.87 in chips)
9a205ab3: posts small blind $0.02
13f80275: posts big blind $0.05
*** HOLE CARDS ***
Dealt to Hero [As 4c]
Dealt to 9a205ab3 
Dealt to 13f80275 
Dealt to 2732db68 
Dealt to 25345929 
Dealt to 15876d02 
2732db68: folds
25345929: folds
15876d02: folds
Hero: folds
9a205ab3: folds
Uncalled bet ($0.03) returned to 13f80275
*** SHOWDOWN ***
13f80275 collected $0.04 from pot
*** SUMMARY ***
Total pot $0.04 | Rake $0 | Jackpot $0 | Bingo $0 | Fortune $0 | Tax $0
Seat 1: Hero (button) folded before Flop (didn't bet)
Seat 2: 9a205ab3 (small blind) folded before Flop
Seat 3: 13f80275 (big blind) collected ($0.04)
Seat 4: 2732db68 folded before Flop (didn't bet)
Seat 5: 25345929 folded before Flop (didn't bet)
Seat 6: 15876d02 folded before Flop (didn't bet)


Poker Hand #RC3795424282: Hold'em No Limit ($0.02/$0.05) - 2025/08/10 02:40:44
Table 'RushAndCash10969542' 6-max Seat #1 is the button
Seat 1: 76ef6bc6 ($11.05 in chips)
Seat 2: 3845acf7 ($6.19 in chips)
Seat 3: Hero ($6.74 in chips)
Seat 4: fe45ce43 ($6.18 in chips)
Seat 5: 52f9d0bb ($4.58 in chips)
Seat 6: 3ceb324 ($5.41 in chips)
3845acf7: posts small blind $0.02
Hero: posts big blind $0.05
*** HOLE CARDS ***
Dealt to 76ef6bc6 
Dealt to 3845acf7 
Dealt to Hero [As Ac]
Dealt to fe45ce43 
Dealt to 52f9d0bb 
Dealt to 3ceb324 
fe45ce43: folds
52f9d0bb: folds
3ceb324: folds
76ef6bc6: folds
3845acf7: folds
Uncalled bet ($0.03) returned to Hero
*** SHOWDOWN ***
Hero collected $0.04 from pot
*** SUMMARY ***
Total pot $0.04 | Rake $0 | Jackpot $0 | Bingo $0 | Fortune $0 | Tax $0
Seat 1: 76ef6bc6 (button) folded before Flop (didn't bet)
Seat 2: 3845acf7 (small blind) folded before Flop
Seat 3: Hero (big blind) collected ($0.04)
Seat 4: fe45ce43 folded before Flop (didn't bet)
Seat 5: 52f9d0bb folded before Flop (didn't bet)
Seat 6: 3ceb324 folded before Flop (didn't bet)


Poker Hand #RC3795424103: Hold'em No Limit ($0.02/$0.05) - 2025/08/10 02:40:15
Table 'RushAndCash10969363' 6-max Seat #1 is the button
Seat 1: 3845acf7 ($6.24 in chips)
Seat 2: Hero ($6.76 in chips)
Seat 3: 3312dab0 ($5.14 in chips)
Seat 4: 2a09ebf1 ($4.76 in chips)
Seat 5: 35c8517c ($14.47 in chips)
Seat 6: 2e4c4ec9 ($5.67 in chips)
Hero: posts small blind $0.02
3312dab0: posts big blind $0.05
*** HOLE CARDS ***
Dealt to 3845acf7 
Dealt to Hero [Jc 7s]
Dealt to 3312dab0 
Dealt to 2a09ebf1 
Dealt to 35c8517c 
Dealt to 2e4c4ec9 
2a09ebf1: folds
35c8517c: folds
2e4c4ec9: raises $0.08 to $0.13
3845acf7: folds
Hero: folds
3312dab0: folds
Uncalled bet ($0.08) returned to 2e4c4ec9
*** SHOWDOWN ***
2e4c4ec9 collected $0.12 from pot
*** SUMMARY ***
Total pot $0.12 | Rake $0 | Jackpot $0 | Bingo $0 | Fortune $0 | Tax $0
Seat 1: 3845acf7 (button) folded before Flop (didn't bet)
Seat 2: Hero (small blind) folded before Flop
Seat 3: 3312dab0 (big blind) folded before Flop
Seat 4: 2a09ebf1 folded before Flop (didn't bet)
Seat 5: 35c8517c folded before Flop (didn't bet)
Seat 6: 2e4c4ec9 collected ($0.12)


Poker Hand #RC3795424083: Hold'em No Limit ($0.02/$0.05) - 2025/08/10 02:40:12
Table 'RushAndCash10969343' 6-max Seat #1 is the button
Seat 1: e1c62858 ($5 in chips)
Seat 2: 3ceb324 ($4.95 in chips)
Seat 3: be5fe617 ($7.19 in chips)
Seat 4: Hero ($6.76 in chips)
Seat 5: 7a3d6a27 ($7.14 in chips)
Seat 6: 12d4819b ($12.63 in chips)
3ceb324: posts small blind $0.02
be5fe617: posts big blind $0.05
*** HOLE CARDS ***
Dealt to e1c62858 
Dealt to 3ceb324 
Dealt to be5fe617 
Dealt to Hero [6c 7d]
Dealt to 7a3d6a27 
Dealt to 12d4819b 
Hero: folds
7a3d6a27: raises $0.05 to $0.1
12d4819b: folds
e1c62858: raises $0.25 to $0.35
3ceb324: raises $0.65 to $1
be5fe617: folds
7a3d6a27: folds
e1c62858: folds
Uncalled bet ($0.65) returned to 3ceb324
*** SHOWDOWN ***
3ceb324 collected $0.81 from pot
*** SUMMARY ***
Total pot $0.85 | Rake $0.04 | Jackpot $0 | Bingo $0 | Fortune $0 | Tax $0
Seat 1: e1c62858 (button) folded before Flop
Seat 2: 3ceb324 (small blind) collected ($0.81)
Seat 3: be5fe617 (big blind) folded before Flop
Seat 4: Hero folded before Flop (didn't bet)
Seat 5: 7a3d6a27 folded before Flop
Seat 6: 12d4819b folded before Flop (didn't bet)


Poker Hand #RC3795424000: Hold'em No Limit ($0.02/$0.05) - 2025/08/10 02:39:58
Table 'RushAndCash10969260' 6-max Seat #1 is the button
Seat 1: 60cfb239 ($5.09 in chips)
Seat 2: Hero ($6.78 in chips)
Seat 3: c4e2527e ($6.79 in chips)
Seat 4: 48ecb088 ($5.02 in chips)
Seat 5: 6cbc6d8b ($5.54 in chips)
Seat 6: ad44a40 ($5.91 in chips)
Hero: posts small blind $0.02
c4e2527e: posts big blind $0.05
*** HOLE CARDS ***
Dealt to 60cfb239 
Dealt to Hero [9s Th]
Dealt to c4e2527e 
Dealt to 48ecb088 
Dealt to 6cbc6d8b 
Dealt to ad44a40 
48ecb088: folds
6cbc6d8b: folds
ad44a40: folds
60cfb239: raises $0.1 to $0.15
Hero: folds
c4e2527e: folds
Uncalled bet ($0.1) returned to 60cfb239
*** SHOWDOWN ***
60cfb239 collected $0.12 from pot
*** SUMMARY ***
Total pot $0.12 | Rake $0 | Jackpot $0 | Bingo $0 | Fortune $0 | Tax $0
Seat 1: 60cfb239 (button) collected ($0.12)
Seat 2: Hero (small blind) folded before Flop
Seat 3: c4e2527e (big blind) folded before Flop
Seat 4: 48ecb088 folded before Flop (didn't bet)
Seat 5: 6cbc6d8b folded before Flop (didn't bet)
Seat 6: ad44a40 folded before Flop (didn't bet)


Poker Hand #RC3795423903: Hold'em No Limit ($0.02/$0.05) - 2025/08/10 02:39:44
Table 'RushAndCash10969163' 6-max Seat #1 is the button
Seat 1: 7d912640 ($5.53 in chips)
Seat 2: 315464e9 ($5.29 in chips)
Seat 3: 5e31bb77 ($6.63 in chips)
Seat 4: 67a27620 ($5.07 in chips)
Seat 5: 48ecb088 ($5.07 in chips)
Seat 6: Hero ($6.71 in chips)
315464e9: posts small blind $0.02
5e31bb77: posts big blind $0.05
*** HOLE CARDS ***
Dealt to 7d912640 
Dealt to 315464e9 
Dealt to 5e31bb77 
Dealt to 67a27620 
Dealt to 48ecb088 
Dealt to Hero [Th Ac]
67a27620: folds
48ecb088: folds
Hero: raises $0.05 to $0.1
7d912640: folds
315464e9: folds
5e31bb77: folds
Uncalled bet ($0.05) returned to Hero
*** SHOWDOWN ***
Hero collected $0.12 from pot
*** SUMMARY ***
Total pot $0.12 | Rake $0 | Jackpot $0 | Bingo $0 | Fortune $0 | Tax $0
Seat 1: 7d912640 (button) folded before Flop (didn't bet)
Seat 2: 315464e9 (small blind) folded before Flop
Seat 3: 5e31bb77 (big blind) folded before Flop
Seat 4: 67a27620 folded before Flop (didn't bet)
Seat 5: 48ecb088 folded before Flop (didn't bet)
Seat 6: Hero collected ($0.12)


Poker Hand #RC3795423880: Hold'em No Limit ($0.02/$0.05) - 2025/08/10 02:39:40
Table 'RushAndCash10969140' 6-max Seat #1 is the button
Seat 1: 523369bf ($12.32 in chips)
Seat 2: 44d9ee4 ($5 in chips)
Seat 3: 7f4505d6 ($12.88 in chips)
Seat 4: Hero ($6.71 in chips)
Seat 5: 67a27620 ($5.07 in chips)
Seat 6: 15e16149 ($8.89 in chips)
44d9ee4: posts small blind $0.02
7f4505d6: posts big blind $0.05
*** HOLE CARDS ***
Dealt to 523369bf 
Dealt to 44d9ee4 
Dealt to 7f4505d6 
Dealt to Hero [3s Th]
Dealt to 67a27620 
Dealt to 15e16149 
Hero: folds
67a27620: folds
15e16149: folds
523369bf: folds
44d9ee4: folds
Uncalled bet ($0.03) returned to 7f4505d6
*** SHOWDOWN ***
7f4505d6 collected $0.04 from pot
*** SUMMARY ***
Total pot $0.04 | Rake $0 | Jackpot $0 | Bingo $0 | Fortune $0 | Tax $0
Seat 1: 523369bf (button) folded before Flop (didn't bet)
Seat 2: 44d9ee4 (small blind) folded before Flop
Seat 3: 7f4505d6 (big blind) collected ($0.04)
Seat 4: Hero folded before Flop (didn't bet)
Seat 5: 67a27620 folded before Flop (didn't bet)
Seat 6: 15e16149 folded before Flop (didn't bet)


Poker Hand #RC3795423857: Hold'em No Limit ($0.02/$0.05) - 2025/08/10 02:39:37
Table 'RushAndCash10969117' 6-max Seat #1 is the button
Seat 1: cc57fc1c ($13.74 in chips)
Seat 2: aeb0c7eb ($5 in chips)
Seat 3: b1603441 ($4.61 in chips)
Seat 4: 8942fed5 ($5 in chips)
Seat 5: Hero ($6.71 in chips)
Seat 6: 89ac170c ($5 in chips)
aeb0c7eb: posts small blind $0.02
b1603441: posts big blind $0.05
*** HOLE CARDS ***
Dealt to cc57fc1c 
Dealt to aeb0c7eb 
Dealt to b1603441 
Dealt to 8942fed5 
Dealt to Hero [8c 2c]
Dealt to 89ac170c 
8942fed5: folds
Hero: folds
89ac170c: raises $0.1 to $0.15
cc57fc1c: folds
aeb0c7eb: folds
b1603441: folds
Uncalled bet ($0.1) returned to 89ac170c
*** SHOWDOWN ***
89ac170c collected $0.12 from pot
*** SUMMARY ***
Total pot $0.12 | Rake $0 | Jackpot $0 | Bingo $0 | Fortune $0 | Tax $0
Seat 1: cc57fc1c (button) folded before Flop (didn't bet)
Seat 2: aeb0c7eb (small blind) folded before Flop
Seat 3: b1603441 (big blind) folded before Flop
Seat 4: 8942fed5 folded before Flop (didn't bet)
Seat 5: Hero folded before Flop (didn't bet)
Seat 6: 89ac170c collected ($0.12)


Poker Hand #RC3795423698: Hold'em No Limit ($0.02/$0.05) - 2025/08/10 02:39:14
Table 'RushAndCash10968958' 6-max Seat #1 is the button
Seat 1: ce517e5d ($12.62 in chips)
Seat 2: 4457b6b0 ($4.76 in chips)
Seat 3: Hero ($6.76 in chips)
Seat 4: a5ec80d6 ($3.73 in chips)
Seat 5: 4675642c ($19.41 in chips)
Seat 6: 315464e9 ($5.27 in chips)
4457b6b0: posts small blind $0.02
Hero: posts big blind $0.05
*** HOLE CARDS ***
Dealt to ce517e5d 
Dealt to 4457b6b0 
Dealt to Hero [6d 5c]
Dealt to a5ec80d6 
Dealt to 4675642c 
Dealt to 315464e9 
a5ec80d6: calls $0.05
4675642c: folds
315464e9: folds
ce517e5d: raises $0.05 to $0.1
4457b6b0: calls $0.08
Hero: folds
a5ec80d6: calls $0.05
*** FLOP *** [3c 4h Tc]
4457b6b0: bets $0.18
a5ec80d6: folds
ce517e5d: calls $0.18
*** TURN *** [3c 4h Tc] [7s]
4457b6b0: bets $0.47
ce517e5d: folds
Uncalled bet ($0.47) returned to 4457b6b0
*** SHOWDOWN ***
4457b6b0 collected $0.68 from pot
*** SUMMARY ***
Total pot $0.71 | Rake $0.03 | Jackpot $0 | Bingo $0 | Fortune $0 | Tax $0
Board [3c 4h Tc 7s]
Seat 1: ce517e5d (button) folded on the Turn
Seat 2: 4457b6b0 (small blind) won ($0.68)
Seat 3: Hero (big blind) folded before Flop
Seat 4: a5ec80d6 folded on the Flop
Seat 5: 4675642c folded before Flop (didn't bet)
Seat 6: 315464e9 folded before Flop (didn't bet)


Poker Hand #RC3795423674: Hold'em No Limit ($0.02/$0.05) - 2025/08/10 02:39:10
Table 'RushAndCash10968934' 6-max Seat #1 is the button
Seat 1: f1205850 ($6.99 in chips)
Seat 2: 2e4c4ec9 ($5.53 in chips)
Seat 3: ad44a40 ($5.84 in chips)
Seat 4: a87b0500 ($8.76 in chips)
Seat 5: cc20b970 ($8.79 in chips)
Seat 6: Hero ($6.76 in chips)
2e4c4ec9: posts small blind $0.02
ad44a40: posts big blind $0.05
*** HOLE CARDS ***
Dealt to f1205850 
Dealt to 2e4c4ec9 
Dealt to ad44a40 
Dealt to a87b0500 
Dealt to cc20b970 
Dealt to Hero [7d Kc]
a87b0500: folds
cc20b970: folds
Hero: folds
f1205850: folds
2e4c4ec9: folds
Uncalled bet ($0.03) returned to ad44a40
*** SHOWDOWN ***
ad44a40 collected $0.04 from pot
*** SUMMARY ***
Total pot $0.04 | Rake $0 | Jackpot $0 | Bingo $0 | Fortune $0 | Tax $0
Seat 1: f1205850 (button) folded before Flop (didn't bet)
Seat 2: 2e4c4ec9 (small blind) folded before Flop
Seat 3: ad44a40 (big blind) collected ($0.04)
Seat 4: a87b0500 folded before Flop (didn't bet)
Seat 5: cc20b970 folded before Flop (didn't bet)
Seat 6: Hero folded before Flop (didn't bet)


Poker Hand #RC3795423651: Hold'em No Limit ($0.02/$0.05) - 2025/08/10 02:39:07
Table 'RushAndCash10968911' 6-max Seat #1 is the button
Seat 1: ad44a40 ($5.84 in chips)
Seat 2: f3a1d090 ($19.08 in chips)
Seat 3: 1d709ff6 ($10.37 in chips)
Seat 4: 3aa4969b ($9.31 in chips)
Seat 5: Hero ($6.76 in chips)
Seat 6: e8a0a52a ($6.92 in chips)
f3a1d090: posts small blind $0.02
1d709ff6: posts big blind $0.05
*** HOLE CARDS ***
Dealt to ad44a40 
Dealt to f3a1d090 
Dealt to 1d709ff6 
Dealt to 3aa4969b 
Dealt to Hero [Qs 5c]
Dealt to e8a0a52a 
3aa4969b: raises $0.05 to $0.1
Hero: folds
e8a0a52a: folds
ad44a40: folds
f3a1d090: folds
1d709ff6: folds
Uncalled bet ($0.05) returned to 3aa4969b
*** SHOWDOWN ***
3aa4969b collected $0.12 from pot
*** SUMMARY ***
Total pot $0.12 | Rake $0 | Jackpot $0 | Bingo $0 | Fortune $0 | Tax $0
Seat 1: ad44a40 (button) folded before Flop (didn't bet)
Seat 2: f3a1d090 (small blind) folded before Flop
Seat 3: 1d709ff6 (big blind) folded before Flop
Seat 4: 3aa4969b collected ($0.12)
Seat 5: Hero folded before Flop (didn't bet)
Seat 6: e8a0a52a folded before Flop (didn't bet)


Poker Hand #RC3795423618: Hold'em No Limit ($0.02/$0.05) - 2025/08/10 02:39:01
Table 'RushAndCash10968878' 6-max Seat #1 is the button
Seat 1: 8eb4f6f7 ($4.05 in chips)
Seat 2: ee9eafe3 ($29.06 in chips)
Seat 3: 679c5ea0 ($12.92 in chips)
Seat 4: e962cf1d ($7.62 in chips)
Seat 5: 429f221 ($5.45 in chips)
Seat 6: Hero ($6.76 in chips)
ee9eafe3: posts small blind $0.02
679c5ea0: posts big blind $0.05
*** HOLE CARDS ***
Dealt to 8eb4f6f7 
Dealt to ee9eafe3 
Dealt to 679c5ea0 
Dealt to e962cf1d 
Dealt to 429f221 
Dealt to Hero [9h Kc]
e962cf1d: folds
429f221: raises $0.05 to $0.1
Hero: folds
8eb4f6f7: folds
ee9eafe3: raises $0.4 to $0.5
679c5ea0: folds
429f221: folds
Uncalled bet ($0.4) returned to ee9eafe3
*** SHOWDOWN ***
ee9eafe3 collected $0.24 from pot
*** SUMMARY ***
Total pot $0.25 | Rake $0.01 | Jackpot $0 | Bingo $0 | Fortune $0 | Tax $0
Seat 1: 8eb4f6f7 (button) folded before Flop (didn't bet)
Seat 2: ee9eafe3 (small blind) collected ($0.24)
Seat 3: 679c5ea0 (big blind) folded before Flop
Seat 4: e962cf1d folded before Flop (didn't bet)
Seat 5: 429f221 folded before Flop
Seat 6: Hero folded before Flop (didn't bet)


Poker Hand #RC3795423522: Hold'em No Limit ($0.02/$0.05) - 2025/08/10 02:38:48
Table 'RushAndCash10968782' 6-max Seat #1 is the button
Seat 1: Hero ($6.76 in chips)
Seat 2: fec61aab ($5 in chips)
Seat 3: 770f0b4a ($5 in chips)
Seat 4: 298d3f9f ($1.41 in chips)
Seat 5: bdbf5ebc ($5.67 in chips)
Seat 6: 19fde344 ($5 in chips)
fec61aab: posts small blind $0.02
770f0b4a: posts big blind $0.05
*** HOLE CARDS ***
Dealt to Hero [3d 4s]
Dealt to fec61aab 
Dealt to 770f0b4a 
Dealt to 298d3f9f 
Dealt to bdbf5ebc 
Dealt to 19fde344 
298d3f9f: folds
bdbf5ebc: folds
19fde344: folds
Hero: folds
fec61aab: folds
Uncalled bet ($0.03) returned to 770f0b4a
*** SHOWDOWN ***
770f0b4a collected $0.04 from pot
*** SUMMARY ***
Total pot $0.04 | Rake $0 | Jackpot $0 | Bingo $0 | Fortune $0 | Tax $0
Seat 1: Hero (button) folded before Flop (didn't bet)
Seat 2: fec61aab (small blind) folded before Flop
Seat 3: 770f0b4a (big blind) collected ($0.04)
Seat 4: 298d3f9f folded before Flop (didn't bet)
Seat 5: bdbf5ebc folded before Flop (didn't bet)
Seat 6: 19fde344 folded before Flop (didn't bet)


Poker Hand #RC3795423498: Hold'em No Limit ($0.02/$0.05) - 2025/08/10 02:38:45
Table 'RushAndCash10968758' 6-max Seat #1 is the button
Seat 1: 298d3f9f ($1.41 in chips)
Seat 2: d15704b8 ($5.25 in chips)
Seat 3: cc57fc1c ($13.81 in chips)
Seat 4: Hero ($6.76 in chips)
Seat 5: f4f482ee ($6.54 in chips)
Seat 6: a731f2b4 ($4.17 in chips)
d15704b8: posts small blind $0.02
cc57fc1c: posts big blind $0.05
*** HOLE CARDS ***
Dealt to 298d3f9f 
Dealt to d15704b8 
Dealt to cc57fc1c 
Dealt to Hero [4h 7h]
Dealt to f4f482ee 
Dealt to a731f2b4 
Hero: folds
f4f482ee: folds
a731f2b4: folds
298d3f9f: folds
d15704b8: folds
Uncalled bet ($0.03) returned to cc57fc1c
*** SHOWDOWN ***
cc57fc1c collected $0.04 from pot
*** SUMMARY ***
Total pot $0.04 | Rake $0 | Jackpot $0 | Bingo $0 | Fortune $0 | Tax $0
Seat 1: 298d3f9f (button) folded before Flop (didn't bet)
Seat 2: d15704b8 (small blind) folded before Flop
Seat 3: cc57fc1c (big blind) collected ($0.04)
Seat 4: Hero folded before Flop (didn't bet)
Seat 5: f4f482ee folded before Flop (didn't bet)
Seat 6: a731f2b4 folded before Flop (didn't bet)


Poker Hand #RC3795423206: Hold'em No Limit ($0.02/$0.05) - 2025/08/10 02:38:02
Table 'RushAndCash10968466' 6-max Seat #1 is the button
Seat 1: ab02685 ($5.04 in chips)
Seat 2: Hero ($6.52 in chips)
Seat 3: edae21a ($5.32 in chips)
Seat 4: 3389168b ($6.99 in chips)
Seat 5: a579ea8 ($5.5 in chips)
Seat 6: 23bfa7da ($3.36 in chips)
Hero: posts small blind $0.02
edae21a: posts big blind $0.05
*** HOLE CARDS ***
Dealt to ab02685 
Dealt to Hero [As Ah]
Dealt to edae21a 
Dealt to 3389168b 
Dealt to a579ea8 
Dealt to 23bfa7da 
3389168b: raises $0.05 to $0.1
a579ea8: folds
23bfa7da: calls $0.1
ab02685: folds
Hero: raises $0.46 to $0.56
edae21a: folds
3389168b: folds
23bfa7da: folds
Uncalled bet ($0.46) returned to Hero
*** SHOWDOWN ***
Hero collected $0.34 from pot
*** SUMMARY ***
Total pot $0.35 | Rake $0.01 | Jackpot $0 | Bingo $0 | Fortune $0 | Tax $0
Seat 1: ab02685 (button) folded before Flop (didn't bet)
Seat 2: Hero (small blind) collected ($0.34)
Seat 3: edae21a (big blind) folded before Flop
Seat 4: 3389168b folded before Flop
Seat 5: a579ea8 folded before Flop (didn't bet)
Seat 6: 23bfa7da folded before Flop


Poker Hand #RC3795423110: Hold'em No Limit ($0.02/$0.05) - 2025/08/10 02:37:47
Table 'RushAndCash10968370' 6-max Seat #1 is the button
Seat 1: b547ce1 ($5.22 in chips)
Seat 2: 8eb4f6f7 ($4.03 in chips)
Seat 3: Hero ($6.57 in chips)
Seat 4: e70deab3 ($5.83 in chips)
Seat 5: eae61b73 ($3.26 in chips)
Seat 6: 9e65ff8b ($5.48 in chips)
8eb4f6f7: posts small blind $0.02
Hero: posts big blind $0.05
*** HOLE CARDS ***
Dealt to b547ce1 
Dealt to 8eb4f6f7 
Dealt to Hero [Jc Kh]
Dealt to e70deab3 
Dealt to eae61b73 
Dealt to 9e65ff8b 
e70deab3: folds
eae61b73: folds
9e65ff8b: folds
b547ce1: raises $0.07 to $0.12
8eb4f6f7: raises $0.38 to $0.5
Hero: folds
b547ce1: folds
Uncalled bet ($0.38) returned to 8eb4f6f7
*** SHOWDOWN ***
8eb4f6f7 collected $0.28 from pot
*** SUMMARY ***
Total pot $0.29 | Rake $0.01 | Jackpot $0 | Bingo $0 | Fortune $0 | Tax $0
Seat 1: b547ce1 (button) folded before Flop
Seat 2: 8eb4f6f7 (small blind) collected ($0.28)
Seat 3: Hero (big blind) folded before Flop
Seat 4: e70deab3 folded before Flop (didn't bet)
Seat 5: eae61b73 folded before Flop (didn't bet)
Seat 6: 9e65ff8b folded before Flop (didn't bet)


Poker Hand #RC3795423086: Hold'em No Limit ($0.02/$0.05) - 2025/08/10 02:37:44
Table 'RushAndCash10968346' 6-max Seat #1 is the button
Seat 1: 120d1136 ($5.9 in chips)
Seat 2: b547ce1 ($5.24 in chips)
Seat 3: fec61aab ($5.1 in chips)
Seat 4: de8926d5 ($11.53 in chips)
Seat 5: 8eb4f6f7 ($4.03 in chips)
Seat 6: Hero ($6.57 in chips)
b547ce1: posts small blind $0.02
fec61aab: posts big blind $0.05
*** HOLE CARDS ***
Dealt to 120d1136 
Dealt to b547ce1 
Dealt to fec61aab 
Dealt to de8926d5 
Dealt to 8eb4f6f7 
Dealt to Hero [6s 8h]
de8926d5: folds
8eb4f6f7: folds
Hero: folds
120d1136: folds
b547ce1: folds
Uncalled bet ($0.03) returned to fec61aab
*** SHOWDOWN ***
fec61aab collected $0.04 from pot
*** SUMMARY ***
Total pot $0.04 | Rake $0 | Jackpot $0 | Bingo $0 | Fortune $0 | Tax $0
Seat 1: 120d1136 (button) folded before Flop (didn't bet)
Seat 2: b547ce1 (small blind) folded before Flop
Seat 3: fec61aab (big blind) collected ($0.04)
Seat 4: de8926d5 folded before Flop (didn't bet)
Seat 5: 8eb4f6f7 folded before Flop (didn't bet)
Seat 6: Hero folded before Flop (didn't bet)


Poker Hand #RC3795422761: Hold'em No Limit ($0.02/$0.05) - 2025/08/10 02:36:52
Table 'RushAndCash10968021' 6-max Seat #1 is the button
Seat 1: Hero ($6.57 in chips)
Seat 2: 5a0773bb ($5.02 in chips)
Seat 3: b547ce1 ($5.24 in chips)
Seat 4: a81f69c5 ($2.3 in chips)
Seat 5: cc73acc1 ($5.07 in chips)
Seat 6: 37577f88 ($5.07 in chips)
5a0773bb: posts small blind $0.02
b547ce1: posts big blind $0.05
*** HOLE CARDS ***
Dealt to Hero [Ah 5c]
Dealt to 5a0773bb 
Dealt to b547ce1 
Dealt to a81f69c5 
Dealt to cc73acc1 
Dealt to 37577f88 
a81f69c5: folds
cc73acc1: folds
37577f88: folds
Hero: raises $0.05 to $0.1
5a0773bb: folds
b547ce1: calls $0.05
*** FLOP *** [Ac Jd 9d]
b547ce1: checks
Hero: checks
*** TURN *** [Ac Jd 9d] [7h]
b547ce1: bets $0.16
Hero: calls $0.16
*** RIVER *** [Ac Jd 9d 7h] [Js]
b547ce1: checks
Hero: checks
b547ce1: shows [As 4c] (two pair, Aces and Jacks)
Hero: shows [Ah 5c] (two pair, Aces and Jacks)
*** SHOWDOWN ***
b547ce1 collected $0.26 from pot
Hero collected $0.26 from pot
*** SUMMARY ***
Total pot $0.54 | Rake $0.02 | Jackpot $0 | Bingo $0 | Fortune $0 | Tax $0
Board [Ac Jd 9d 7h Js]
Seat 1: Hero (button) showed [Ah 5c] and won ($0.26) with two pair, Aces and Jacks
Seat 2: 5a0773bb (small blind) folded before Flop
Seat 3: b547ce1 (big blind) showed [As 4c] and won ($0.26) with two pair, Aces and Jacks
Seat 4: a81f69c5 folded before Flop (didn't bet)
Seat 5: cc73acc1 folded before Flop (didn't bet)
Seat 6: 37577f88 folded before Flop (didn't bet)


Poker Hand #RC3795422664: Hold'em No Limit ($0.02/$0.05) - 2025/08/10 02:36:38
Table 'RushAndCash10967924' 6-max Seat #1 is the button
Seat 1: 650a21a0 ($6.7 in chips)
Seat 2: e0461ef9 ($8.44 in chips)
Seat 3: 3845acf7 ($6.16 in chips)
Seat 4: Hero ($6.5 in chips)
Seat 5: d2055999 ($7.4 in chips)
Seat 6: fec61aab ($5.1 in chips)
e0461ef9: posts small blind $0.02
3845acf7: posts big blind $0.05
*** HOLE CARDS ***
Dealt to 650a21a0 
Dealt to e0461ef9 
Dealt to 3845acf7 
Dealt to Hero [Tc Ah]
Dealt to d2055999 
Dealt to fec61aab 
Hero: raises $0.05 to $0.1
d2055999: folds
fec61aab: folds
650a21a0: folds
e0461ef9: folds
3845acf7: folds
Uncalled bet ($0.05) returned to Hero
*** SHOWDOWN ***
Hero collected $0.12 from pot
*** SUMMARY ***
Total pot $0.12 | Rake $0 | Jackpot $0 | Bingo $0 | Fortune $0 | Tax $0
Seat 1: 650a21a0 (button) folded before Flop (didn't bet)
Seat 2: e0461ef9 (small blind) folded before Flop
Seat 3: 3845acf7 (big blind) folded before Flop
Seat 4: Hero collected ($0.12)
Seat 5: d2055999 folded before Flop (didn't bet)
Seat 6: fec61aab folded before Flop (didn't bet)


Poker Hand #RC3795422547: Hold'em No Limit ($0.02/$0.05) - 2025/08/10 02:36:21
Table 'RushAndCash10967807' 6-max Seat #1 is the button
Seat 1: f1c7e07d ($5.29 in chips)
Seat 2: 548fee38 ($5.46 in chips)
Seat 3: Hero ($6.55 in chips)
Seat 4: f617d80c ($5.8 in chips)
Seat 5: 967e75a ($5.53 in chips)
Seat 6: 4118a035 ($9.64 in chips)
548fee38: posts small blind $0.02
Hero: posts big blind $0.05
*** HOLE CARDS ***
Dealt to f1c7e07d 
Dealt to 548fee38 
Dealt to Hero [Kh 8d]
Dealt to f617d80c 
Dealt to 967e75a 
Dealt to 4118a035 
f617d80c: raises $0.08 to $0.13
967e75a: folds
4118a035: folds
f1c7e07d: folds
548fee38: folds
Hero: folds
Uncalled bet ($0.08) returned to f617d80c
*** SHOWDOWN ***
f617d80c collected $0.12 from pot
*** SUMMARY ***
Total pot $0.12 | Rake $0 | Jackpot $0 | Bingo $0 | Fortune $0 | Tax $0
Seat 1: f1c7e07d (button) folded before Flop (didn't bet)
Seat 2: 548fee38 (small blind) folded before Flop
Seat 3: Hero (big blind) folded before Flop
Seat 4: f617d80c collected ($0.12)
Seat 5: 967e75a folded before Flop (didn't bet)
Seat 6: 4118a035 folded before Flop (didn't bet)


Poker Hand #RC3795422521: Hold'em No Limit ($0.02/$0.05) - 2025/08/10 02:36:18
Table 'RushAndCash10967781' 6-max Seat #1 is the button
Seat 1: 16e40141 ($5 in chips)
Seat 2: 2e230ca ($8.2 in chips)
Seat 3: 4da3a60d ($5.65 in chips)
Seat 4: Hero ($6.55 in chips)
Seat 5: f1c7e07d ($5.29 in chips)
Seat 6: 1d709ff6 ($10.54 in chips)
2e230ca: posts small blind $0.02
4da3a60d: posts big blind $0.05
*** HOLE CARDS ***
Dealt to 16e40141 
Dealt to 2e230ca 
Dealt to 4da3a60d 
Dealt to Hero [2s Tc]
Dealt to f1c7e07d 
Dealt to 1d709ff6 
Hero: folds
f1c7e07d: folds
1d709ff6: raises $0.05 to $0.1
16e40141: folds
2e230ca: raises $0.4 to $0.5
4da3a60d: folds
1d709ff6: folds
Uncalled bet ($0.4) returned to 2e230ca
*** SHOWDOWN ***
2e230ca collected $0.24 from pot
*** SUMMARY ***
Total pot $0.25 | Rake $0.01 | Jackpot $0 | Bingo $0 | Fortune $0 | Tax $0
Seat 1: 16e40141 (button) folded before Flop (didn't bet)
Seat 2: 2e230ca (small blind) collected ($0.24)
Seat 3: 4da3a60d (big blind) folded before Flop
Seat 4: Hero folded before Flop (didn't bet)
Seat 5: f1c7e07d folded before Flop (didn't bet)
Seat 6: 1d709ff6 folded before Flop


Poker Hand #RC3795422436: Hold'em No Limit ($0.02/$0.05) - 2025/08/10 02:36:05
Table 'RushAndCash10967696' 6-max Seat #1 is the button
Seat 1: 15876d02 ($7.57 in chips)
Seat 2: Hero ($6.57 in chips)
Seat 3: 94330b0b ($12.17 in chips)
Seat 4: a81f69c5 ($2.57 in chips)
Seat 5: 315464e9 ($5.37 in chips)
Seat 6: 2e230ca ($8.2 in chips)
Hero: posts small blind $0.02
94330b0b: posts big blind $0.05
*** HOLE CARDS ***
Dealt to 15876d02 
Dealt to Hero [Ks 3s]
Dealt to 94330b0b 
Dealt to a81f69c5 
Dealt to 315464e9 
Dealt to 2e230ca 
a81f69c5: raises $0.05 to $0.1
315464e9: folds
2e230ca: folds
15876d02: folds
Hero: folds
94330b0b: calls $0.05
*** FLOP *** [Kd Ad Qh]
94330b0b: checks
a81f69c5: bets $0.1
94330b0b: calls $0.1
*** TURN *** [Kd Ad Qh] [4h]
94330b0b: checks
a81f69c5: checks
*** RIVER *** [Kd Ad Qh 4h] [Kh]
94330b0b: bets $0.3
a81f69c5: folds
Uncalled bet ($0.3) returned to 94330b0b
*** SHOWDOWN ***
94330b0b collected $0.4 from pot
*** SUMMARY ***
Total pot $0.42 | Rake $0.02 | Jackpot $0 | Bingo $0 | Fortune $0 | Tax $0
Board [Kd Ad Qh 4h Kh]
Seat 1: 15876d02 (button) folded before Flop (didn't bet)
Seat 2: Hero (small blind) folded before Flop
Seat 3: 94330b0b (big blind) won ($0.4)
Seat 4: a81f69c5 folded on the River
Seat 5: 315464e9 folded before Flop (didn't bet)
Seat 6: 2e230ca folded before Flop (didn't bet)


Poker Hand #RC3795422406: Hold'em No Limit ($0.02/$0.05) - 2025/08/10 02:36:00
Table 'RushAndCash10967666' 6-max Seat #1 is the button
Seat 1: Hero ($6.57 in chips)
Seat 2: 4457b6b0 ($6.57 in chips)
Seat 3: 9059cf94 ($6.08 in chips)
Seat 4: 9ef76244 ($6.05 in chips)
Seat 5: aded8328 ($10.41 in chips)
Seat 6: 1189c558 ($5.39 in chips)
4457b6b0: posts small blind $0.02
9059cf94: posts big blind $0.05
*** HOLE CARDS ***
Dealt to Hero [2c Kh]
Dealt to 4457b6b0 
Dealt to 9059cf94 
Dealt to 9ef76244 
Dealt to aded8328 
Dealt to 1189c558 
9ef76244: folds
aded8328: folds
1189c558: folds
Hero: folds
4457b6b0: raises $0.1 to $0.15
9059cf94: folds
Uncalled bet ($0.1) returned to 4457b6b0
*** SHOWDOWN ***
4457b6b0 collected $0.1 from pot
*** SUMMARY ***
Total pot $0.1 | Rake $0 | Jackpot $0 | Bingo $0 | Fortune $0 | Tax $0
Seat 1: Hero (button) folded before Flop (didn't bet)
Seat 2: 4457b6b0 (small blind) collected ($0.1)
Seat 3: 9059cf94 (big blind) folded before Flop
Seat 4: 9ef76244 folded before Flop (didn't bet)
Seat 5: aded8328 folded before Flop (didn't bet)
Seat 6: 1189c558 folded before Flop (didn't bet)


Poker Hand #RC3795422117: Hold'em No Limit ($0.02/$0.05) - 2025/08/10 02:35:16
Table 'RushAndCash10967377' 6-max Seat #1 is the button
Seat 1: e12e8997 ($5 in chips)
Seat 2: 76ef6bc6 ($11.77 in chips)
Seat 3: 7816e94f ($5 in chips)
Seat 4: 69d54b5d ($5 in chips)
Seat 5: 137bd69d ($5.71 in chips)
Seat 6: Hero ($6.21 in chips)
76ef6bc6: posts small blind $0.02
7816e94f: posts big blind $0.05
*** HOLE CARDS ***
Dealt to e12e8997 
Dealt to 76ef6bc6 
Dealt to 7816e94f 
Dealt to 69d54b5d 
Dealt to 137bd69d 
Dealt to Hero [Kh Ad]
69d54b5d: raises $0.05 to $0.1
137bd69d: folds
Hero: raises $0.22 to $0.32
e12e8997: folds
76ef6bc6: folds
7816e94f: folds
69d54b5d: calls $0.22
*** FLOP *** [7s Ks 2c]
69d54b5d: checks
Hero: checks
*** TURN *** [7s Ks 2c] [Jd]
69d54b5d: checks
Hero: bets $0.5
69d54b5d: folds
Uncalled bet ($0.5) returned to Hero
*** SHOWDOWN ***
Hero collected $0.68 from pot
*** SUMMARY ***
Total pot $0.71 | Rake $0.03 | Jackpot $0 | Bingo $0 | Fortune $0 | Tax $0
Board [7s Ks 2c Jd]
Seat 1: e12e8997 (button) folded before Flop (didn't bet)
Seat 2: 76ef6bc6 (small blind) folded before Flop
Seat 3: 7816e94f (big blind) folded before Flop
Seat 4: 69d54b5d folded on the Turn
Seat 5: 137bd69d folded before Flop (didn't bet)
Seat 6: Hero won ($0.68)


Poker Hand #RC3795422093: Hold'em No Limit ($0.02/$0.05) - 2025/08/10 02:35:12
Table 'RushAndCash10967353' 6-max Seat #1 is the button
Seat 1: 15e16149 ($6.46 in chips)
Seat 2: 10ac1742 ($5.31 in chips)
Seat 3: 3a4a7f42 ($2 in chips)
Seat 4: 23bfa7da ($3.39 in chips)
Seat 5: Hero ($6.21 in chips)
Seat 6: ab02685 ($5 in chips)
10ac1742: posts small blind $0.02
3a4a7f42: posts big blind $0.05
*** HOLE CARDS ***
Dealt to 15e16149 
Dealt to 10ac1742 
Dealt to 3a4a7f42 
Dealt to 23bfa7da 
Dealt to Hero [4h 4s]
Dealt to ab02685 
23bfa7da: folds
Hero: folds
ab02685: raises $0.08 to $0.13
15e16149: folds
10ac1742: folds
3a4a7f42: calls $0.08
*** FLOP *** [7s Qc 3d]
3a4a7f42: checks
ab02685: checks
*** TURN *** [7s Qc 3d] [5c]
3a4a7f42: checks
ab02685: checks
*** RIVER *** [7s Qc 3d 5c] [Ah]
3a4a7f42: checks
ab02685: checks
3a4a7f42: shows [9d Jd] (Ace high)
ab02685: shows [Kc Th] (Ace high)
*** SHOWDOWN ***
ab02685 collected $0.27 from pot
*** SUMMARY ***
Total pot $0.28 | Rake $0.01 | Jackpot $0 | Bingo $0 | Fortune $0 | Tax $0
Board [7s Qc 3d 5c Ah]
Seat 1: 15e16149 (button) folded before Flop (didn't bet)
Seat 2: 10ac1742 (small blind) folded before Flop
Seat 3: 3a4a7f42 (big blind) showed [9d Jd] and lost with Ace high
Seat 4: 23bfa7da folded before Flop (didn't bet)
Seat 5: Hero folded before Flop (didn't bet)
Seat 6: ab02685 showed [Kc Th] and won ($0.27) with Ace high


Poker Hand #RC3795422001: Hold'em No Limit ($0.02/$0.05) - 2025/08/10 02:34:58
Table 'RushAndCash10967261' 6-max Seat #1 is the button
Seat 1: Hero ($6.14 in chips)
Seat 2: 315464e9 ($5.53 in chips)
Seat 3: cfdc3190 ($7.51 in chips)
Seat 4: 80d282ad ($4.73 in chips)
Seat 5: 89a546f8 ($5 in chips)
Seat 6: 7d912640 ($5 in chips)
315464e9: posts small blind $0.02
cfdc3190: posts big blind $0.05
*** HOLE CARDS ***
Dealt to Hero [6h 6d]
Dealt to 315464e9 
Dealt to cfdc3190 
Dealt to 80d282ad 
Dealt to 89a546f8 
Dealt to 7d912640 
80d282ad: folds
89a546f8: folds
7d912640: folds
Hero: raises $0.05 to $0.1
315464e9: folds
cfdc3190: folds
Uncalled bet ($0.05) returned to Hero
*** SHOWDOWN ***
Hero collected $0.12 from pot
*** SUMMARY ***
Total pot $0.12 | Rake $0 | Jackpot $0 | Bingo $0 | Fortune $0 | Tax $0
Seat 1: Hero (button) collected ($0.12)
Seat 2: 315464e9 (small blind) folded before Flop
Seat 3: cfdc3190 (big blind) folded before Flop
Seat 4: 80d282ad folded before Flop (didn't bet)
Seat 5: 89a546f8 folded before Flop (didn't bet)
Seat 6: 7d912640 folded before Flop (didn't bet)


Poker Hand #RC3795421947: Hold'em No Limit ($0.02/$0.05) - 2025/08/10 02:34:49
Table 'RushAndCash10967207' 6-max Seat #1 is the button
Seat 1: 99376de ($21.28 in chips)
Seat 2: Hero ($6.16 in chips)
Seat 3: 1d709ff6 ($10.75 in chips)
Seat 4: 166e4a4 ($7.18 in chips)
Seat 5: 17266b76 ($2.36 in chips)
Seat 6: e61f41dd ($11.86 in chips)
Hero: posts small blind $0.02
1d709ff6: posts big blind $0.05
*** HOLE CARDS ***
Dealt to 99376de 
Dealt to Hero [7d Ah]
Dealt to 1d709ff6 
Dealt to 166e4a4 
Dealt to 17266b76 
Dealt to e61f41dd 
166e4a4: raises $0.05 to $0.1
17266b76: folds
e61f41dd: folds
99376de: folds
Hero: folds
1d709ff6: folds
Uncalled bet ($0.05) returned to 166e4a4
*** SHOWDOWN ***
166e4a4 collected $0.12 from pot
*** SUMMARY ***
Total pot $0.12 | Rake $0 | Jackpot $0 | Bingo $0 | Fortune $0 | Tax $0
Seat 1: 99376de (button) folded before Flop (didn't bet)
Seat 2: Hero (small blind) folded before Flop
Seat 3: 1d709ff6 (big blind) folded before Flop
Seat 4: 166e4a4 collected ($0.12)
Seat 5: 17266b76 folded before Flop (didn't bet)
Seat 6: e61f41dd folded before Flop (didn't bet)


Poker Hand #RC3795421861: Hold'em No Limit ($0.02/$0.05) - 2025/08/10 02:34:36
Table 'RushAndCash10967121' 6-max Seat #1 is the button
Seat 1: fec61aab ($5.07 in chips)
Seat 2: 11eda99d ($5 in chips)
Seat 3: Hero ($6.21 in chips)
Seat 4: 9c86a569 ($5.52 in chips)
Seat 5: 251009f4 ($5 in chips)
Seat 6: 6d7e07bc ($5.26 in chips)
11eda99d: posts small blind $0.02
Hero: posts big blind $0.05
*** HOLE CARDS ***
Dealt to fec61aab 
Dealt to 11eda99d 
Dealt to Hero [8h 4c]
Dealt to 9c86a569 
Dealt to 251009f4 
Dealt to 6d7e07bc 
9c86a569: folds
251009f4: folds
6d7e07bc: folds
fec61aab: raises $0.05 to $0.1
11eda99d: folds
Hero: folds
Uncalled bet ($0.05) returned to fec61aab
*** SHOWDOWN ***
fec61aab collected $0.12 from pot
*** SUMMARY ***
Total pot $0.12 | Rake $0 | Jackpot $0 | Bingo $0 | Fortune $0 | Tax $0
Seat 1: fec61aab (button) collected ($0.12)
Seat 2: 11eda99d (small blind) folded before Flop
Seat 3: Hero (big blind) folded before Flop
Seat 4: 9c86a569 folded before Flop (didn't bet)
Seat 5: 251009f4 folded before Flop (didn't bet)
Seat 6: 6d7e07bc folded before Flop (didn't bet)


Poker Hand #RC3795421837: Hold'em No Limit ($0.02/$0.05) - 2025/08/10 02:34:31
Table 'RushAndCash10967097' 6-max Seat #1 is the button
Seat 1: a4931689 ($10.41 in chips)
Seat 2: edae21a ($5 in chips)
Seat 3: 5cccb150 ($5.76 in chips)
Seat 4: 4fa744c2 ($5.09 in chips)
Seat 5: 2694dd9a ($5 in chips)
Seat 6: Hero ($6.21 in chips)
edae21a: posts small blind $0.02
5cccb150: posts big blind $0.05
*** HOLE CARDS ***
Dealt to a4931689 
Dealt to edae21a 
Dealt to 5cccb150 
Dealt to 4fa744c2 
Dealt to 2694dd9a 
Dealt to Hero [Ks 3d]
4fa744c2: folds
2694dd9a: folds
Hero: folds
a4931689: folds
edae21a: raises $0.1 to $0.15
5cccb150: folds
Uncalled bet ($0.1) returned to edae21a
*** SHOWDOWN ***
edae21a collected $0.1 from pot
*** SUMMARY ***
Total pot $0.1 | Rake $0 | Jackpot $0 | Bingo $0 | Fortune $0 | Tax $0
Seat 1: a4931689 (button) folded before Flop (didn't bet)
Seat 2: edae21a (small blind) collected ($0.1)
Seat 3: 5cccb150 (big blind) folded before Flop
Seat 4: 4fa744c2 folded before Flop (didn't bet)
Seat 5: 2694dd9a folded before Flop (didn't bet)
Seat 6: Hero folded before Flop (didn't bet)


Poker Hand #RC3795421818: Hold'em No Limit ($0.02/$0.05) - 2025/08/10 02:34:28
Table 'RushAndCash10967078' 6-max Seat #1 is the button
Seat 1: a579ea8 ($3.42 in chips)
Seat 2: a4931689 ($10.43 in chips)
Seat 3: a4a46ffd ($6.5 in chips)
Seat 4: 5051873b ($6.17 in chips)
Seat 5: Hero ($6.21 in chips)
Seat 6: 315464e9 ($5.68 in chips)
a4931689: posts small blind $0.02
a4a46ffd: posts big blind $0.05
*** HOLE CARDS ***
Dealt to a579ea8 
Dealt to a4931689 
Dealt to a4a46ffd 
Dealt to 5051873b 
Dealt to Hero [6h 7s]
Dealt to 315464e9 
5051873b: folds
Hero: folds
315464e9: folds
a579ea8: folds
a4931689: folds
Uncalled bet ($0.03) returned to a4a46ffd
*** SHOWDOWN ***
a4a46ffd collected $0.04 from pot
*** SUMMARY ***
Total pot $0.04 | Rake $0 | Jackpot $0 | Bingo $0 | Fortune $0 | Tax $0
Seat 1: a579ea8 (button) folded before Flop (didn't bet)
Seat 2: a4931689 (small blind) folded before Flop
Seat 3: a4a46ffd (big blind) collected ($0.04)
Seat 4: 5051873b folded before Flop (didn't bet)
Seat 5: Hero folded before Flop (didn't bet)
Seat 6: 315464e9 folded before Flop (didn't bet)


Poker Hand #RC3795421778: Hold'em No Limit ($0.02/$0.05) - 2025/08/10 02:34:21
Table 'RushAndCash10967038' 6-max Seat #1 is the button
Seat 1: 710c102b ($5 in chips)
Seat 2: 9a290b47 ($5.14 in chips)
Seat 3: 7f7620a ($7.34 in chips)
Seat 4: 4d4d4fd4 ($7.14 in chips)
Seat 5: Hero ($6.21 in chips)
Seat 6: 4a75d66a ($12.14 in chips)
9a290b47: posts small blind $0.02
7f7620a: posts big blind $0.05
*** HOLE CARDS ***
Dealt to 710c102b 
Dealt to 9a290b47 
Dealt to 7f7620a 
Dealt to 4d4d4fd4 
Dealt to Hero [Kc Td]
Dealt to 4a75d66a 
4d4d4fd4: folds
Hero: folds
4a75d66a: folds
710c102b: folds
9a290b47: raises $0.1 to $0.15
7f7620a: calls $0.1
*** FLOP *** [Qc 5h 3d]
9a290b47: checks
7f7620a: bets $0.07
9a290b47: calls $0.07
*** TURN *** [Qc 5h 3d] [Ts]
9a290b47: checks
7f7620a: checks
*** RIVER *** [Qc 5h 3d Ts] [9c]
9a290b47: checks
7f7620a: bets $0.33
9a290b47: folds
Uncalled bet ($0.33) returned to 7f7620a
*** SHOWDOWN ***
7f7620a collected $0.42 from pot
*** SUMMARY ***
Total pot $0.44 | Rake $0.02 | Jackpot $0 | Bingo $0 | Fortune $0 | Tax $0
Board [Qc 5h 3d Ts 9c]
Seat 1: 710c102b (button) folded before Flop (didn't bet)
Seat 2: 9a290b47 (small blind) folded on the River
Seat 3: 7f7620a (big blind) won ($0.42)
Seat 4: 4d4d4fd4 folded before Flop (didn't bet)
Seat 5: Hero folded before Flop (didn't bet)
Seat 6: 4a75d66a folded before Flop (didn't bet)


Poker Hand #RC3795421665: Hold'em No Limit ($0.02/$0.05) - 2025/08/10 02:34:04
Table 'RushAndCash10966925' 6-max Seat #1 is the button
Seat 1: 138d2797 ($4.08 in chips)
Seat 2: e75eff02 ($3.67 in chips)
Seat 3: Hero ($6.19 in chips)
Seat 4: 967e75a ($5 in chips)
Seat 5: 5f6e556d ($5.73 in chips)
Seat 6: ce517e5d ($8.76 in chips)
e75eff02: posts small blind $0.02
Hero: posts big blind $0.05
*** HOLE CARDS ***
Dealt to 138d2797 
Dealt to e75eff02 
Dealt to Hero [Qc As]
Dealt to 967e75a 
Dealt to 5f6e556d 
Dealt to ce517e5d 
967e75a: folds
5f6e556d: folds
ce517e5d: folds
138d2797: folds
e75eff02: folds
Uncalled bet ($0.03) returned to Hero
*** SHOWDOWN ***
Hero collected $0.04 from pot
*** SUMMARY ***
Total pot $0.04 | Rake $0 | Jackpot $0 | Bingo $0 | Fortune $0 | Tax $0
Seat 1: 138d2797 (button) folded before Flop (didn't bet)
Seat 2: e75eff02 (small blind) folded before Flop
Seat 3: Hero (big blind) collected ($0.04)
Seat 4: 967e75a folded before Flop (didn't bet)
Seat 5: 5f6e556d folded before Flop (didn't bet)
Seat 6: ce517e5d folded before Flop (didn't bet)


Poker Hand #RC3795421643: Hold'em No Limit ($0.02/$0.05) - 2025/08/10 02:34:00
Table 'RushAndCash10966903' 6-max Seat #1 is the button
Seat 1: 67ab27d4 ($5 in chips)
Seat 2: c233e8c8 ($8.36 in chips)
Seat 3: 91754c7a ($3.85 in chips)
Seat 4: Hero ($6.19 in chips)
Seat 5: b1045884 ($3.03 in chips)
Seat 6: 713b695f ($5 in chips)
c233e8c8: posts small blind $0.02
91754c7a: posts big blind $0.05
*** HOLE CARDS ***
Dealt to 67ab27d4 
Dealt to c233e8c8 
Dealt to 91754c7a 
Dealt to Hero [Th 7d]
Dealt to b1045884 
Dealt to 713b695f 
Hero: folds
b1045884: folds
713b695f: folds
67ab27d4: raises $0.05 to $0.1
c233e8c8: folds
91754c7a: folds
Uncalled bet ($0.05) returned to 67ab27d4
*** SHOWDOWN ***
67ab27d4 collected $0.12 from pot
*** SUMMARY ***
Total pot $0.12 | Rake $0 | Jackpot $0 | Bingo $0 | Fortune $0 | Tax $0
Seat 1: 67ab27d4 (button) collected ($0.12)
Seat 2: c233e8c8 (small blind) folded before Flop
Seat 3: 91754c7a (big blind) folded before Flop
Seat 4: Hero folded before Flop (didn't bet)
Seat 5: b1045884 folded before Flop (didn't bet)
Seat 6: 713b695f folded before Flop (didn't bet)


Poker Hand #RC3795421564: Hold'em No Limit ($0.02/$0.05) - 2025/08/10 02:33:47
Table 'RushAndCash10966824' 6-max Seat #1 is the button
Seat 1: d7f7b374 ($5.07 in chips)
Seat 2: Hero ($6.21 in chips)
Seat 3: 9509e2e ($4.79 in chips)
Seat 4: 696a490 ($7.77 in chips)
Seat 5: 66694de3 ($1.7 in chips)
Seat 6: f7b1defe ($9.86 in chips)
Hero: posts small blind $0.02
9509e2e: posts big blind $0.05
*** HOLE CARDS ***
Dealt to d7f7b374 
Dealt to Hero [8c 4h]
Dealt to 9509e2e 
Dealt to 696a490 
Dealt to 66694de3 
Dealt to f7b1defe 
696a490: folds
66694de3: raises $0.1 to $0.15
f7b1defe: raises $0.3 to $0.45
d7f7b374: folds
Hero: folds
9509e2e: folds
66694de3: calls $0.3
*** FLOP *** [3d 7c 8h]
66694de3: checks
f7b1defe: bets $0.33
66694de3: calls $0.33
*** TURN *** [3d 7c 8h] [7s]
66694de3: checks
f7b1defe: checks
*** RIVER *** [3d 7c 8h 7s] [9s]
66694de3: checks
f7b1defe: bets $1.08
66694de3: folds
Uncalled bet ($1.08) returned to f7b1defe
*** SHOWDOWN ***
f7b1defe collected $1.49 from pot
*** SUMMARY ***
Total pot $1.63 | Rake $0.07 | Jackpot $0.07 | Bingo $0 | Fortune $0 | Tax $0
Board [3d 7c 8h 7s 9s]
Seat 1: d7f7b374 (button) folded before Flop (didn't bet)
Seat 2: Hero (small blind) folded before Flop
Seat 3: 9509e2e (big blind) folded before Flop
Seat 4: 696a490 folded before Flop (didn't bet)
Seat 5: 66694de3 folded on the River
Seat 6: f7b1defe won ($1.49)


Poker Hand #RC3795421170: Hold'em No Limit ($0.02/$0.05) - 2025/08/10 02:32:43
Table 'RushAndCash10966430' 6-max Seat #1 is the button
Seat 1: Hero ($4.7 in chips)
Seat 2: 1e85b50 ($26.24 in chips)
Seat 3: eb247144 ($8.89 in chips)
Seat 4: db9525e1 ($9.25 in chips)
Seat 5: 7d912640 ($5.35 in chips)
Seat 6: 938d3763 ($16.27 in chips)
1e85b50: posts small blind $0.02
eb247144: posts big blind $0.05
*** HOLE CARDS ***
Dealt to Hero [6s 7s]
Dealt to 1e85b50 
Dealt to eb247144 
Dealt to db9525e1 
Dealt to 7d912640 
Dealt to 938d3763 
db9525e1: folds
7d912640: raises $0.08 to $0.13
938d3763: folds
Hero: calls $0.13
1e85b50: folds
eb247144: folds
*** FLOP *** [7h 8c 9s]
7d912640: bets $0.17
Hero: calls $0.17
*** TURN *** [7h 8c 9s] [Qd]
7d912640: bets $0.51
Hero: calls $0.51
*** RIVER *** [7h 8c 9s Qd] [4d]
7d912640: bets $0.85
Hero: calls $0.85
7d912640: shows [Js Kc] (King high)
Hero: shows [6s 7s] (a pair of Sevens)
*** SHOWDOWN ***
Hero collected $3.17 from pot
*** SUMMARY ***
Total pot $3.39 | Rake $0.15 | Jackpot $0.07 | Bingo $0 | Fortune $0 | Tax $0
Board [7h 8c 9s Qd 4d]
Seat 1: Hero (button) showed [6s 7s] and won ($3.17) with a pair of Sevens
Seat 2: 1e85b50 (small blind) folded before Flop
Seat 3: eb247144 (big blind) folded before Flop
Seat 4: db9525e1 folded before Flop (didn't bet)
Seat 5: 7d912640 showed [Js Kc] and lost with King high
Seat 6: 938d3763 folded before Flop (didn't bet)


Poker Hand #RC3795421143: Hold'em No Limit ($0.02/$0.05) - 2025/08/10 02:32:39
Table 'RushAndCash10966403' 6-max Seat #1 is the button
Seat 1: f11e70d0 ($10.41 in chips)
Seat 2: 66ea990b ($5.09 in chips)
Seat 3: e70deab3 ($5.31 in chips)
Seat 4: 51270fe ($5.11 in chips)
Seat 5: ee87ee96 ($19.77 in chips)
Seat 6: Hero ($4.7 in chips)
66ea990b: posts small blind $0.02
e70deab3: posts big blind $0.05
*** HOLE CARDS ***
Dealt to f11e70d0 
Dealt to 66ea990b 
Dealt to e70deab3 
Dealt to 51270fe 
Dealt to ee87ee96 
Dealt to Hero [6h 8d]
51270fe: folds
ee87ee96: raises $0.05 to $0.1
Hero: folds
f11e70d0: folds
66ea990b: calls $0.08
e70deab3: folds
*** FLOP *** [Kd Th Qc]
66ea990b: checks
ee87ee96: bets $0.1
66ea990b: folds
Uncalled bet ($0.1) returned to ee87ee96
*** SHOWDOWN ***
ee87ee96 collected $0.24 from pot
*** SUMMARY ***
Total pot $0.25 | Rake $0.01 | Jackpot $0 | Bingo $0 | Fortune $0 | Tax $0
Board [Kd Th Qc]
Seat 1: f11e70d0 (button) folded before Flop (didn't bet)
Seat 2: 66ea990b (small blind) folded on the Flop
Seat 3: e70deab3 (big blind) folded before Flop
Seat 4: 51270fe folded before Flop (didn't bet)
Seat 5: ee87ee96 won ($0.24)
Seat 6: Hero folded before Flop (didn't bet)


Poker Hand #RC3795421121: Hold'em No Limit ($0.02/$0.05) - 2025/08/10 02:32:35
Table 'RushAndCash10966381' 6-max Seat #1 is the button
Seat 1: 84a6e006 ($17.02 in chips)
Seat 2: 9629b901 ($5.05 in chips)
Seat 3: f11e70d0 ($10.46 in chips)
Seat 4: ee87ee96 ($19.77 in chips)
Seat 5: Hero ($4.7 in chips)
Seat 6: 4d5a4ee5 ($10.85 in chips)
9629b901: posts small blind $0.02
f11e70d0: posts big blind $0.05
*** HOLE CARDS ***
Dealt to 84a6e006 
Dealt to 9629b901 
Dealt to f11e70d0 
Dealt to ee87ee96 
Dealt to Hero [2h 2c]
Dealt to 4d5a4ee5 
ee87ee96: folds
Hero: folds
4d5a4ee5: folds
84a6e006: folds
9629b901: raises $0.1 to $0.15
f11e70d0: folds
Uncalled bet ($0.1) returned to 9629b901
*** SHOWDOWN ***
9629b901 collected $0.1 from pot
*** SUMMARY ***
Total pot $0.1 | Rake $0 | Jackpot $0 | Bingo $0 | Fortune $0 | Tax $0
Seat 1: 84a6e006 (button) folded before Flop (didn't bet)
Seat 2: 9629b901 (small blind) collected ($0.1)
Seat 3: f11e70d0 (big blind) folded before Flop
Seat 4: ee87ee96 folded before Flop (didn't bet)
Seat 5: Hero folded before Flop (didn't bet)
Seat 6: 4d5a4ee5 folded before Flop (didn't bet)


Poker Hand #RC3795421070: Hold'em No Limit ($0.02/$0.05) - 2025/08/10 02:32:27
Table 'RushAndCash10966330' 6-max Seat #1 is the button
Seat 1: Hero ($4.7 in chips)
Seat 2: 5be329df ($3.73 in chips)
Seat 3: 712a2078 ($16.24 in chips)
Seat 4: e70deab3 ($5.31 in chips)
Seat 5: 9509e2e ($4.76 in chips)
Seat 6: 922808b9 ($21.99 in chips)
5be329df: posts small blind $0.02
712a2078: posts big blind $0.05
*** HOLE CARDS ***
Dealt to Hero [3d Ah]
Dealt to 5be329df 
Dealt to 712a2078 
Dealt to e70deab3 
Dealt to 9509e2e 
Dealt to 922808b9 
e70deab3: folds
9509e2e: folds
922808b9: folds
Hero: folds
5be329df: raises $0.05 to $0.1
712a2078: raises $0.2 to $0.3
5be329df: calls $0.2
*** FLOP *** [Kh As Kd]
5be329df: checks
712a2078: bets $0.2
5be329df: folds
Uncalled bet ($0.2) returned to 712a2078
*** SHOWDOWN ***
712a2078 collected $0.57 from pot
*** SUMMARY ***
Total pot $0.6 | Rake $0.03 | Jackpot $0 | Bingo $0 | Fortune $0 | Tax $0
Board [Kh As Kd]
Seat 1: Hero (button) folded before Flop (didn't bet)
Seat 2: 5be329df (small blind) folded on the Flop
Seat 3: 712a2078 (big blind) won ($0.57)
Seat 4: e70deab3 folded before Flop (didn't bet)
Seat 5: 9509e2e folded before Flop (didn't bet)
Seat 6: 922808b9 folded before Flop (didn't bet)


Poker Hand #RC3795421012: Hold'em No Limit ($0.02/$0.05) - 2025/08/10 02:32:17
Table 'RushAndCash10966272' 6-max Seat #1 is the button
Seat 1: 17550682 ($7.98 in chips)
Seat 2: 9ec01b30 ($7.22 in chips)
Seat 3: Hero ($4.75 in chips)
Seat 4: 192d221d ($3.99 in chips)
Seat 5: ca43cd5 ($8.98 in chips)
Seat 6: 4118a035 ($8 in chips)
9ec01b30: posts small blind $0.02
Hero: posts big blind $0.05
*** HOLE CARDS ***
Dealt to 17550682 
Dealt to 9ec01b30 
Dealt to Hero [2c Ts]
Dealt to 192d221d 
Dealt to ca43cd5 
Dealt to 4118a035 
192d221d: folds
ca43cd5: folds
4118a035: raises $0.05 to $0.1
17550682: folds
9ec01b30: folds
Hero: folds
Uncalled bet ($0.05) returned to 4118a035
*** SHOWDOWN ***
4118a035 collected $0.12 from pot
*** SUMMARY ***
Total pot $0.12 | Rake $0 | Jackpot $0 | Bingo $0 | Fortune $0 | Tax $0
Seat 1: 17550682 (button) folded before Flop (didn't bet)
Seat 2: 9ec01b30 (small blind) folded before Flop
Seat 3: Hero (big blind) folded before Flop
Seat 4: 192d221d folded before Flop (didn't bet)
Seat 5: ca43cd5 folded before Flop (didn't bet)
Seat 6: 4118a035 collected ($0.12)


Poker Hand #RC3795420823: Hold'em No Limit ($0.02/$0.05) - 2025/08/10 02:31:49
Table 'RushAndCash10966083' 6-max Seat #1 is the button
Seat 1: 6a77af60 ($7.57 in chips)
Seat 2: Hero ($4.89 in chips)
Seat 3: 9ec01b30 ($7.09 in chips)
Seat 4: e8a0a52a ($5.37 in chips)
Seat 5: abc8a81a ($7.23 in chips)
Seat 6: 124f4da0 ($4.04 in chips)
Hero: posts small blind $0.02
9ec01b30: posts big blind $0.05
*** HOLE CARDS ***
Dealt to 6a77af60 
Dealt to Hero [Kc 3c]
Dealt to 9ec01b30 
Dealt to e8a0a52a 
Dealt to abc8a81a 
Dealt to 124f4da0 
e8a0a52a: folds
abc8a81a: folds
124f4da0: folds
6a77af60: folds
Hero: raises $0.09 to $0.14
9ec01b30: raises $0.46 to $0.6
Hero: folds
Uncalled bet ($0.46) returned to 9ec01b30
*** SHOWDOWN ***
9ec01b30 collected $0.27 from pot
*** SUMMARY ***
Total pot $0.28 | Rake $0.01 | Jackpot $0 | Bingo $0 | Fortune $0 | Tax $0
Seat 1: 6a77af60 (button) folded before Flop (didn't bet)
Seat 2: Hero (small blind) folded before Flop
Seat 3: 9ec01b30 (big blind) collected ($0.27)
Seat 4: e8a0a52a folded before Flop (didn't bet)
Seat 5: abc8a81a folded before Flop (didn't bet)
Seat 6: 124f4da0 folded before Flop (didn't bet)


Poker Hand #RC3795420797: Hold'em No Limit ($0.02/$0.05) - 2025/08/10 02:31:45
Table 'RushAndCash10966057' 6-max Seat #1 is the button
Seat 1: 6f7ae573 ($5.89 in chips)
Seat 2: ff87a474 ($6.88 in chips)
Seat 3: 66694de3 ($1.77 in chips)
Seat 4: Hero ($4.89 in chips)
Seat 5: 1037db79 ($7.57 in chips)
Seat 6: 5051873b ($5.99 in chips)
ff87a474: posts small blind $0.02
66694de3: posts big blind $0.05
*** HOLE CARDS ***
Dealt to 6f7ae573 
Dealt to ff87a474 
Dealt to 66694de3 
Dealt to Hero [2s 2d]
Dealt to 1037db79 
Dealt to 5051873b 
Hero: folds
1037db79: folds
5051873b: folds
6f7ae573: raises $0.05 to $0.1
ff87a474: folds
66694de3: folds
Uncalled bet ($0.05) returned to 6f7ae573
*** SHOWDOWN ***
6f7ae573 collected $0.12 from pot
*** SUMMARY ***
Total pot $0.12 | Rake $0 | Jackpot $0 | Bingo $0 | Fortune $0 | Tax $0
Seat 1: 6f7ae573 (button) collected ($0.12)
Seat 2: ff87a474 (small blind) folded before Flop
Seat 3: 66694de3 (big blind) folded before Flop
Seat 4: Hero folded before Flop (didn't bet)
Seat 5: 1037db79 folded before Flop (didn't bet)
Seat 6: 5051873b folded before Flop (didn't bet)


Poker Hand #RC3795420771: Hold'em No Limit ($0.02/$0.05) - 2025/08/10 02:31:42
Table 'RushAndCash10966031' 6-max Seat #1 is the button
Seat 1: 251009f4 ($5.3 in chips)
Seat 2: 1037db79 ($7.59 in chips)
Seat 3: d23220ed ($4.75 in chips)
Seat 4: c6036812 ($1.41 in chips)
Seat 5: Hero ($4.89 in chips)
Seat 6: c3281252 ($5.94 in chips)
1037db79: posts small blind $0.02
d23220ed: posts big blind $0.05
*** HOLE CARDS ***
Dealt to 251009f4 
Dealt to 1037db79 
Dealt to d23220ed 
Dealt to c6036812 
Dealt to Hero [5c 8d]
Dealt to c3281252 
c6036812: raises $0.05 to $0.1
Hero: folds
c3281252: folds
251009f4: folds
1037db79: folds
d23220ed: folds
Uncalled bet ($0.05) returned to c6036812
*** SHOWDOWN ***
c6036812 collected $0.12 from pot
*** SUMMARY ***
Total pot $0.12 | Rake $0 | Jackpot $0 | Bingo $0 | Fortune $0 | Tax $0
Seat 1: 251009f4 (button) folded before Flop (didn't bet)
Seat 2: 1037db79 (small blind) folded before Flop
Seat 3: d23220ed (big blind) folded before Flop
Seat 4: c6036812 collected ($0.12)
Seat 5: Hero folded before Flop (didn't bet)
Seat 6: c3281252 folded before Flop (didn't bet)


Poker Hand #RC3795420748: Hold'em No Limit ($0.02/$0.05) - 2025/08/10 02:31:38
Table 'RushAndCash10966008' 6-max Seat #1 is the button
Seat 1: 187dd5e5 ($5 in chips)
Seat 2: 11eda99d ($5 in chips)
Seat 3: ed2e3bd1 ($5.37 in chips)
Seat 4: d23220ed ($4.75 in chips)
Seat 5: Hero ($4.89 in chips)
Seat 6: 251009f4 ($5.3 in chips)
11eda99d: posts small blind $0.02
ed2e3bd1: posts big blind $0.05
*** HOLE CARDS ***
Dealt to 187dd5e5 
Dealt to 11eda99d 
Dealt to ed2e3bd1 
Dealt to d23220ed 
Dealt to Hero [7d Qh]
Dealt to 251009f4 
d23220ed: folds
Hero: folds
251009f4: folds
187dd5e5: raises $0.08 to $0.13
11eda99d: folds
ed2e3bd1: folds
Uncalled bet ($0.08) returned to 187dd5e5
*** SHOWDOWN ***
187dd5e5 collected $0.12 from pot
*** SUMMARY ***
Total pot $0.12 | Rake $0 | Jackpot $0 | Bingo $0 | Fortune $0 | Tax $0
Seat 1: 187dd5e5 (button) collected ($0.12)
Seat 2: 11eda99d (small blind) folded before Flop
Seat 3: ed2e3bd1 (big blind) folded before Flop
Seat 4: d23220ed folded before Flop (didn't bet)
Seat 5: Hero folded before Flop (didn't bet)
Seat 6: 251009f4 folded before Flop (didn't bet)


Poker Hand #RC3795420726: Hold'em No Limit ($0.02/$0.05) - 2025/08/10 02:31:34
Table 'RushAndCash10965986' 6-max Seat #1 is the button
Seat 1: ea43ffc8 ($5.32 in chips)
Seat 2: 253639a7 ($5.16 in chips)
Seat 3: 8dabeea2 ($5.43 in chips)
Seat 4: 777a2ea8 ($4.89 in chips)
Seat 5: 7cf6a8cc ($5 in chips)
Seat 6: Hero ($4.89 in chips)
253639a7: posts small blind $0.02
8dabeea2: posts big blind $0.05
*** HOLE CARDS ***
Dealt to ea43ffc8 
Dealt to 253639a7 
Dealt to 8dabeea2 
Dealt to 777a2ea8 
Dealt to 7cf6a8cc 
Dealt to Hero [4s 8d]
777a2ea8: folds
7cf6a8cc: folds
Hero: folds
ea43ffc8: folds
253639a7: folds
Uncalled bet ($0.03) returned to 8dabeea2
*** SHOWDOWN ***
8dabeea2 collected $0.04 from pot
*** SUMMARY ***
Total pot $0.04 | Rake $0 | Jackpot $0 | Bingo $0 | Fortune $0 | Tax $0
Seat 1: ea43ffc8 (button) folded before Flop (didn't bet)
Seat 2: 253639a7 (small blind) folded before Flop
Seat 3: 8dabeea2 (big blind) collected ($0.04)
Seat 4: 777a2ea8 folded before Flop (didn't bet)
Seat 5: 7cf6a8cc folded before Flop (didn't bet)
Seat 6: Hero folded before Flop (didn't bet)


Poker Hand #RC3795420653: Hold'em No Limit ($0.02/$0.05) - 2025/08/10 02:31:21
Table 'RushAndCash10965913' 6-max Seat #1 is the button
Seat 1: d7f7b374 ($5.06 in chips)
Seat 2: 62d10ee ($12.89 in chips)
Seat 3: Hero ($4.94 in chips)
Seat 4: e3d5a37 ($5.23 in chips)
Seat 5: ad44a40 ($6.02 in chips)
Seat 6: 3ac0fa5e ($5.11 in chips)
62d10ee: posts small blind $0.02
Hero: posts big blind $0.05
*** HOLE CARDS ***
Dealt to d7f7b374 
Dealt to 62d10ee 
Dealt to Hero [3h Ks]
Dealt to e3d5a37 
Dealt to ad44a40 
Dealt to 3ac0fa5e 
e3d5a37: raises $0.05 to $0.1
ad44a40: folds
3ac0fa5e: raises $0.41 to $0.51
d7f7b374: folds
62d10ee: folds
Hero: folds
e3d5a37: folds
Uncalled bet ($0.41) returned to 3ac0fa5e
*** SHOWDOWN ***
3ac0fa5e collected $0.26 from pot
*** SUMMARY ***
Total pot $0.27 | Rake $0.01 | Jackpot $0 | Bingo $0 | Fortune $0 | Tax $0
Seat 1: d7f7b374 (button) folded before Flop (didn't bet)
Seat 2: 62d10ee (small blind) folded before Flop
Seat 3: Hero (big blind) folded before Flop
Seat 4: e3d5a37 folded before Flop
Seat 5: ad44a40 folded before Flop (didn't bet)
Seat 6: 3ac0fa5e collected ($0.26)


Poker Hand #RC3795420607: Hold'em No Limit ($0.02/$0.05) - 2025/08/10 02:31:14
Table 'RushAndCash10965867' 6-max Seat #1 is the button
Seat 1: Hero ($4.94 in chips)
Seat 2: 58fa799c ($8.98 in chips)
Seat 3: dd5ee70a ($5.17 in chips)
Seat 4: 9fa795bc ($3.56 in chips)
Seat 5: a744d756 ($5.59 in chips)
Seat 6: 5a0773bb ($5.15 in chips)
58fa799c: posts small blind $0.02
dd5ee70a: posts big blind $0.05
*** HOLE CARDS ***
Dealt to Hero [6d 3h]
Dealt to 58fa799c 
Dealt to dd5ee70a 
Dealt to 9fa795bc 
Dealt to a744d756 
Dealt to 5a0773bb 
9fa795bc: folds
a744d756: folds
5a0773bb: raises $0.05 to $0.1
Hero: folds
58fa799c: calls $0.08
dd5ee70a: folds
*** FLOP *** [8d 5c 6c]
58fa799c: checks
5a0773bb: checks
*** TURN *** [8d 5c 6c] [Qd]
58fa799c: bets $0.13
5a0773bb: calls $0.13
*** RIVER *** [8d 5c 6c Qd] [8c]
58fa799c: bets $0.41
5a0773bb: folds
Uncalled bet ($0.41) returned to 58fa799c
*** SHOWDOWN ***
58fa799c collected $0.49 from pot
*** SUMMARY ***
Total pot $0.51 | Rake $0.02 | Jackpot $0 | Bingo $0 | Fortune $0 | Tax $0
Board [8d 5c 6c Qd 8c]
Seat 1: Hero (button) folded before Flop (didn't bet)
Seat 2: 58fa799c (small blind) won ($0.49)
Seat 3: dd5ee70a (big blind) folded before Flop
Seat 4: 9fa795bc folded before Flop (didn't bet)
Seat 5: a744d756 folded before Flop (didn't bet)
Seat 6: 5a0773bb folded on the River


Poker Hand #RC3795420585: Hold'em No Limit ($0.02/$0.05) - 2025/08/10 02:31:10
Table 'RushAndCash10965845' 6-max Seat #1 is the button
Seat 1: 3205afd ($5.05 in chips)
Seat 2: 9b2ae90e ($4.02 in chips)
Seat 3: 40bea6c7 ($4.77 in chips)
Seat 4: Hero ($4.94 in chips)
Seat 5: d240a74 ($5.85 in chips)
Seat 6: e6507657 ($16.67 in chips)
9b2ae90e: posts small blind $0.02
40bea6c7: posts big blind $0.05
*** HOLE CARDS ***
Dealt to 3205afd 
Dealt to 9b2ae90e 
Dealt to 40bea6c7 
Dealt to Hero [3d 7c]
Dealt to d240a74 
Dealt to e6507657 
Hero: folds
d240a74: folds
e6507657: raises $0.08 to $0.13
3205afd: folds
9b2ae90e: folds
40bea6c7: folds
Uncalled bet ($0.08) returned to e6507657
*** SHOWDOWN ***
e6507657 collected $0.12 from pot
*** SUMMARY ***
Total pot $0.12 | Rake $0 | Jackpot $0 | Bingo $0 | Fortune $0 | Tax $0
Seat 1: 3205afd (button) folded before Flop (didn't bet)
Seat 2: 9b2ae90e (small blind) folded before Flop
Seat 3: 40bea6c7 (big blind) folded before Flop
Seat 4: Hero folded before Flop (didn't bet)
Seat 5: d240a74 folded before Flop (didn't bet)
Seat 6: e6507657 collected ($0.12)


Poker Hand #RC3795420561: Hold'em No Limit ($0.02/$0.05) - 2025/08/10 02:31:07
Table 'RushAndCash10965821' 6-max Seat #1 is the button
Seat 1: 5e31bb77 ($6.17 in chips)
Seat 2: cc73acc1 ($5 in chips)
Seat 3: ff04709c ($8.09 in chips)
Seat 4: 888094e2 ($5.11 in chips)
Seat 5: a4931689 ($10.43 in chips)
Seat 6: Hero ($4.94 in chips)
cc73acc1: posts small blind $0.02
ff04709c: posts big blind $0.05
*** HOLE CARDS ***
Dealt to 5e31bb77 
Dealt to cc73acc1 
Dealt to ff04709c 
Dealt to 888094e2 
Dealt to a4931689 
Dealt to Hero [9d 2c]
888094e2: folds
a4931689: folds
Hero: folds
5e31bb77: raises $0.05 to $0.1
cc73acc1: folds
ff04709c: calls $0.05
*** FLOP *** [8d 6c Qd]
ff04709c: checks
5e31bb77: bets $0.08
ff04709c: calls $0.08
*** TURN *** [8d 6c Qd] [3h]
ff04709c: checks
5e31bb77: bets $0.29
ff04709c: folds
Uncalled bet ($0.29) returned to 5e31bb77
*** SHOWDOWN ***
5e31bb77 collected $0.37 from pot
*** SUMMARY ***
Total pot $0.38 | Rake $0.01 | Jackpot $0 | Bingo $0 | Fortune $0 | Tax $0
Board [8d 6c Qd 3h]
Seat 1: 5e31bb77 (button) won ($0.37)
Seat 2: cc73acc1 (small blind) folded before Flop
Seat 3: ff04709c (big blind) folded on the Turn
Seat 4: 888094e2 folded before Flop (didn't bet)
Seat 5: a4931689 folded before Flop (didn't bet)
Seat 6: Hero folded before Flop (didn't bet)


Poker Hand #RC3795420446: Hold'em No Limit ($0.02/$0.05) - 2025/08/10 02:30:47
Table 'RushAndCash10965706' 6-max Seat #1 is the button
Seat 1: Hero ($4.94 in chips)
Seat 2: f1c7e07d ($5 in chips)
Seat 3: 710c102b ($5.62 in chips)
Seat 4: 2b32692e ($17.22 in chips)
Seat 5: 86bca4fd ($5.31 in chips)
Seat 6: ee9d96cb ($10.47 in chips)
f1c7e07d: posts small blind $0.02
710c102b: posts big blind $0.05
*** HOLE CARDS ***
Dealt to Hero [Qc 2d]
Dealt to f1c7e07d 
Dealt to 710c102b 
Dealt to 2b32692e 
Dealt to 86bca4fd 
Dealt to ee9d96cb 
2b32692e: folds
86bca4fd: folds
ee9d96cb: folds
Hero: folds
f1c7e07d: raises $0.05 to $0.1
710c102b: folds
Uncalled bet ($0.05) returned to f1c7e07d
*** SHOWDOWN ***
f1c7e07d collected $0.1 from pot
*** SUMMARY ***
Total pot $0.1 | Rake $0 | Jackpot $0 | Bingo $0 | Fortune $0 | Tax $0
Seat 1: Hero (button) folded before Flop (didn't bet)
Seat 2: f1c7e07d (small blind) collected ($0.1)
Seat 3: 710c102b (big blind) folded before Flop
Seat 4: 2b32692e folded before Flop (didn't bet)
Seat 5: 86bca4fd folded before Flop (didn't bet)
Seat 6: ee9d96cb folded before Flop (didn't bet)


Poker Hand #RC3795420226: Hold'em No Limit ($0.02/$0.05) - 2025/08/10 02:30:09
Table 'RushAndCash10965486' 6-max Seat #1 is the button
Seat 1: 912c2b8 ($4.62 in chips)
Seat 2: Hero ($5.07 in chips)
Seat 3: 12d4819b ($11.76 in chips)
Seat 4: af72addc ($5.65 in chips)
Seat 5: f4f482ee ($5.76 in chips)
Seat 6: 86bca4fd ($5.07 in chips)
Hero: posts small blind $0.02
12d4819b: posts big blind $0.05
*** HOLE CARDS ***
Dealt to 912c2b8 
Dealt to Hero [7s 7h]
Dealt to 12d4819b 
Dealt to af72addc 
Dealt to f4f482ee 
Dealt to 86bca4fd 
af72addc: folds
f4f482ee: folds
86bca4fd: raises $0.08 to $0.13
912c2b8: folds
Hero: calls $0.11
12d4819b: calls $0.08
*** FLOP *** [9d Kh 5s]
Hero: checks
12d4819b: checks
86bca4fd: bets $0.21
Hero: folds
12d4819b: folds
Uncalled bet ($0.21) returned to 86bca4fd
*** SHOWDOWN ***
86bca4fd collected $0.37 from pot
*** SUMMARY ***
Total pot $0.39 | Rake $0.02 | Jackpot $0 | Bingo $0 | Fortune $0 | Tax $0
Board [9d Kh 5s]
Seat 1: 912c2b8 (button) folded before Flop (didn't bet)
Seat 2: Hero (small blind) folded on the Flop
Seat 3: 12d4819b (big blind) folded on the Flop
Seat 4: af72addc folded before Flop (didn't bet)
Seat 5: f4f482ee folded before Flop (didn't bet)
Seat 6: 86bca4fd won ($0.37)


Poker Hand #RC3795419978: Hold'em No Limit ($0.02/$0.05) - 2025/08/10 02:29:25
Table 'RushAndCash10965238' 6-max Seat #1 is the button
Seat 1: 9611d997 ($5 in chips)
Seat 2: 80d282ad ($4.76 in chips)
Seat 3: Hero ($5.28 in chips)
Seat 4: 16e40141 ($5 in chips)
Seat 5: dd5ee70a ($4.83 in chips)
Seat 6: 12d4819b ($11.55 in chips)
80d282ad: posts small blind $0.02
Hero: posts big blind $0.05
*** HOLE CARDS ***
Dealt to 9611d997 
Dealt to 80d282ad 
Dealt to Hero [8h 9h]
Dealt to 16e40141 
Dealt to dd5ee70a 
Dealt to 12d4819b 
16e40141: folds
dd5ee70a: folds
12d4819b: raises $0.05 to $0.1
9611d997: folds
80d282ad: folds
Hero: calls $0.05
*** FLOP *** [Kc 9c Jc]
Hero: checks
12d4819b: bets $0.11
Hero: calls $0.11
*** TURN *** [Kc 9c Jc] [3d]
Hero: checks
12d4819b: bets $0.27
Hero: folds
Uncalled bet ($0.27) returned to 12d4819b
*** SHOWDOWN ***
12d4819b collected $0.42 from pot
*** SUMMARY ***
Total pot $0.44 | Rake $0.02 | Jackpot $0 | Bingo $0 | Fortune $0 | Tax $0
Board [Kc 9c Jc 3d]
Seat 1: 9611d997 (button) folded before Flop (didn't bet)
Seat 2: 80d282ad (small blind) folded before Flop
Seat 3: Hero (big blind) folded on the Turn
Seat 4: 16e40141 folded before Flop (didn't bet)
Seat 5: dd5ee70a folded before Flop (didn't bet)
Seat 6: 12d4819b won ($0.42)


Poker Hand #RC3795419928: Hold'em No Limit ($0.02/$0.05) - 2025/08/10 02:29:17
Table 'RushAndCash10965188' 6-max Seat #1 is the button
Seat 1: e3d383b0 ($4.51 in chips)
Seat 2: Hero ($5.3 in chips)
Seat 3: a0ddaed ($15.55 in chips)
Seat 4: 1495c66c ($5 in chips)
Seat 5: f3fd2a32 ($1.75 in chips)
Seat 6: 91ffc966 ($6.94 in chips)
Hero: posts small blind $0.02
a0ddaed: posts big blind $0.05
*** HOLE CARDS ***
Dealt to e3d383b0 
Dealt to Hero [9h Qd]
Dealt to a0ddaed 
Dealt to 1495c66c 
Dealt to f3fd2a32 
Dealt to 91ffc966 
1495c66c: folds
f3fd2a32: folds
91ffc966: folds
e3d383b0: raises $0.05 to $0.1
Hero: folds
a0ddaed: calls $0.05
*** FLOP *** [3s As 3h]
a0ddaed: checks
e3d383b0: bets $0.08
a0ddaed: calls $0.08
*** TURN *** [3s As 3h] [Tc]
a0ddaed: checks
e3d383b0: checks
*** RIVER *** [3s As 3h Tc] [2c]
a0ddaed: bets $0.19
e3d383b0: calls $0.19
a0ddaed: shows [6h Ah] (two pair, Aces and Threes)
e3d383b0: shows [Qs 2d] (two pair, Threes and Twos)
*** SHOWDOWN ***
a0ddaed collected $0.73 from pot
*** SUMMARY ***
Total pot $0.76 | Rake $0.03 | Jackpot $0 | Bingo $0 | Fortune $0 | Tax $0
Board [3s As 3h Tc 2c]
Seat 1: e3d383b0 (button) showed [Qs 2d] and lost with two pair, Threes and Twos
Seat 2: Hero (small blind) folded before Flop
Seat 3: a0ddaed (big blind) showed [6h Ah] and won ($0.73) with two pair, Aces and Threes
Seat 4: 1495c66c folded before Flop (didn't bet)
Seat 5: f3fd2a32 folded before Flop (didn't bet)
Seat 6: 91ffc966 folded before Flop (didn't bet)


Poker Hand #RC3795419902: Hold'em No Limit ($0.02/$0.05) - 2025/08/10 02:29:12
Table 'RushAndCash10965162' 6-max Seat #1 is the button
Seat 1: 679c5ea0 ($12.58 in chips)
Seat 2: a579ea8 ($4.32 in chips)
Seat 3: 4675642c ($17.16 in chips)
Seat 4: cf2ee802 ($3.02 in chips)
Seat 5: 76ef6bc6 ($13.26 in chips)
Seat 6: Hero ($5.3 in chips)
a579ea8: posts small blind $0.02
4675642c: posts big blind $0.05
*** HOLE CARDS ***
Dealt to 679c5ea0 
Dealt to a579ea8 
Dealt to 4675642c 
Dealt to cf2ee802 
Dealt to 76ef6bc6 
Dealt to Hero [Jh 3d]
cf2ee802: raises $0.05 to $0.1
76ef6bc6: folds
Hero: folds
679c5ea0: folds
a579ea8: folds
4675642c: folds
Uncalled bet ($0.05) returned to cf2ee802
*** SHOWDOWN ***
cf2ee802 collected $0.12 from pot
*** SUMMARY ***
Total pot $0.12 | Rake $0 | Jackpot $0 | Bingo $0 | Fortune $0 | Tax $0
Seat 1: 679c5ea0 (button) folded before Flop (didn't bet)
Seat 2: a579ea8 (small blind) folded before Flop
Seat 3: 4675642c (big blind) folded before Flop
Seat 4: cf2ee802 collected ($0.12)
Seat 5: 76ef6bc6 folded before Flop (didn't bet)
Seat 6: Hero folded before Flop (didn't bet)


Poker Hand #RC3795419880: Hold'em No Limit ($0.02/$0.05) - 2025/08/10 02:29:09
Table 'RushAndCash10965140' 6-max Seat #1 is the button
Seat 1: 696a490 ($8 in chips)
Seat 2: 5a2143e8 ($6.48 in chips)
Seat 3: b42f22c4 ($7.55 in chips)
Seat 4: 2b504dfd ($5 in chips)
Seat 5: daeab3be ($6.41 in chips)
Seat 6: Hero ($5.3 in chips)
5a2143e8: posts small blind $0.02
b42f22c4: posts big blind $0.05
*** HOLE CARDS ***
Dealt to 696a490 
Dealt to 5a2143e8 
Dealt to b42f22c4 
Dealt to 2b504dfd 
Dealt to daeab3be 
Dealt to Hero [9s Ah]
2b504dfd: folds
daeab3be: folds
Hero: folds
696a490: raises $0.1 to $0.15
5a2143e8: folds
b42f22c4: folds
Uncalled bet ($0.1) returned to 696a490
*** SHOWDOWN ***
696a490 collected $0.12 from pot
*** SUMMARY ***
Total pot $0.12 | Rake $0 | Jackpot $0 | Bingo $0 | Fortune $0 | Tax $0
Seat 1: 696a490 (button) collected ($0.12)
Seat 2: 5a2143e8 (small blind) folded before Flop
Seat 3: b42f22c4 (big blind) folded before Flop
Seat 4: 2b504dfd folded before Flop (didn't bet)
Seat 5: daeab3be folded before Flop (didn't bet)
Seat 6: Hero folded before Flop (didn't bet)


Poker Hand #RC3795419671: Hold'em No Limit ($0.02/$0.05) - 2025/08/10 02:28:33
Table 'RushAndCash10964931' 6-max Seat #1 is the button
Seat 1: 5c577d6b ($11.32 in chips)
Seat 2: 85387093 ($2.22 in chips)
Seat 3: 696a490 ($7.89 in chips)
Seat 4: e1f1512c ($4.91 in chips)
Seat 5: Hero ($5.4 in chips)
Seat 6: 62e651df ($5.7 in chips)
85387093: posts small blind $0.02
696a490: posts big blind $0.05
*** HOLE CARDS ***
Dealt to 5c577d6b 
Dealt to 85387093 
Dealt to 696a490 
Dealt to e1f1512c 
Dealt to Hero [Jh Tc]
Dealt to 62e651df 
e1f1512c: folds
Hero: raises $0.05 to $0.1
62e651df: folds
5c577d6b: folds
85387093: folds
696a490: raises $0.25 to $0.35
Hero: folds
Uncalled bet ($0.25) returned to 696a490
*** SHOWDOWN ***
696a490 collected $0.21 from pot
*** SUMMARY ***
Total pot $0.22 | Rake $0.01 | Jackpot $0 | Bingo $0 | Fortune $0 | Tax $0
Seat 1: 5c577d6b (button) folded before Flop (didn't bet)
Seat 2: 85387093 (small blind) folded before Flop
Seat 3: 696a490 (big blind) collected ($0.21)
Seat 4: e1f1512c folded before Flop (didn't bet)
Seat 5: Hero folded before Flop
Seat 6: 62e651df folded before Flop (didn't bet)


Poker Hand #RC3795419571: Hold'em No Limit ($0.02/$0.05) - 2025/08/10 02:28:15
Table 'RushAndCash10964831' 6-max Seat #1 is the button
Seat 1: Hero ($5.4 in chips)
Seat 2: 99376de ($19.53 in chips)
Seat 3: d9d39bb8 ($5.16 in chips)
Seat 4: 4de1fa9b ($6.09 in chips)
Seat 5: 435e1e6c ($6.16 in chips)
Seat 6: 2d00432d ($5.62 in chips)
99376de: posts small blind $0.02
d9d39bb8: posts big blind $0.05
*** HOLE CARDS ***
Dealt to Hero [8h 6d]
Dealt to 99376de 
Dealt to d9d39bb8 
Dealt to 4de1fa9b 
Dealt to 435e1e6c 
Dealt to 2d00432d 
4de1fa9b: calls $0.05
435e1e6c: folds
2d00432d: folds
Hero: folds
99376de: folds
d9d39bb8: checks
*** FLOP *** [5c 4c Ah]
d9d39bb8: checks
4de1fa9b: bets $0.06
d9d39bb8: calls $0.06
*** TURN *** [5c 4c Ah] [6h]
d9d39bb8: checks
4de1fa9b: bets $0.12
d9d39bb8: folds
Uncalled bet ($0.12) returned to 4de1fa9b
*** SHOWDOWN ***
4de1fa9b collected $0.23 from pot
*** SUMMARY ***
Total pot $0.24 | Rake $0.01 | Jackpot $0 | Bingo $0 | Fortune $0 | Tax $0
Board [5c 4c Ah 6h]
Seat 1: Hero (button) folded before Flop (didn't bet)
Seat 2: 99376de (small blind) folded before Flop
Seat 3: d9d39bb8 (big blind) folded on the Turn
Seat 4: 4de1fa9b won ($0.23)
Seat 5: 435e1e6c folded before Flop (didn't bet)
Seat 6: 2d00432d folded before Flop (didn't bet)


Poker Hand #RC3795419542: Hold'em No Limit ($0.02/$0.05) - 2025/08/10 02:28:10
Table 'RushAndCash10964802' 6-max Seat #1 is the button
Seat 1: 17550682 ($8.21 in chips)
Seat 2: Hero ($5.42 in chips)
Seat 3: 2b504dfd ($5 in chips)
Seat 4: f6b23cb7 ($5.9 in chips)
Seat 5: 915746c1 ($6.83 in chips)
Seat 6: f4ead22b ($9.06 in chips)
Hero: posts small blind $0.02
2b504dfd: posts big blind $0.05
*** HOLE CARDS ***
Dealt to 17550682 
Dealt to Hero [2d Ts]
Dealt to 2b504dfd 
Dealt to f6b23cb7 
Dealt to 915746c1 
Dealt to f4ead22b 
f6b23cb7: folds
915746c1: folds
f4ead22b: folds
17550682: raises $0.08 to $0.13
Hero: folds
2b504dfd: folds
Uncalled bet ($0.08) returned to 17550682
*** SHOWDOWN ***
17550682 collected $0.12 from pot
*** SUMMARY ***
Total pot $0.12 | Rake $0 | Jackpot $0 | Bingo $0 | Fortune $0 | Tax $0
Seat 1: 17550682 (button) collected ($0.12)
Seat 2: Hero (small blind) folded before Flop
Seat 3: 2b504dfd (big blind) folded before Flop
Seat 4: f6b23cb7 folded before Flop (didn't bet)
Seat 5: 915746c1 folded before Flop (didn't bet)
Seat 6: f4ead22b folded before Flop (didn't bet)


Poker Hand #RC3795419087: Hold'em No Limit ($0.02/$0.05) - 2025/08/10 02:26:53
Table 'RushAndCash10964347' 6-max Seat #1 is the button
Seat 1: 192d221d ($4.19 in chips)
Seat 2: 915746c1 ($6.1 in chips)
Seat 3: Hero ($6.3 in chips)
Seat 4: a3adc721 ($1.97 in chips)
Seat 5: ab9bbdab ($4.28 in chips)
Seat 6: acf679b2 ($2.12 in chips)
915746c1: posts small blind $0.02
Hero: posts big blind $0.05
*** HOLE CARDS ***
Dealt to 192d221d 
Dealt to 915746c1 
Dealt to Hero [Js 8h]
Dealt to a3adc721 
Dealt to ab9bbdab 
Dealt to acf679b2 
a3adc721: folds
ab9bbdab: folds
acf679b2: folds
192d221d: folds
915746c1: raises $0.08 to $0.13
Hero: calls $0.08
*** FLOP *** [6d 5d 5s]
915746c1: checks
Hero: checks
*** TURN *** [6d 5d 5s] [3s]
915746c1: checks
Hero: bets $0.13
915746c1: calls $0.13
*** RIVER *** [6d 5d 5s 3s] [7d]
915746c1: checks
Hero: bets $0.62
915746c1: raises $1.32 to $1.94
Hero: folds
Uncalled bet ($1.32) returned to 915746c1
*** SHOWDOWN ***
915746c1 collected $1.61 from pot
*** SUMMARY ***
Total pot $1.76 | Rake $0.08 | Jackpot $0.07 | Bingo $0 | Fortune $0 | Tax $0
Board [6d 5d 5s 3s 7d]
Seat 1: 192d221d (button) folded before Flop (didn't bet)
Seat 2: 915746c1 (small blind) won ($1.61)
Seat 3: Hero (big blind) folded on the River
Seat 4: a3adc721 folded before Flop (didn't bet)
Seat 5: ab9bbdab folded before Flop (didn't bet)
Seat 6: acf679b2 folded before Flop (didn't bet)


Poker Hand #RC3795419064: Hold'em No Limit ($0.02/$0.05) - 2025/08/10 02:26:50
Table 'RushAndCash10964324' 6-max Seat #1 is the button
Seat 1: a79d47fb ($5.83 in chips)
Seat 2: dd5ee70a ($4.35 in chips)
Seat 3: 712a2078 ($14.3 in chips)
Seat 4: Hero ($6.3 in chips)
Seat 5: 94c5fa01 ($5.27 in chips)
Seat 6: 76ef6bc6 ($13.06 in chips)
dd5ee70a: posts small blind $0.02
712a2078: posts big blind $0.05
*** HOLE CARDS ***
Dealt to a79d47fb 
Dealt to dd5ee70a 
Dealt to 712a2078 
Dealt to Hero [3s Tc]
Dealt to 94c5fa01 
Dealt to 76ef6bc6 
Hero: folds
94c5fa01: folds
76ef6bc6: folds
a79d47fb: folds
dd5ee70a: folds
Uncalled bet ($0.03) returned to 712a2078
*** SHOWDOWN ***
712a2078 collected $0.04 from pot
*** SUMMARY ***
Total pot $0.04 | Rake $0 | Jackpot $0 | Bingo $0 | Fortune $0 | Tax $0
Seat 1: a79d47fb (button) folded before Flop (didn't bet)
Seat 2: dd5ee70a (small blind) folded before Flop
Seat 3: 712a2078 (big blind) collected ($0.04)
Seat 4: Hero folded before Flop (didn't bet)
Seat 5: 94c5fa01 folded before Flop (didn't bet)
Seat 6: 76ef6bc6 folded before Flop (didn't bet)


Poker Hand #RC3795419046: Hold'em No Limit ($0.02/$0.05) - 2025/08/10 02:26:46
Table 'RushAndCash10964306' 6-max Seat #1 is the button
Seat 1: acf679b2 ($2.12 in chips)
Seat 2: 52ac8d1c ($13.9 in chips)
Seat 3: 58fa799c ($8.53 in chips)
Seat 4: Hero ($6.3 in chips)
Seat 5: 51270fe ($5.13 in chips)
Seat 6: 1d709ff6 ($5 in chips)
52ac8d1c: posts small blind $0.02
58fa799c: posts big blind $0.05
*** HOLE CARDS ***
Dealt to acf679b2 
Dealt to 52ac8d1c 
Dealt to 58fa799c 
Dealt to Hero [Jh 4s]
Dealt to 51270fe 
Dealt to 1d709ff6 
Hero: folds
51270fe: raises $0.1 to $0.15
1d709ff6: folds
acf679b2: folds
52ac8d1c: folds
58fa799c: folds
Uncalled bet ($0.1) returned to 51270fe
*** SHOWDOWN ***
51270fe collected $0.12 from pot
*** SUMMARY ***
Total pot $0.12 | Rake $0 | Jackpot $0 | Bingo $0 | Fortune $0 | Tax $0
Seat 1: acf679b2 (button) folded before Flop (didn't bet)
Seat 2: 52ac8d1c (small blind) folded before Flop
Seat 3: 58fa799c (big blind) folded before Flop
Seat 4: Hero folded before Flop (didn't bet)
Seat 5: 51270fe collected ($0.12)
Seat 6: 1d709ff6 folded before Flop (didn't bet)


Poker Hand #RC3795419027: Hold'em No Limit ($0.02/$0.05) - 2025/08/10 02:26:43
Table 'RushAndCash10964287' 6-max Seat #1 is the button
Seat 1: 4c2390ac ($5 in chips)
Seat 2: 187dd5e5 ($5.16 in chips)
Seat 3: c251cc1b ($5.79 in chips)
Seat 4: db846cc6 ($5.4 in chips)
Seat 5: Hero ($6.3 in chips)
Seat 6: 5193ed0c ($5.05 in chips)
187dd5e5: posts small blind $0.02
c251cc1b: posts big blind $0.05
*** HOLE CARDS ***
Dealt to 4c2390ac 
Dealt to 187dd5e5 
Dealt to c251cc1b 
Dealt to db846cc6 
Dealt to Hero [7c 5h]
Dealt to 5193ed0c 
db846cc6: folds
Hero: folds
5193ed0c: folds
4c2390ac: raises $0.05 to $0.1
187dd5e5: raises $0.2 to $0.3
c251cc1b: folds
4c2390ac: folds
Uncalled bet ($0.2) returned to 187dd5e5
*** SHOWDOWN ***
187dd5e5 collected $0.24 from pot
*** SUMMARY ***
Total pot $0.25 | Rake $0.01 | Jackpot $0 | Bingo $0 | Fortune $0 | Tax $0
Seat 1: 4c2390ac (button) folded before Flop
Seat 2: 187dd5e5 (small blind) collected ($0.24)
Seat 3: c251cc1b (big blind) folded before Flop
Seat 4: db846cc6 folded before Flop (didn't bet)
Seat 5: Hero folded before Flop (didn't bet)
Seat 6: 5193ed0c folded before Flop (didn't bet)


Poker Hand #RC3795419006: Hold'em No Limit ($0.02/$0.05) - 2025/08/10 02:26:39
Table 'RushAndCash10964266' 6-max Seat #1 is the button
Seat 1: db846cc6 ($5.4 in chips)
Seat 2: 938d3763 ($17.65 in chips)
Seat 3: 48ecb088 ($5 in chips)
Seat 4: cadc02ef ($5 in chips)
Seat 5: Hero ($6.3 in chips)
Seat 6: 970372f9 ($5.42 in chips)
938d3763: posts small blind $0.02
48ecb088: posts big blind $0.05
*** HOLE CARDS ***
Dealt to db846cc6 
Dealt to 938d3763 
Dealt to 48ecb088 
Dealt to cadc02ef 
Dealt to Hero [3c 5c]
Dealt to 970372f9 
cadc02ef: raises $0.05 to $0.1
Hero: folds
970372f9: folds
db846cc6: folds
938d3763: folds
48ecb088: folds
Uncalled bet ($0.05) returned to cadc02ef
*** SHOWDOWN ***
cadc02ef collected $0.12 from pot
*** SUMMARY ***
Total pot $0.12 | Rake $0 | Jackpot $0 | Bingo $0 | Fortune $0 | Tax $0
Seat 1: db846cc6 (button) folded before Flop (didn't bet)
Seat 2: 938d3763 (small blind) folded before Flop
Seat 3: 48ecb088 (big blind) folded before Flop
Seat 4: cadc02ef collected ($0.12)
Seat 5: Hero folded before Flop (didn't bet)
Seat 6: 970372f9 folded before Flop (didn't bet)


Poker Hand #RC3795418977: Hold'em No Limit ($0.02/$0.05) - 2025/08/10 02:26:33
Table 'RushAndCash10964237' 6-max Seat #1 is the button
Seat 1: 79f98251 ($9.82 in chips)
Seat 2: 24b60f06 ($5.47 in chips)
Seat 3: 1037db79 ($7.33 in chips)
Seat 4: Hero ($6.3 in chips)
Seat 5: 94330b0b ($9.69 in chips)
Seat 6: 4da3a60d ($5 in chips)
24b60f06: posts small blind $0.02
1037db79: posts big blind $0.05
*** HOLE CARDS ***
Dealt to 79f98251 
Dealt to 24b60f06 
Dealt to 1037db79 
Dealt to Hero [Jc 2c]
Dealt to 94330b0b 
Dealt to 4da3a60d 
Hero: folds
94330b0b: folds
4da3a60d: raises $0.05 to $0.1
79f98251: folds
24b60f06: folds
1037db79: folds
Uncalled bet ($0.05) returned to 4da3a60d
*** SHOWDOWN ***
4da3a60d collected $0.12 from pot
*** SUMMARY ***
Total pot $0.12 | Rake $0 | Jackpot $0 | Bingo $0 | Fortune $0 | Tax $0
Seat 1: 79f98251 (button) folded before Flop (didn't bet)
Seat 2: 24b60f06 (small blind) folded before Flop
Seat 3: 1037db79 (big blind) folded before Flop
Seat 4: Hero folded before Flop (didn't bet)
Seat 5: 94330b0b folded before Flop (didn't bet)
Seat 6: 4da3a60d collected ($0.12)


Poker Hand #RC3795418863: Hold'em No Limit ($0.02/$0.05) - 2025/08/10 02:26:13
Table 'RushAndCash10964123' 6-max Seat #1 is the button
Seat 1: 9efe33b0 ($9.68 in chips)
Seat 2: Hero ($6.32 in chips)
Seat 3: f617d80c ($5.21 in chips)
Seat 4: 7ba30c43 ($6.37 in chips)
Seat 5: bd8827c8 ($5.85 in chips)
Seat 6: 4780776f ($7.99 in chips)
Hero: posts small blind $0.02
f617d80c: posts big blind $0.05
*** HOLE CARDS ***
Dealt to 9efe33b0 
Dealt to Hero [2h Kc]
Dealt to f617d80c 
Dealt to 7ba30c43 
Dealt to bd8827c8 
Dealt to 4780776f 
7ba30c43: folds
bd8827c8: folds
4780776f: raises $0.07 to $0.12
9efe33b0: folds
Hero: folds
f617d80c: folds
Uncalled bet ($0.07) returned to 4780776f
*** SHOWDOWN ***
4780776f collected $0.12 from pot
*** SUMMARY ***
Total pot $0.12 | Rake $0 | Jackpot $0 | Bingo $0 | Fortune $0 | Tax $0
Seat 1: 9efe33b0 (button) folded before Flop (didn't bet)
Seat 2: Hero (small blind) folded before Flop
Seat 3: f617d80c (big blind) folded before Flop
Seat 4: 7ba30c43 folded before Flop (didn't bet)
Seat 5: bd8827c8 folded before Flop (didn't bet)
Seat 6: 4780776f collected ($0.12)


Poker Hand #RC3795418803: Hold'em No Limit ($0.02/$0.05) - 2025/08/10 02:26:02
Table 'RushAndCash10964063' 6-max Seat #1 is the button
Seat 1: 3334eae3 ($9.02 in chips)
Seat 2: 203b73b4 ($5.78 in chips)
Seat 3: Hero ($6.37 in chips)
Seat 4: f4ead22b ($9.19 in chips)
Seat 5: 82a34580 ($10.15 in chips)
Seat 6: 7827d82d ($12.28 in chips)
203b73b4: posts small blind $0.02
Hero: posts big blind $0.05
*** HOLE CARDS ***
Dealt to 3334eae3 
Dealt to 203b73b4 
Dealt to Hero [2d 9c]
Dealt to f4ead22b 
Dealt to 82a34580 
Dealt to 7827d82d 
f4ead22b: raises $0.08 to $0.13
82a34580: folds
7827d82d: folds
3334eae3: folds
203b73b4: folds
Hero: folds
Uncalled bet ($0.08) returned to f4ead22b
*** SHOWDOWN ***
f4ead22b collected $0.12 from pot
*** SUMMARY ***
Total pot $0.12 | Rake $0 | Jackpot $0 | Bingo $0 | Fortune $0 | Tax $0
Seat 1: 3334eae3 (button) folded before Flop (didn't bet)
Seat 2: 203b73b4 (small blind) folded before Flop
Seat 3: Hero (big blind) folded before Flop
Seat 4: f4ead22b collected ($0.12)
Seat 5: 82a34580 folded before Flop (didn't bet)
Seat 6: 7827d82d folded before Flop (didn't bet)


Poker Hand #RC3795418754: Hold'em No Limit ($0.02/$0.05) - 2025/08/10 02:25:54
Table 'RushAndCash10964014' 6-max Seat #1 is the button
Seat 1: Hero ($6.37 in chips)
Seat 2: 9efe33b0 ($9.7 in chips)
Seat 3: 7f7620a ($5.07 in chips)
Seat 4: f5f760a7 ($5 in chips)
Seat 5: 679c5ea0 ($11.43 in chips)
Seat 6: 23fdfb4c ($5.26 in chips)
9efe33b0: posts small blind $0.02
7f7620a: posts big blind $0.05
*** HOLE CARDS ***
Dealt to Hero [8h Kc]
Dealt to 9efe33b0 
Dealt to 7f7620a 
Dealt to f5f760a7 
Dealt to 679c5ea0 
Dealt to 23fdfb4c 
f5f760a7: folds
679c5ea0: folds
23fdfb4c: folds
Hero: folds
9efe33b0: folds
Uncalled bet ($0.03) returned to 7f7620a
*** SHOWDOWN ***
7f7620a collected $0.04 from pot
*** SUMMARY ***
Total pot $0.04 | Rake $0 | Jackpot $0 | Bingo $0 | Fortune $0 | Tax $0
Seat 1: Hero (button) folded before Flop (didn't bet)
Seat 2: 9efe33b0 (small blind) folded before Flop
Seat 3: 7f7620a (big blind) collected ($0.04)
Seat 4: f5f760a7 folded before Flop (didn't bet)
Seat 5: 679c5ea0 folded before Flop (didn't bet)
Seat 6: 23fdfb4c folded before Flop (didn't bet)


Poker Hand #RC3795418736: Hold'em No Limit ($0.02/$0.05) - 2025/08/10 02:25:50
Table 'RushAndCash10963996' 6-max Seat #1 is the button
Seat 1: ce517e5d ($14.28 in chips)
Seat 2: 19bfbfd2 ($5.93 in chips)
Seat 3: 7e944648 ($37.76 in chips)
Seat 4: Hero ($6.37 in chips)
Seat 5: f5f760a7 ($5 in chips)
Seat 6: 7f7620a ($5.07 in chips)
19bfbfd2: posts small blind $0.02
7e944648: posts big blind $0.05
*** HOLE CARDS ***
Dealt to ce517e5d 
Dealt to 19bfbfd2 
Dealt to 7e944648 
Dealt to Hero [6d 9c]
Dealt to f5f760a7 
Dealt to 7f7620a 
Hero: folds
f5f760a7: folds
7f7620a: folds
ce517e5d: folds
19bfbfd2: folds
Uncalled bet ($0.03) returned to 7e944648
*** SHOWDOWN ***
7e944648 collected $0.04 from pot
*** SUMMARY ***
Total pot $0.04 | Rake $0 | Jackpot $0 | Bingo $0 | Fortune $0 | Tax $0
Seat 1: ce517e5d (button) folded before Flop (didn't bet)
Seat 2: 19bfbfd2 (small blind) folded before Flop
Seat 3: 7e944648 (big blind) collected ($0.04)
Seat 4: Hero folded before Flop (didn't bet)
Seat 5: f5f760a7 folded before Flop (didn't bet)
Seat 6: 7f7620a folded before Flop (didn't bet)


Poker Hand #RC3795418612: Hold'em No Limit ($0.02/$0.05) - 2025/08/10 02:25:28
Table 'RushAndCash10963872' 6-max Seat #1 is the button
Seat 1: Hero ($6.37 in chips)
Seat 2: 7a6e7f96 ($5.08 in chips)
Seat 3: 7e60d7cc ($10.88 in chips)
Seat 4: d3a35f6b ($6.57 in chips)
Seat 5: 1f2e397c ($5.57 in chips)
Seat 6: f3a1d090 ($15.64 in chips)
7a6e7f96: posts small blind $0.02
7e60d7cc: posts big blind $0.05
*** HOLE CARDS ***
Dealt to Hero [4d 6h]
Dealt to 7a6e7f96 
Dealt to 7e60d7cc 
Dealt to d3a35f6b 
Dealt to 1f2e397c 
Dealt to f3a1d090 
d3a35f6b: folds
1f2e397c: raises $0.06 to $0.11
f3a1d090: folds
Hero: folds
7a6e7f96: folds
7e60d7cc: calls $0.06
*** FLOP *** [4c Ts 8d]
7e60d7cc: checks
1f2e397c: checks
*** TURN *** [4c Ts 8d] [As]
7e60d7cc: checks
1f2e397c: bets $0.12
7e60d7cc: raises $0.36 to $0.48
1f2e397c: calls $0.36
*** RIVER *** [4c Ts 8d As] [Qs]
7e60d7cc: checks
1f2e397c: checks
7e60d7cc: shows [Ac 8c] (two pair, Aces and Eights)
1f2e397c: shows [Kh Ad] (a pair of Aces)
*** SHOWDOWN ***
7e60d7cc collected $1.14 from pot
*** SUMMARY ***
Total pot $1.2 | Rake $0.06 | Jackpot $0 | Bingo $0 | Fortune $0 | Tax $0
Board [4c Ts 8d As Qs]
Seat 1: Hero (button) folded before Flop (didn't bet)
Seat 2: 7a6e7f96 (small blind) folded before Flop
Seat 3: 7e60d7cc (big blind) showed [Ac 8c] and won ($1.14) with two pair, Aces and Eights
Seat 4: d3a35f6b folded before Flop (didn't bet)
Seat 5: 1f2e397c showed [Kh Ad] and lost with a pair of Aces
Seat 6: f3a1d090 folded before Flop (didn't bet)


Poker Hand #RC3795418509: Hold'em No Limit ($0.02/$0.05) - 2025/08/10 02:25:11
Table 'RushAndCash10963769' 6-max Seat #1 is the button
Seat 1: 212f90cc ($3.54 in chips)
Seat 2: 9ae88339 ($0.92 in chips)
Seat 3: Hero ($6.35 in chips)
Seat 4: ae33334 ($6.89 in chips)
Seat 5: 8d89f669 ($3.1 in chips)
Seat 6: f4ead22b ($9.31 in chips)
9ae88339: posts small blind $0.02
Hero: posts big blind $0.05
*** HOLE CARDS ***
Dealt to 212f90cc 
Dealt to 9ae88339 
Dealt to Hero [Jc As]
Dealt to ae33334 
Dealt to 8d89f669 
Dealt to f4ead22b 
ae33334: folds
8d89f669: folds
f4ead22b: folds
212f90cc: folds
9ae88339: folds
Uncalled bet ($0.03) returned to Hero
*** SHOWDOWN ***
Hero collected $0.04 from pot
*** SUMMARY ***
Total pot $0.04 | Rake $0 | Jackpot $0 | Bingo $0 | Fortune $0 | Tax $0
Seat 1: 212f90cc (button) folded before Flop (didn't bet)
Seat 2: 9ae88339 (small blind) folded before Flop
Seat 3: Hero (big blind) collected ($0.04)
Seat 4: ae33334 folded before Flop (didn't bet)
Seat 5: 8d89f669 folded before Flop (didn't bet)
Seat 6: f4ead22b folded before Flop (didn't bet)


Poker Hand #RC3795418344: Hold'em No Limit ($0.02/$0.05) - 2025/08/10 02:24:42
Table 'RushAndCash10963604' 6-max Seat #1 is the button
Seat 1: e0b0eff3 ($4.33 in chips)
Seat 2: Hero ($6.15 in chips)
Seat 3: 4595dc87 ($4.25 in chips)
Seat 4: 69f37b0e ($5 in chips)
Seat 5: e8054191 ($5.44 in chips)
Seat 6: 64ff32e3 ($6.53 in chips)
Hero: posts small blind $0.02
4595dc87: posts big blind $0.05
*** HOLE CARDS ***
Dealt to e0b0eff3 
Dealt to Hero [Td Qd]
Dealt to 4595dc87 
Dealt to 69f37b0e 
Dealt to e8054191 
Dealt to 64ff32e3 
69f37b0e: folds
e8054191: folds
64ff32e3: folds
e0b0eff3: folds
Hero: raises $0.05 to $0.1
4595dc87: calls $0.05
*** FLOP *** [3d 3c 4s]
Hero: bets $0.12
4595dc87: calls $0.12
*** TURN *** [3d 3c 4s] [7d]
Hero: bets $0.52
4595dc87: folds
Uncalled bet ($0.52) returned to Hero
*** SHOWDOWN ***
Hero collected $0.42 from pot
*** SUMMARY ***
Total pot $0.44 | Rake $0.02 | Jackpot $0 | Bingo $0 | Fortune $0 | Tax $0
Board [3d 3c 4s 7d]
Seat 1: e0b0eff3 (button) folded before Flop (didn't bet)
Seat 2: Hero (small blind) won ($0.42)
Seat 3: 4595dc87 (big blind) folded on the Turn
Seat 4: 69f37b0e folded before Flop (didn't bet)
Seat 5: e8054191 folded before Flop (didn't bet)
Seat 6: 64ff32e3 folded before Flop (didn't bet)


Poker Hand #RC3795418242: Hold'em No Limit ($0.02/$0.05) - 2025/08/10 02:24:24
Table 'RushAndCash10963502' 6-max Seat #1 is the button
Seat 1: a579ea8 ($4.42 in chips)
Seat 2: 53b13f90 ($10.11 in chips)
Seat 3: e0b0eff3 ($4.4 in chips)
Seat 4: 6728f33c ($9.17 in chips)
Seat 5: 359b44cd ($5.94 in chips)
Seat 6: Hero ($6.08 in chips)
53b13f90: posts small blind $0.02
e0b0eff3: posts big blind $0.05
*** HOLE CARDS ***
Dealt to a579ea8 
Dealt to 53b13f90 
Dealt to e0b0eff3 
Dealt to 6728f33c 
Dealt to 359b44cd 
Dealt to Hero [Th Ad]
6728f33c: folds
359b44cd: folds
Hero: raises $0.05 to $0.1
a579ea8: folds
53b13f90: folds
e0b0eff3: folds
Uncalled bet ($0.05) returned to Hero
*** SHOWDOWN ***
Hero collected $0.12 from pot
*** SUMMARY ***
Total pot $0.12 | Rake $0 | Jackpot $0 | Bingo $0 | Fortune $0 | Tax $0
Seat 1: a579ea8 (button) folded before Flop (didn't bet)
Seat 2: 53b13f90 (small blind) folded before Flop
Seat 3: e0b0eff3 (big blind) folded before Flop
Seat 4: 6728f33c folded before Flop (didn't bet)
Seat 5: 359b44cd folded before Flop (didn't bet)
Seat 6: Hero collected ($0.12)


Poker Hand #RC3795417912: Hold'em No Limit ($0.02/$0.05) - 2025/08/10 02:23:28
Table 'RushAndCash10963172' 6-max Seat #1 is the button
Seat 1: 69d54b5d ($5.1 in chips)
Seat 2: 35c8517c ($11.89 in chips)
Seat 3: ba28deb ($6.49 in chips)
Seat 4: 1dafb1bc ($13.02 in chips)
Seat 5: ad44a40 ($5.19 in chips)
Seat 6: Hero ($6.08 in chips)
35c8517c: posts small blind $0.02
ba28deb: posts big blind $0.05
*** HOLE CARDS ***
Dealt to 69d54b5d 
Dealt to 35c8517c 
Dealt to ba28deb 
Dealt to 1dafb1bc 
Dealt to ad44a40 
Dealt to Hero [2s 3s]
1dafb1bc: folds
ad44a40: folds
Hero: folds
69d54b5d: raises $0.05 to $0.1
35c8517c: calls $0.08
ba28deb: folds
*** FLOP *** [9d 6s Ah]
35c8517c: checks
69d54b5d: bets $0.2
35c8517c: folds
Uncalled bet ($0.2) returned to 69d54b5d
*** SHOWDOWN ***
69d54b5d collected $0.24 from pot
*** SUMMARY ***
Total pot $0.25 | Rake $0.01 | Jackpot $0 | Bingo $0 | Fortune $0 | Tax $0
Board [9d 6s Ah]
Seat 1: 69d54b5d (button) won ($0.24)
Seat 2: 35c8517c (small blind) folded on the Flop
Seat 3: ba28deb (big blind) folded before Flop
Seat 4: 1dafb1bc folded before Flop (didn't bet)
Seat 5: ad44a40 folded before Flop (didn't bet)
Seat 6: Hero folded before Flop (didn't bet)


Poker Hand #RC3795417830: Hold'em No Limit ($0.02/$0.05) - 2025/08/10 02:23:15
Table 'RushAndCash10963090' 6-max Seat #1 is the button
Seat 1: e0461ef9 ($9 in chips)
Seat 2: Hero ($6.1 in chips)
Seat 3: 52ac8d1c ($14.96 in chips)
Seat 4: f7ce4e8 ($6.94 in chips)
Seat 5: 7656ad46 ($9.71 in chips)
Seat 6: cda08fd1 ($7.62 in chips)
Hero: posts small blind $0.02
52ac8d1c: posts big blind $0.05
*** HOLE CARDS ***
Dealt to e0461ef9 
Dealt to Hero [Ad 3h]
Dealt to 52ac8d1c 
Dealt to f7ce4e8 
Dealt to 7656ad46 
Dealt to cda08fd1 
f7ce4e8: folds
7656ad46: folds
cda08fd1: folds
e0461ef9: folds
Hero: folds
Uncalled bet ($0.03) returned to 52ac8d1c
*** SHOWDOWN ***
52ac8d1c collected $0.04 from pot
*** SUMMARY ***
Total pot $0.04 | Rake $0 | Jackpot $0 | Bingo $0 | Fortune $0 | Tax $0
Seat 1: e0461ef9 (button) folded before Flop (didn't bet)
Seat 2: Hero (small blind) folded before Flop
Seat 3: 52ac8d1c (big blind) collected ($0.04)
Seat 4: f7ce4e8 folded before Flop (didn't bet)
Seat 5: 7656ad46 folded before Flop (didn't bet)
Seat 6: cda08fd1 folded before Flop (didn't bet)


Poker Hand #RC3795417808: Hold'em No Limit ($0.02/$0.05) - 2025/08/10 02:23:12
Table 'RushAndCash10963068' 6-max Seat #1 is the button
Seat 1: 448e261d ($22.12 in chips)
Seat 2: f88e0ca8 ($5.02 in chips)
Seat 3: 938d3763 ($19.47 in chips)
Seat 4: f2fec87b ($3.62 in chips)
Seat 5: Hero ($6.1 in chips)
Seat 6: 66cca958 ($5 in chips)
f88e0ca8: posts small blind $0.02
938d3763: posts big blind $0.05
*** HOLE CARDS ***
Dealt to 448e261d 
Dealt to f88e0ca8 
Dealt to 938d3763 
Dealt to f2fec87b 
Dealt to Hero [4d Qc]
Dealt to 66cca958 
f2fec87b: folds
Hero: folds
66cca958: folds
448e261d: folds
f88e0ca8: calls $0.03
938d3763: checks
*** FLOP *** [8d 3c 5s]
f88e0ca8: checks
938d3763: checks
*** TURN *** [8d 3c 5s] [4c]
f88e0ca8: bets $0.05
938d3763: folds
Uncalled bet ($0.05) returned to f88e0ca8
*** SHOWDOWN ***
f88e0ca8 collected $0.1 from pot
*** SUMMARY ***
Total pot $0.1 | Rake $0 | Jackpot $0 | Bingo $0 | Fortune $0 | Tax $0
Board [8d 3c 5s 4c]
Seat 1: 448e261d (button) folded before Flop (didn't bet)
Seat 2: f88e0ca8 (small blind) won ($0.1)
Seat 3: 938d3763 (big blind) folded on the Turn
Seat 4: f2fec87b folded before Flop (didn't bet)
Seat 5: Hero folded before Flop (didn't bet)
Seat 6: 66cca958 folded before Flop (didn't bet)


Poker Hand #RC3795417394: Hold'em No Limit ($0.02/$0.05) - 2025/08/10 02:22:01
Table 'RushAndCash10962654' 6-max Seat #1 is the button
Seat 1: 710c102b ($5.07 in chips)
Seat 2: 938d3763 ($20.38 in chips)
Seat 3: Hero ($5.34 in chips)
Seat 4: 6728f33c ($8.76 in chips)
Seat 5: 7abebecf ($4.93 in chips)
Seat 6: 32a59565 ($18.11 in chips)
938d3763: posts small blind $0.02
Hero: posts big blind $0.05
*** HOLE CARDS ***
Dealt to 710c102b 
Dealt to 938d3763 
Dealt to Hero [Qh Td]
Dealt to 6728f33c 
Dealt to 7abebecf 
Dealt to 32a59565 
6728f33c: folds
7abebecf: folds
32a59565: folds
710c102b: folds
938d3763: calls $0.03
Hero: checks
*** FLOP *** [Ah Jc 7c]
938d3763: checks
Hero: checks
*** TURN *** [Ah Jc 7c] [2h]
938d3763: checks
Hero: checks
*** RIVER *** [Ah Jc 7c 2h] [Kc]
938d3763: bets $0.86
Hero: calls $0.86
938d3763: shows [Ad As] (three of a kind, Aces)
Hero: shows [Qh Td] (a straight, Ace to Ten)
*** SHOWDOWN ***
Hero collected $1.67 from pot
*** SUMMARY ***
Total pot $1.82 | Rake $0.08 | Jackpot $0.07 | Bingo $0 | Fortune $0 | Tax $0
Board [Ah Jc 7c 2h Kc]
Seat 1: 710c102b (button) folded before Flop (didn't bet)
Seat 2: 938d3763 (small blind) showed [Ad As] and lost with three of a kind, Aces
Seat 3: Hero (big blind) showed [Qh Td] and won ($1.67) with a straight, Ace to Ten
Seat 4: 6728f33c folded before Flop (didn't bet)
Seat 5: 7abebecf folded before Flop (didn't bet)
Seat 6: 32a59565 folded before Flop (didn't bet)


Poker Hand #RC3795417371: Hold'em No Limit ($0.02/$0.05) - 2025/08/10 02:21:57
Table 'RushAndCash10962631' 6-max Seat #1 is the button
Seat 1: ebe5f93a ($3.04 in chips)
Seat 2: ab9bbdab ($5 in chips)
Seat 3: ad44a40 ($5 in chips)
Seat 4: cb80c9e ($13.88 in chips)
Seat 5: 938d3763 ($20.38 in chips)
Seat 6: Hero ($5.34 in chips)
ab9bbdab: posts small blind $0.02
ad44a40: posts big blind $0.05
*** HOLE CARDS ***
Dealt to ebe5f93a 
Dealt to ab9bbdab 
Dealt to ad44a40 
Dealt to cb80c9e 
Dealt to 938d3763 
Dealt to Hero [9h 3d]
cb80c9e: folds
938d3763: folds
Hero: folds
ebe5f93a: folds
ab9bbdab: folds
Uncalled bet ($0.03) returned to ad44a40
*** SHOWDOWN ***
ad44a40 collected $0.04 from pot
*** SUMMARY ***
Total pot $0.04 | Rake $0 | Jackpot $0 | Bingo $0 | Fortune $0 | Tax $0
Seat 1: ebe5f93a (button) folded before Flop (didn't bet)
Seat 2: ab9bbdab (small blind) folded before Flop
Seat 3: ad44a40 (big blind) collected ($0.04)
Seat 4: cb80c9e folded before Flop (didn't bet)
Seat 5: 938d3763 folded before Flop (didn't bet)
Seat 6: Hero folded before Flop (didn't bet)


Poker Hand #RC3795417347: Hold'em No Limit ($0.02/$0.05) - 2025/08/10 02:21:53
Table 'RushAndCash10962607' 6-max Seat #1 is the button
Seat 1: 7abebecf ($4.93 in chips)
Seat 2: 32a59565 ($18.18 in chips)
Seat 3: 8d1f433e ($6.52 in chips)
Seat 4: af4acd4a ($16.77 in chips)
Seat 5: 6f7ae573 ($5.07 in chips)
Seat 6: Hero ($5.34 in chips)
32a59565: posts small blind $0.02
8d1f433e: posts big blind $0.05
*** HOLE CARDS ***
Dealt to 7abebecf 
Dealt to 32a59565 
Dealt to 8d1f433e 
Dealt to af4acd4a 
Dealt to 6f7ae573 
Dealt to Hero [Kh 4h]
af4acd4a: folds
6f7ae573: raises $0.05 to $0.1
Hero: folds
7abebecf: folds
32a59565: folds
8d1f433e: folds
Uncalled bet ($0.05) returned to 6f7ae573
*** SHOWDOWN ***
6f7ae573 collected $0.12 from pot
*** SUMMARY ***
Total pot $0.12 | Rake $0 | Jackpot $0 | Bingo $0 | Fortune $0 | Tax $0
Seat 1: 7abebecf (button) folded before Flop (didn't bet)
Seat 2: 32a59565 (small blind) folded before Flop
Seat 3: 8d1f433e (big blind) folded before Flop
Seat 4: af4acd4a folded before Flop (didn't bet)
Seat 5: 6f7ae573 collected ($0.12)
Seat 6: Hero folded before Flop (didn't bet)


Poker Hand #RC3795417258: Hold'em No Limit ($0.02/$0.05) - 2025/08/10 02:21:39
Table 'RushAndCash10962518' 6-max Seat #1 is the button
Seat 1: Hero ($5.34 in chips)
Seat 2: a56605ca ($8.83 in chips)
Seat 3: 42cf61ea ($8.6 in chips)
Seat 4: f7b1defe ($5 in chips)
Seat 5: 6160e53f ($9.77 in chips)
Seat 6: eb247144 ($5.16 in chips)
a56605ca: posts small blind $0.02
42cf61ea: posts big blind $0.05
*** HOLE CARDS ***
Dealt to Hero [Kc 3s]
Dealt to a56605ca 
Dealt to 42cf61ea 
Dealt to f7b1defe 
Dealt to 6160e53f 
Dealt to eb247144 
f7b1defe: folds
6160e53f: raises $0.06 to $0.11
eb247144: folds
Hero: folds
a56605ca: folds
42cf61ea: calls $0.06
*** FLOP *** [2s Kd 2d]
42cf61ea: checks
6160e53f: checks
*** TURN *** [2s Kd 2d] [Ks]
42cf61ea: checks
6160e53f: bets $0.08
42cf61ea: calls $0.08
*** RIVER *** [2s Kd 2d Ks] [3c]
42cf61ea: checks
6160e53f: bets $0.6
42cf61ea: calls $0.6
6160e53f: shows [Th Td] (two pair, Kings and Tens)
42cf61ea: shows [6h 6c] (two pair, Kings and Sixes)
*** SHOWDOWN ***
6160e53f collected $1.46 from pot
*** SUMMARY ***
Total pot $1.6 | Rake $0.07 | Jackpot $0.07 | Bingo $0 | Fortune $0 | Tax $0
Board [2s Kd 2d Ks 3c]
Seat 1: Hero (button) folded before Flop (didn't bet)
Seat 2: a56605ca (small blind) folded before Flop
Seat 3: 42cf61ea (big blind) showed [6h 6c] and lost with two pair, Kings and Sixes
Seat 4: f7b1defe folded before Flop (didn't bet)
Seat 5: 6160e53f showed [Th Td] and won ($1.46) with two pair, Kings and Tens
Seat 6: eb247144 folded before Flop (didn't bet)


Poker Hand #RC3795417190: Hold'em No Limit ($0.02/$0.05) - 2025/08/10 02:21:28
Table 'RushAndCash10962450' 6-max Seat #1 is the button
Seat 1: Hero ($5.34 in chips)
Seat 2: f7ce4e8 ($7.1 in chips)
Seat 3: ff04709c ($5 in chips)
Seat 4: a579ea8 ($5.77 in chips)
Seat 5: ae33334 ($6.99 in chips)
Seat 6: 2d81f74b ($11.54 in chips)
f7ce4e8: posts small blind $0.02
ff04709c: posts big blind $0.05
*** HOLE CARDS ***
Dealt to Hero [Js 6d]
Dealt to f7ce4e8 
Dealt to ff04709c 
Dealt to a579ea8 
Dealt to ae33334 
Dealt to 2d81f74b 
a579ea8: folds
ae33334: folds
2d81f74b: raises $0.08 to $0.13
Hero: folds
f7ce4e8: folds
ff04709c: calls $0.08
*** FLOP *** [7d Ac 3h]
ff04709c: checks
2d81f74b: checks
*** TURN *** [7d Ac 3h] [Th]
ff04709c: checks
2d81f74b: checks
*** RIVER *** [7d Ac 3h Th] [8s]
ff04709c: bets $0.1
2d81f74b: calls $0.1
ff04709c: shows [Ks Tc] (a pair of Tens)
2d81f74b: shows [Kc Kd] (a pair of Kings)
*** SHOWDOWN ***
2d81f74b collected $0.46 from pot
*** SUMMARY ***
Total pot $0.48 | Rake $0.02 | Jackpot $0 | Bingo $0 | Fortune $0 | Tax $0
Board [7d Ac 3h Th 8s]
Seat 1: Hero (button) folded before Flop (didn't bet)
Seat 2: f7ce4e8 (small blind) folded before Flop
Seat 3: ff04709c (big blind) showed [Ks Tc] and lost with a pair of Tens
Seat 4: a579ea8 folded before Flop (didn't bet)
Seat 5: ae33334 folded before Flop (didn't bet)
Seat 6: 2d81f74b showed [Kc Kd] and won ($0.46) with a pair of Kings


Poker Hand #RC3795417080: Hold'em No Limit ($0.02/$0.05) - 2025/08/10 02:21:12
Table 'RushAndCash10962340' 6-max Seat #1 is the button
Seat 1: 43e3e204 ($5.14 in chips)
Seat 2: Hero ($5.36 in chips)
Seat 3: d6ec49ee ($5 in chips)
Seat 4: 4d5a4ee5 ($10.99 in chips)
Seat 5: a56605ca ($8.83 in chips)
Seat 6: 9c597dd2 ($5.5 in chips)
Hero: posts small blind $0.02
d6ec49ee: posts big blind $0.05
*** HOLE CARDS ***
Dealt to 43e3e204 
Dealt to Hero [Qh 8h]
Dealt to d6ec49ee 
Dealt to 4d5a4ee5 
Dealt to a56605ca 
Dealt to 9c597dd2 
4d5a4ee5: folds
a56605ca: folds
9c597dd2: folds
43e3e204: raises $0.1 to $0.15
Hero: folds
d6ec49ee: folds
Uncalled bet ($0.1) returned to 43e3e204
*** SHOWDOWN ***
43e3e204 collected $0.12 from pot
*** SUMMARY ***
Total pot $0.12 | Rake $0 | Jackpot $0 | Bingo $0 | Fortune $0 | Tax $0
Seat 1: 43e3e204 (button) collected ($0.12)
Seat 2: Hero (small blind) folded before Flop
Seat 3: d6ec49ee (big blind) folded before Flop
Seat 4: 4d5a4ee5 folded before Flop (didn't bet)
Seat 5: a56605ca folded before Flop (didn't bet)
Seat 6: 9c597dd2 folded before Flop (didn't bet)


Poker Hand #RC3795417052: Hold'em No Limit ($0.02/$0.05) - 2025/08/10 02:21:08
Table 'RushAndCash10962312' 6-max Seat #1 is the button
Seat 1: f0dc1ae7 ($1.93 in chips)
Seat 2: 912c2b8 ($4.95 in chips)
Seat 3: 52310931 ($12.9 in chips)
Seat 4: 203b73b4 ($5 in chips)
Seat 5: Hero ($5.36 in chips)
Seat 6: 2b89dd50 ($5.07 in chips)
912c2b8: posts small blind $0.02
52310931: posts big blind $0.05
*** HOLE CARDS ***
Dealt to f0dc1ae7 
Dealt to 912c2b8 
Dealt to 52310931 
Dealt to 203b73b4 
Dealt to Hero [Qc 2h]
Dealt to 2b89dd50 
203b73b4: raises $0.1 to $0.15
Hero: folds
2b89dd50: folds
f0dc1ae7: folds
912c2b8: calls $0.13
52310931: folds
*** FLOP *** [Kh 8s 4d]
912c2b8: checks
203b73b4: bets $0.26
912c2b8: folds
Uncalled bet ($0.26) returned to 203b73b4
*** SHOWDOWN ***
203b73b4 collected $0.34 from pot
*** SUMMARY ***
Total pot $0.35 | Rake $0.01 | Jackpot $0 | Bingo $0 | Fortune $0 | Tax $0
Board [Kh 8s 4d]
Seat 1: f0dc1ae7 (button) folded before Flop (didn't bet)
Seat 2: 912c2b8 (small blind) folded on the Flop
Seat 3: 52310931 (big blind) folded before Flop
Seat 4: 203b73b4 won ($0.34)
Seat 5: Hero folded before Flop (didn't bet)
Seat 6: 2b89dd50 folded before Flop (didn't bet)


Poker Hand #RC3795416826: Hold'em No Limit ($0.02/$0.05) - 2025/08/10 02:20:32
Table 'RushAndCash10962086' 6-max Seat #1 is the button
Seat 1: 7a3d6a27 ($6.02 in chips)
Seat 2: 82a34580 ($8.77 in chips)
Seat 3: Hero ($5.24 in chips)
Seat 4: ab02685 ($5 in chips)
Seat 5: ad670634 ($6.43 in chips)
Seat 6: 52310931 ($13.01 in chips)
82a34580: posts small blind $0.02
Hero: posts big blind $0.05
*** HOLE CARDS ***
Dealt to 7a3d6a27 
Dealt to 82a34580 
Dealt to Hero [Ah 4h]
Dealt to ab02685 
Dealt to ad670634 
Dealt to 52310931 
ab02685: folds
ad670634: folds
52310931: raises $0.06 to $0.11
7a3d6a27: folds
82a34580: folds
Hero: calls $0.06
*** FLOP *** [8h 5s 2c]
Hero: bets $0.12
52310931: folds
Uncalled bet ($0.12) returned to Hero
*** SHOWDOWN ***
Hero collected $0.23 from pot
*** SUMMARY ***
Total pot $0.24 | Rake $0.01 | Jackpot $0 | Bingo $0 | Fortune $0 | Tax $0
Board [8h 5s 2c]
Seat 1: 7a3d6a27 (button) folded before Flop (didn't bet)
Seat 2: 82a34580 (small blind) folded before Flop
Seat 3: Hero (big blind) won ($0.23)
Seat 4: ab02685 folded before Flop (didn't bet)
Seat 5: ad670634 folded before Flop (didn't bet)
Seat 6: 52310931 folded on the Flop


Poker Hand #RC3795416803: Hold'em No Limit ($0.02/$0.05) - 2025/08/10 02:20:28
Table 'RushAndCash10962063' 6-max Seat #1 is the button
Seat 1: d84dfddc ($16.4 in chips)
Seat 2: 8d1f433e ($6.61 in chips)
Seat 3: f1205850 ($6.64 in chips)
Seat 4: Hero ($5.24 in chips)
Seat 5: 922808b9 ($22.79 in chips)
Seat 6: 82a34580 ($8.77 in chips)
8d1f433e: posts small blind $0.02
f1205850: posts big blind $0.05
*** HOLE CARDS ***
Dealt to d84dfddc 
Dealt to 8d1f433e 
Dealt to f1205850 
Dealt to Hero [Kh 3c]
Dealt to 922808b9 
Dealt to 82a34580 
Hero: folds
922808b9: folds
82a34580: folds
d84dfddc: raises $0.06 to $0.11
8d1f433e: folds
f1205850: folds
Uncalled bet ($0.06) returned to d84dfddc
*** SHOWDOWN ***
d84dfddc collected $0.12 from pot
*** SUMMARY ***
Total pot $0.12 | Rake $0 | Jackpot $0 | Bingo $0 | Fortune $0 | Tax $0
Seat 1: d84dfddc (button) collected ($0.12)
Seat 2: 8d1f433e (small blind) folded before Flop
Seat 3: f1205850 (big blind) folded before Flop
Seat 4: Hero folded before Flop (didn't bet)
Seat 5: 922808b9 folded before Flop (didn't bet)
Seat 6: 82a34580 folded before Flop (didn't bet)


Poker Hand #RC3795416781: Hold'em No Limit ($0.02/$0.05) - 2025/08/10 02:20:25
Table 'RushAndCash10962041' 6-max Seat #1 is the button
Seat 1: 125e0487 ($5 in chips)
Seat 2: 65dae0f9 ($4.45 in chips)
Seat 3: 264d4d37 ($6.15 in chips)
Seat 4: 80776616 ($6.79 in chips)
Seat 5: Hero ($5.24 in chips)
Seat 6: 298d3f9f ($5.19 in chips)
65dae0f9: posts small blind $0.02
264d4d37: posts big blind $0.05
*** HOLE CARDS ***
Dealt to 125e0487 
Dealt to 65dae0f9 
Dealt to 264d4d37 
Dealt to 80776616 
Dealt to Hero [4d 6c]
Dealt to 298d3f9f 
80776616: folds
Hero: folds
298d3f9f: folds
125e0487: folds
65dae0f9: folds
Uncalled bet ($0.03) returned to 264d4d37
*** SHOWDOWN ***
264d4d37 collected $0.04 from pot
*** SUMMARY ***
Total pot $0.04 | Rake $0 | Jackpot $0 | Bingo $0 | Fortune $0 | Tax $0
Seat 1: 125e0487 (button) folded before Flop (didn't bet)
Seat 2: 65dae0f9 (small blind) folded before Flop
Seat 3: 264d4d37 (big blind) collected ($0.04)
Seat 4: 80776616 folded before Flop (didn't bet)
Seat 5: Hero folded before Flop (didn't bet)
Seat 6: 298d3f9f folded before Flop (didn't bet)


Poker Hand #RC3795416761: Hold'em No Limit ($0.02/$0.05) - 2025/08/10 02:20:21
Table 'RushAndCash10962021' 6-max Seat #1 is the button
Seat 1: db28d989 ($7.81 in chips)
Seat 2: 61c50184 ($5.07 in chips)
Seat 3: b5892436 ($6.25 in chips)
Seat 4: 7656ad46 ($9.71 in chips)
Seat 5: Hero ($5.24 in chips)
Seat 6: 35c8517c ($11.45 in chips)
61c50184: posts small blind $0.02
b5892436: posts big blind $0.05
*** HOLE CARDS ***
Dealt to db28d989 
Dealt to 61c50184 
Dealt to b5892436 
Dealt to 7656ad46 
Dealt to Hero [6d Qs]
Dealt to 35c8517c 
7656ad46: raises $0.08 to $0.13
Hero: folds
35c8517c: folds
db28d989: calls $0.13
61c50184: folds
b5892436: calls $0.08
*** FLOP *** [2c 6s Ts]
b5892436: checks
7656ad46: checks
db28d989: checks
*** TURN *** [2c 6s Ts] [3d]
b5892436: checks
7656ad46: checks
db28d989: checks
*** RIVER *** [2c 6s Ts 3d] [3c]
b5892436: bets $0.31
7656ad46: folds
db28d989: folds
Uncalled bet ($0.31) returned to b5892436
*** SHOWDOWN ***
b5892436 collected $0.39 from pot
*** SUMMARY ***
Total pot $0.41 | Rake $0.02 | Jackpot $0 | Bingo $0 | Fortune $0 | Tax $0
Board [2c 6s Ts 3d 3c]
Seat 1: db28d989 (button) folded on the River
Seat 2: 61c50184 (small blind) folded before Flop
Seat 3: b5892436 (big blind) won ($0.39)
Seat 4: 7656ad46 folded on the River
Seat 5: Hero folded before Flop (didn't bet)
Seat 6: 35c8517c folded before Flop (didn't bet)


Poker Hand #RC3795416738: Hold'em No Limit ($0.02/$0.05) - 2025/08/10 02:20:18
Table 'RushAndCash10961998' 6-max Seat #1 is the button
Seat 1: 514a7da1 ($7.23 in chips)
Seat 2: ba28deb ($5.9 in chips)
Seat 3: 2ec6cbd5 ($6.53 in chips)
Seat 4: dcabf449 ($9.28 in chips)
Seat 5: 19819752 ($5.78 in chips)
Seat 6: Hero ($5.24 in chips)
ba28deb: posts small blind $0.02
2ec6cbd5: posts big blind $0.05
*** HOLE CARDS ***
Dealt to 514a7da1 
Dealt to ba28deb 
Dealt to 2ec6cbd5 
Dealt to dcabf449 
Dealt to 19819752 
Dealt to Hero [Kh 5c]
dcabf449: folds
19819752: folds
Hero: folds
514a7da1: raises $0.05 to $0.1
ba28deb: raises $0.42 to $0.52
2ec6cbd5: calls $0.47
514a7da1: folds
*** FLOP *** [Ks 9c 8h]
ba28deb: bets $0.36
2ec6cbd5: folds
Uncalled bet ($0.36) returned to ba28deb
*** SHOWDOWN ***
ba28deb collected $1.09 from pot
*** SUMMARY ***
Total pot $1.14 | Rake $0.05 | Jackpot $0 | Bingo $0 | Fortune $0 | Tax $0
Board [Ks 9c 8h]
Seat 1: 514a7da1 (button) folded before Flop
Seat 2: ba28deb (small blind) won ($1.09)
Seat 3: 2ec6cbd5 (big blind) folded on the Flop
Seat 4: dcabf449 folded before Flop (didn't bet)
Seat 5: 19819752 folded before Flop (didn't bet)
Seat 6: Hero folded before Flop (didn't bet)


Poker Hand #RC3795416491: Hold'em No Limit ($0.02/$0.05) - 2025/08/10 02:19:36
Table 'RushAndCash10961751' 6-max Seat #1 is the button
Seat 1: Hero ($5.34 in chips)
Seat 2: aa804731 ($11.96 in chips)
Seat 3: f2fec87b ($3.91 in chips)
Seat 4: 5051873b ($5.07 in chips)
Seat 5: 93f7e7 ($5 in chips)
Seat 6: 514a7da1 ($6.99 in chips)
aa804731: posts small blind $0.02
f2fec87b: posts big blind $0.05
*** HOLE CARDS ***
Dealt to Hero [3c 5c]
Dealt to aa804731 
Dealt to f2fec87b 
Dealt to 5051873b 
Dealt to 93f7e7 
Dealt to 514a7da1 
5051873b: folds
93f7e7: folds
514a7da1: raises $0.05 to $0.1
Hero: calls $0.1
aa804731: calls $0.08
f2fec87b: folds
*** FLOP *** [Ks Jc 6h]
aa804731: checks
514a7da1: bets $0.27
Hero: folds
aa804731: folds
Uncalled bet ($0.27) returned to 514a7da1
*** SHOWDOWN ***
514a7da1 collected $0.34 from pot
*** SUMMARY ***
Total pot $0.35 | Rake $0.01 | Jackpot $0 | Bingo $0 | Fortune $0 | Tax $0
Board [Ks Jc 6h]
Seat 1: Hero (button) folded on the Flop
Seat 2: aa804731 (small blind) folded on the Flop
Seat 3: f2fec87b (big blind) folded before Flop
Seat 4: 5051873b folded before Flop (didn't bet)
Seat 5: 93f7e7 folded before Flop (didn't bet)
Seat 6: 514a7da1 won ($0.34)


Poker Hand #RC3795416409: Hold'em No Limit ($0.02/$0.05) - 2025/08/10 02:19:21
Table 'RushAndCash10961669' 6-max Seat #1 is the button
Seat 1: e2758542 ($4.71 in chips)
Seat 2: Hero ($5.36 in chips)
Seat 3: c251cc1b ($5.96 in chips)
Seat 4: 3845acf7 ($6.02 in chips)
Seat 5: f11e70d0 ($10.26 in chips)
Seat 6: e05757de ($4.97 in chips)
Hero: posts small blind $0.02
c251cc1b: posts big blind $0.05
*** HOLE CARDS ***
Dealt to e2758542 
Dealt to Hero [Jc 5d]
Dealt to c251cc1b 
Dealt to 3845acf7 
Dealt to f11e70d0 
Dealt to e05757de 
3845acf7: folds
f11e70d0: folds
e05757de: folds
e2758542: folds
Hero: folds
Uncalled bet ($0.03) returned to c251cc1b
*** SHOWDOWN ***
c251cc1b collected $0.04 from pot
*** SUMMARY ***
Total pot $0.04 | Rake $0 | Jackpot $0 | Bingo $0 | Fortune $0 | Tax $0
Seat 1: e2758542 (button) folded before Flop (didn't bet)
Seat 2: Hero (small blind) folded before Flop
Seat 3: c251cc1b (big blind) collected ($0.04)
Seat 4: 3845acf7 folded before Flop (didn't bet)
Seat 5: f11e70d0 folded before Flop (didn't bet)
Seat 6: e05757de folded before Flop (didn't bet)


Poker Hand #RC3795415992: Hold'em No Limit ($0.02/$0.05) - 2025/08/10 02:18:12
Table 'RushAndCash10961252' 6-max Seat #1 is the button
Seat 1: 9675b552 ($5.16 in chips)
Seat 2: 8772cba ($13.99 in chips)
Seat 3: Hero ($5.37 in chips)
Seat 4: 9366af84 ($15.41 in chips)
Seat 5: 166e4a4 ($5.14 in chips)
Seat 6: e05757de ($4.98 in chips)
8772cba: posts small blind $0.02
Hero: posts big blind $0.05
*** HOLE CARDS ***
Dealt to 9675b552 
Dealt to 8772cba 
Dealt to Hero [2d Ah]
Dealt to 9366af84 
Dealt to 166e4a4 
Dealt to e05757de 
9366af84: folds
166e4a4: folds
e05757de: raises $0.05 to $0.1
9675b552: folds
8772cba: folds
Hero: calls $0.05
*** FLOP *** [Th Ks Ad]
Hero: checks
e05757de: bets $0.16
Hero: calls $0.16
*** TURN *** [Th Ks Ad] [Kh]
Hero: checks
e05757de: bets $0.29
Hero: calls $0.29
*** RIVER *** [Th Ks Ad Kh] [Jh]
Hero: checks
e05757de: checks
Hero: shows [2d Ah] (two pair, Aces and Kings)
e05757de: shows [Jd As] (two pair, Aces and Kings)
*** SHOWDOWN ***
Hero collected $0.54 from pot
e05757de collected $0.54 from pot
*** SUMMARY ***
Total pot $1.12 | Rake $0.04 | Jackpot $0 | Bingo $0 | Fortune $0 | Tax $0
Board [Th Ks Ad Kh Jh]
Seat 1: 9675b552 (button) folded before Flop (didn't bet)
Seat 2: 8772cba (small blind) folded before Flop
Seat 3: Hero (big blind) showed [2d Ah] and won ($0.54) with two pair, Aces and Kings
Seat 4: 9366af84 folded before Flop (didn't bet)
Seat 5: 166e4a4 folded before Flop (didn't bet)
Seat 6: e05757de showed [Jd As] and won ($0.54) with two pair, Aces and Kings


Poker Hand #RC3795415967: Hold'em No Limit ($0.02/$0.05) - 2025/08/10 02:18:08
Table 'RushAndCash10961227' 6-max Seat #1 is the button
Seat 1: 4460cfc4 ($6.94 in chips)
Seat 2: e1219075 ($6.71 in chips)
Seat 3: abc8a81a ($5.05 in chips)
Seat 4: a52639d2 ($17.27 in chips)
Seat 5: 8772cba ($13.99 in chips)
Seat 6: Hero ($5.37 in chips)
e1219075: posts small blind $0.02
abc8a81a: posts big blind $0.05
*** HOLE CARDS ***
Dealt to 4460cfc4 
Dealt to e1219075 
Dealt to abc8a81a 
Dealt to a52639d2 
Dealt to 8772cba 
Dealt to Hero [5s Qd]
a52639d2: folds
8772cba: folds
Hero: folds
4460cfc4: folds
e1219075: folds
Uncalled bet ($0.03) returned to abc8a81a
*** SHOWDOWN ***
abc8a81a collected $0.04 from pot
*** SUMMARY ***
Total pot $0.04 | Rake $0 | Jackpot $0 | Bingo $0 | Fortune $0 | Tax $0
Seat 1: 4460cfc4 (button) folded before Flop (didn't bet)
Seat 2: e1219075 (small blind) folded before Flop
Seat 3: abc8a81a (big blind) collected ($0.04)
Seat 4: a52639d2 folded before Flop (didn't bet)
Seat 5: 8772cba folded before Flop (didn't bet)
Seat 6: Hero folded before Flop (didn't bet)


Poker Hand #RC3795415945: Hold'em No Limit ($0.02/$0.05) - 2025/08/10 02:18:05
Table 'RushAndCash10961205' 6-max Seat #1 is the button
Seat 1: 19819752 ($6.16 in chips)
Seat 2: 6a77af60 ($5.09 in chips)
Seat 3: 7a6e7f96 ($5.25 in chips)
Seat 4: Hero ($5.37 in chips)
Seat 5: abc8a81a ($5.05 in chips)
Seat 6: 102fc3aa ($5.1 in chips)
6a77af60: posts small blind $0.02
7a6e7f96: posts big blind $0.05
*** HOLE CARDS ***
Dealt to 19819752 
Dealt to 6a77af60 
Dealt to 7a6e7f96 
Dealt to Hero [7s Qc]
Dealt to abc8a81a 
Dealt to 102fc3aa 
Hero: folds
abc8a81a: folds
102fc3aa: raises $0.06 to $0.11
19819752: folds
6a77af60: raises $0.39 to $0.5
7a6e7f96: folds
102fc3aa: folds
Uncalled bet ($0.39) returned to 6a77af60
*** SHOWDOWN ***
6a77af60 collected $0.26 from pot
*** SUMMARY ***
Total pot $0.27 | Rake $0.01 | Jackpot $0 | Bingo $0 | Fortune $0 | Tax $0
Seat 1: 19819752 (button) folded before Flop (didn't bet)
Seat 2: 6a77af60 (small blind) collected ($0.26)
Seat 3: 7a6e7f96 (big blind) folded before Flop
Seat 4: Hero folded before Flop (didn't bet)
Seat 5: abc8a81a folded before Flop (didn't bet)
Seat 6: 102fc3aa folded before Flop


Poker Hand #RC3795415908: Hold'em No Limit ($0.02/$0.05) - 2025/08/10 02:17:59
Table 'RushAndCash10961168' 6-max Seat #1 is the button
Seat 1: 34e4d292 ($5.11 in chips)
Seat 2: 2f04a1e2 ($8.16 in chips)
Seat 3: a744d756 ($5 in chips)
Seat 4: d1e5e132 ($1.26 in chips)
Seat 5: b42f22c4 ($5 in chips)
Seat 6: Hero ($5.37 in chips)
2f04a1e2: posts small blind $0.02
a744d756: posts big blind $0.05
*** HOLE CARDS ***
Dealt to 34e4d292 
Dealt to 2f04a1e2 
Dealt to a744d756 
Dealt to d1e5e132 
Dealt to b42f22c4 
Dealt to Hero [3c 3d]
d1e5e132: raises $0.05 to $0.1
b42f22c4: folds
Hero: folds
34e4d292: folds
2f04a1e2: folds
a744d756: calls $0.05
*** FLOP *** [Ah 3s Kh]
a744d756: checks
d1e5e132: bets $0.11
a744d756: calls $0.11
*** TURN *** [Ah 3s Kh] [Tc]
a744d756: checks
d1e5e132: checks
*** RIVER *** [Ah 3s Kh Tc] [Kc]
a744d756: checks
d1e5e132: checks
a744d756: shows [8s Ac] (two pair, Aces and Kings)
d1e5e132: shows [6d 6c] (two pair, Kings and Sixes)
*** SHOWDOWN ***
a744d756 collected $0.42 from pot
*** SUMMARY ***
Total pot $0.44 | Rake $0.02 | Jackpot $0 | Bingo $0 | Fortune $0 | Tax $0
Board [Ah 3s Kh Tc Kc]
Seat 1: 34e4d292 (button) folded before Flop (didn't bet)
Seat 2: 2f04a1e2 (small blind) folded before Flop
Seat 3: a744d756 (big blind) showed [8s Ac] and won ($0.42) with two pair, Aces and Kings
Seat 4: d1e5e132 showed [6d 6c] and lost with two pair, Kings and Sixes
Seat 5: b42f22c4 folded before Flop (didn't bet)
Seat 6: Hero folded before Flop (didn't bet)


Poker Hand #RC3795415806: Hold'em No Limit ($0.02/$0.05) - 2025/08/10 02:17:43
Table 'RushAndCash10961066' 6-max Seat #1 is the button
Seat 1: Hero ($5.37 in chips)
Seat 2: a731f2b4 ($5.1 in chips)
Seat 3: 6160e53f ($2.97 in chips)
Seat 4: 3d9b215 ($10.49 in chips)
Seat 5: 3c3c41c1 ($8.43 in chips)
Seat 6: fb59cd77 ($6.65 in chips)
a731f2b4: posts small blind $0.02
6160e53f: posts big blind $0.05
*** HOLE CARDS ***
Dealt to Hero [8c 3s]
Dealt to a731f2b4 
Dealt to 6160e53f 
Dealt to 3d9b215 
Dealt to 3c3c41c1 
Dealt to fb59cd77 
3d9b215: folds
3c3c41c1: folds
fb59cd77: folds
Hero: folds
a731f2b4: folds
Uncalled bet ($0.03) returned to 6160e53f
*** SHOWDOWN ***
6160e53f collected $0.04 from pot
*** SUMMARY ***
Total pot $0.04 | Rake $0 | Jackpot $0 | Bingo $0 | Fortune $0 | Tax $0
Seat 1: Hero (button) folded before Flop (didn't bet)
Seat 2: a731f2b4 (small blind) folded before Flop
Seat 3: 6160e53f (big blind) collected ($0.04)
Seat 4: 3d9b215 folded before Flop (didn't bet)
Seat 5: 3c3c41c1 folded before Flop (didn't bet)
Seat 6: fb59cd77 folded before Flop (didn't bet)


Poker Hand #RC3795415721: Hold'em No Limit ($0.02/$0.05) - 2025/08/10 02:17:27
Table 'RushAndCash10960981' 6-max Seat #1 is the button
Seat 1: c4e2527e ($5.69 in chips)
Seat 2: Hero ($5.39 in chips)
Seat 3: de8926d5 ($11.27 in chips)
Seat 4: 2732db68 ($6.8 in chips)
Seat 5: 286965fb ($4.53 in chips)
Seat 6: fd75b7b1 ($9.95 in chips)
Hero: posts small blind $0.02
de8926d5: posts big blind $0.05
*** HOLE CARDS ***
Dealt to c4e2527e 
Dealt to Hero [7c Jd]
Dealt to de8926d5 
Dealt to 2732db68 
Dealt to 286965fb 
Dealt to fd75b7b1 
2732db68: folds
286965fb: folds
fd75b7b1: folds
c4e2527e: folds
Hero: folds
Uncalled bet ($0.03) returned to de8926d5
*** SHOWDOWN ***
de8926d5 collected $0.04 from pot
*** SUMMARY ***
Total pot $0.04 | Rake $0 | Jackpot $0 | Bingo $0 | Fortune $0 | Tax $0
Seat 1: c4e2527e (button) folded before Flop (didn't bet)
Seat 2: Hero (small blind) folded before Flop
Seat 3: de8926d5 (big blind) collected ($0.04)
Seat 4: 2732db68 folded before Flop (didn't bet)
Seat 5: 286965fb folded before Flop (didn't bet)
Seat 6: fd75b7b1 folded before Flop (didn't bet)


Poker Hand #RC3795415507: Hold'em No Limit ($0.02/$0.05) - 2025/08/10 02:16:48
Table 'RushAndCash10960767' 6-max Seat #1 is the button
Seat 1: fd75b7b1 ($10.05 in chips)
Seat 2: 3845acf7 ($5.62 in chips)
Seat 3: Hero ($5.28 in chips)
Seat 4: 72eca880 ($4.53 in chips)
Seat 5: 26b2edc9 ($3.75 in chips)
Seat 6: 92cea38 ($5 in chips)
3845acf7: posts small blind $0.02
Hero: posts big blind $0.05
*** HOLE CARDS ***
Dealt to fd75b7b1 
Dealt to 3845acf7 
Dealt to Hero [8h 5h]
Dealt to 72eca880 
Dealt to 26b2edc9 
Dealt to 92cea38 
72eca880: folds
26b2edc9: folds
92cea38: folds
fd75b7b1: raises $0.05 to $0.1
3845acf7: folds
Hero: calls $0.05
*** FLOP *** [9h 9c 5d]
Hero: bets $0.08
fd75b7b1: folds
Uncalled bet ($0.08) returned to Hero
*** SHOWDOWN ***
Hero collected $0.21 from pot
*** SUMMARY ***
Total pot $0.22 | Rake $0.01 | Jackpot $0 | Bingo $0 | Fortune $0 | Tax $0
Board [9h 9c 5d]
Seat 1: fd75b7b1 (button) folded on the Flop
Seat 2: 3845acf7 (small blind) folded before Flop
Seat 3: Hero (big blind) won ($0.21)
Seat 4: 72eca880 folded before Flop (didn't bet)
Seat 5: 26b2edc9 folded before Flop (didn't bet)
Seat 6: 92cea38 folded before Flop (didn't bet)


Poker Hand #RC3795415489: Hold'em No Limit ($0.02/$0.05) - 2025/08/10 02:16:44
Table 'RushAndCash10960749' 6-max Seat #1 is the button
Seat 1: 448e261d ($11.24 in chips)
Seat 2: db846cc6 ($7.62 in chips)
Seat 3: c66704d7 ($4.93 in chips)
Seat 4: Hero ($5.28 in chips)
Seat 5: 3845acf7 ($5.62 in chips)
Seat 6: 903da351 ($6.63 in chips)
db846cc6: posts small blind $0.02
c66704d7: posts big blind $0.05
*** HOLE CARDS ***
Dealt to 448e261d 
Dealt to db846cc6 
Dealt to c66704d7 
Dealt to Hero [5c 2s]
Dealt to 3845acf7 
Dealt to 903da351 
Hero: folds
3845acf7: folds
903da351: folds
448e261d: raises $0.07 to $0.12
db846cc6: calls $0.1
c66704d7: calls $0.07
*** FLOP *** [2d Qd Qs]
db846cc6: checks
c66704d7: checks
448e261d: bets $0.09
db846cc6: calls $0.09
c66704d7: folds
*** TURN *** [2d Qd Qs] [Kh]
db846cc6: checks
448e261d: bets $0.18
db846cc6: calls $0.18
*** RIVER *** [2d Qd Qs Kh] [Tc]
db846cc6: checks
448e261d: bets $0.9
db846cc6: calls $0.9
448e261d: shows [Qh Qc] (four of a kind, Queens)
db846cc6: shows [Jh Kd] (two pair, Kings and Queens)
*** SHOWDOWN ***
448e261d collected $2.5 from pot
*** SUMMARY ***
Total pot $2.7 | Rake $0.13 | Jackpot $0.07 | Bingo $0 | Fortune $0 | Tax $0
Board [2d Qd Qs Kh Tc]
Seat 1: 448e261d (button) showed [Qh Qc] and won ($2.5) with four of a kind, Queens
Seat 2: db846cc6 (small blind) showed [Jh Kd] and lost with two pair, Kings and Queens
Seat 3: c66704d7 (big blind) folded on the Flop
Seat 4: Hero folded before Flop (didn't bet)
Seat 5: 3845acf7 folded before Flop (didn't bet)
Seat 6: 903da351 folded before Flop (didn't bet)


Poker Hand #RC3795415468: Hold'em No Limit ($0.02/$0.05) - 2025/08/10 02:16:41
Table 'RushAndCash10960728' 6-max Seat #1 is the button
Seat 1: b42f22c4 ($5.07 in chips)
Seat 2: fd75b7b1 ($10.07 in chips)
Seat 3: 4809682b ($17.78 in chips)
Seat 4: da332313 ($5.36 in chips)
Seat 5: c66704d7 ($4.93 in chips)
Seat 6: Hero ($5.28 in chips)
fd75b7b1: posts small blind $0.02
4809682b: posts big blind $0.05
*** HOLE CARDS ***
Dealt to b42f22c4 
Dealt to fd75b7b1 
Dealt to 4809682b 
Dealt to da332313 
Dealt to c66704d7 
Dealt to Hero [4s 3c]
da332313: raises $0.1 to $0.15
c66704d7: folds
Hero: folds
b42f22c4: folds
fd75b7b1: folds
4809682b: folds
Uncalled bet ($0.1) returned to da332313
*** SHOWDOWN ***
da332313 collected $0.12 from pot
*** SUMMARY ***
Total pot $0.12 | Rake $0 | Jackpot $0 | Bingo $0 | Fortune $0 | Tax $0
Seat 1: b42f22c4 (button) folded before Flop (didn't bet)
Seat 2: fd75b7b1 (small blind) folded before Flop
Seat 3: 4809682b (big blind) folded before Flop
Seat 4: da332313 collected ($0.12)
Seat 5: c66704d7 folded before Flop (didn't bet)
Seat 6: Hero folded before Flop (didn't bet)


Poker Hand #RC3795415448: Hold'em No Limit ($0.02/$0.05) - 2025/08/10 02:16:37
Table 'RushAndCash10960708' 6-max Seat #1 is the button
Seat 1: 99c9b3ec ($7.63 in chips)
Seat 2: 935ecf12 ($6.52 in chips)
Seat 3: 679c5ea0 ($10.63 in chips)
Seat 4: Hero ($5.28 in chips)
Seat 5: 109477d4 ($5.25 in chips)
Seat 6: 8e1843b8 ($5.16 in chips)
935ecf12: posts small blind $0.02
679c5ea0: posts big blind $0.05
*** HOLE CARDS ***
Dealt to 99c9b3ec 
Dealt to 935ecf12 
Dealt to 679c5ea0 
Dealt to Hero [3h Tc]
Dealt to 109477d4 
Dealt to 8e1843b8 
Hero: folds
109477d4: raises $0.1 to $0.15
8e1843b8: folds
99c9b3ec: raises $0.35 to $0.5
935ecf12: folds
679c5ea0: folds
109477d4: folds
Uncalled bet ($0.35) returned to 99c9b3ec
*** SHOWDOWN ***
99c9b3ec collected $0.36 from pot
*** SUMMARY ***
Total pot $0.37 | Rake $0.01 | Jackpot $0 | Bingo $0 | Fortune $0 | Tax $0
Seat 1: 99c9b3ec (button) collected ($0.36)
Seat 2: 935ecf12 (small blind) folded before Flop
Seat 3: 679c5ea0 (big blind) folded before Flop
Seat 4: Hero folded before Flop (didn't bet)
Seat 5: 109477d4 folded before Flop
Seat 6: 8e1843b8 folded before Flop (didn't bet)


Poker Hand #RC3795415386: Hold'em No Limit ($0.02/$0.05) - 2025/08/10 02:16:25
Table 'RushAndCash10960646' 6-max Seat #1 is the button
Seat 1: Hero ($5.28 in chips)
Seat 2: 8d9c97d6 ($5.82 in chips)
Seat 3: 11eda99d ($5.12 in chips)
Seat 4: 1d709ff6 ($5 in chips)
Seat 5: b2e4e02f ($7.66 in chips)
Seat 6: 99376de ($15.72 in chips)
8d9c97d6: posts small blind $0.02
11eda99d: posts big blind $0.05
*** HOLE CARDS ***
Dealt to Hero [4h Qc]
Dealt to 8d9c97d6 
Dealt to 11eda99d 
Dealt to 1d709ff6 
Dealt to b2e4e02f 
Dealt to 99376de 
1d709ff6: folds
b2e4e02f: folds
99376de: folds
Hero: folds
8d9c97d6: raises $0.07 to $0.12
11eda99d: folds
Uncalled bet ($0.07) returned to 8d9c97d6
*** SHOWDOWN ***
8d9c97d6 collected $0.1 from pot
*** SUMMARY ***
Total pot $0.1 | Rake $0 | Jackpot $0 | Bingo $0 | Fortune $0 | Tax $0
Seat 1: Hero (button) folded before Flop (didn't bet)
Seat 2: 8d9c97d6 (small blind) collected ($0.1)
Seat 3: 11eda99d (big blind) folded before Flop
Seat 4: 1d709ff6 folded before Flop (didn't bet)
Seat 5: b2e4e02f folded before Flop (didn't bet)
Seat 6: 99376de folded before Flop (didn't bet)


Poker Hand #RC3795415307: Hold'em No Limit ($0.02/$0.05) - 2025/08/10 02:16:10
Table 'RushAndCash10960567' 6-max Seat #1 is the button
Seat 1: a52639d2 ($17.57 in chips)
Seat 2: Hero ($5.3 in chips)
Seat 3: 8088c6e8 ($8.93 in chips)
Seat 4: 8803400a ($5 in chips)
Seat 5: a6d5a8d0 ($5.58 in chips)
Seat 6: 143f3b35 ($4.14 in chips)
Hero: posts small blind $0.02
8088c6e8: posts big blind $0.05
*** HOLE CARDS ***
Dealt to a52639d2 
Dealt to Hero [9c 3d]
Dealt to 8088c6e8 
Dealt to 8803400a 
Dealt to a6d5a8d0 
Dealt to 143f3b35 
8803400a: raises $0.06 to $0.11
a6d5a8d0: folds
143f3b35: folds
a52639d2: folds
Hero: folds
8088c6e8: calls $0.06
*** FLOP *** [7h 4h 2c]
8088c6e8: bets $0.08
8803400a: folds
Uncalled bet ($0.08) returned to 8088c6e8
*** SHOWDOWN ***
8088c6e8 collected $0.23 from pot
*** SUMMARY ***
Total pot $0.24 | Rake $0.01 | Jackpot $0 | Bingo $0 | Fortune $0 | Tax $0
Board [7h 4h 2c]
Seat 1: a52639d2 (button) folded before Flop (didn't bet)
Seat 2: Hero (small blind) folded before Flop
Seat 3: 8088c6e8 (big blind) won ($0.23)
Seat 4: 8803400a folded on the Flop
Seat 5: a6d5a8d0 folded before Flop (didn't bet)
Seat 6: 143f3b35 folded before Flop (didn't bet)


Poker Hand #RC3795415204: Hold'em No Limit ($0.02/$0.05) - 2025/08/10 02:15:53
Table 'RushAndCash10960464' 6-max Seat #1 is the button
Seat 1: 2b32692e ($9.35 in chips)
Seat 2: 9675b552 ($5.02 in chips)
Seat 3: Hero ($5.35 in chips)
Seat 4: ab02685 ($5.21 in chips)
Seat 5: 7650e550 ($5.52 in chips)
Seat 6: 26b2edc9 ($4.27 in chips)
9675b552: posts small blind $0.02
Hero: posts big blind $0.05
*** HOLE CARDS ***
Dealt to 2b32692e 
Dealt to 9675b552 
Dealt to Hero [2c 9c]
Dealt to ab02685 
Dealt to 7650e550 
Dealt to 26b2edc9 
ab02685: folds
7650e550: raises $0.05 to $0.1
26b2edc9: folds
2b32692e: folds
9675b552: calls $0.08
Hero: folds
*** FLOP *** [Js 3s 9s]
9675b552: checks
7650e550: checks
*** TURN *** [Js 3s 9s] [6c]
9675b552: checks
7650e550: bets $0.19
9675b552: folds
Uncalled bet ($0.19) returned to 7650e550
*** SHOWDOWN ***
7650e550 collected $0.24 from pot
*** SUMMARY ***
Total pot $0.25 | Rake $0.01 | Jackpot $0 | Bingo $0 | Fortune $0 | Tax $0
Board [Js 3s 9s 6c]
Seat 1: 2b32692e (button) folded before Flop (didn't bet)
Seat 2: 9675b552 (small blind) folded on the Turn
Seat 3: Hero (big blind) folded before Flop
Seat 4: ab02685 folded before Flop (didn't bet)
Seat 5: 7650e550 won ($0.24)
Seat 6: 26b2edc9 folded before Flop (didn't bet)


Poker Hand #RC3795415180: Hold'em No Limit ($0.02/$0.05) - 2025/08/10 02:15:50
Table 'RushAndCash10960440' 6-max Seat #1 is the button
Seat 1: ce517e5d ($13.14 in chips)
Seat 2: 576f5693 ($8.42 in chips)
Seat 3: 45a2a5f3 ($5.07 in chips)
Seat 4: Hero ($5.35 in chips)
Seat 5: b7cf9a6f ($4.53 in chips)
Seat 6: db9525e1 ($6.59 in chips)
576f5693: posts small blind $0.02
45a2a5f3: posts big blind $0.05
*** HOLE CARDS ***
Dealt to ce517e5d 
Dealt to 576f5693 
Dealt to 45a2a5f3 
Dealt to Hero [8c 5s]
Dealt to b7cf9a6f 
Dealt to db9525e1 
Hero: folds
b7cf9a6f: folds
db9525e1: folds
ce517e5d: folds
576f5693: calls $0.03
45a2a5f3: raises $0.45 to $0.5
576f5693: folds
Uncalled bet ($0.45) returned to 45a2a5f3
*** SHOWDOWN ***
45a2a5f3 collected $0.1 from pot
*** SUMMARY ***
Total pot $0.1 | Rake $0 | Jackpot $0 | Bingo $0 | Fortune $0 | Tax $0
Seat 1: ce517e5d (button) folded before Flop (didn't bet)
Seat 2: 576f5693 (small blind) folded before Flop
Seat 3: 45a2a5f3 (big blind) collected ($0.1)
Seat 4: Hero folded before Flop (didn't bet)
Seat 5: b7cf9a6f folded before Flop (didn't bet)
Seat 6: db9525e1 folded before Flop (didn't bet)


Poker Hand #RC3795414783: Hold'em No Limit ($0.02/$0.05) - 2025/08/10 02:14:42
Table 'RushAndCash10960043' 6-max Seat #1 is the button
Seat 1: 9e198b9d ($5.07 in chips)
Seat 2: e1219075 ($6.23 in chips)
Seat 3: ce517e5d ($14.49 in chips)
Seat 4: Hero ($4.18 in chips)
Seat 5: fa9ba740 ($6.27 in chips)
Seat 6: d15704b8 ($6.73 in chips)
e1219075: posts small blind $0.02
ce517e5d: posts big blind $0.05
*** HOLE CARDS ***
Dealt to 9e198b9d 
Dealt to e1219075 
Dealt to ce517e5d 
Dealt to Hero [Ts Jh]
Dealt to fa9ba740 
Dealt to d15704b8 
Hero: raises $0.05 to $0.1
fa9ba740: folds
d15704b8: folds
9e198b9d: folds
e1219075: folds
ce517e5d: raises $0.22 to $0.32
Hero: calls $0.22
*** FLOP *** [Jd 5c 3d]
ce517e5d: checks
Hero: bets $0.19
ce517e5d: raises $0.35 to $0.54
Hero: calls $0.35
*** TURN *** [Jd 5c 3d] [7d]
ce517e5d: checks
Hero: bets $0.49
ce517e5d: calls $0.49
*** RIVER *** [Jd 5c 3d 7d] [9s]
ce517e5d: checks
Hero: checks
ce517e5d: shows [Ad Tc] (Ace high)
Hero: shows [Ts Jh] (a pair of Jacks)
*** SHOWDOWN ***
Hero collected $2.52 from pot
*** SUMMARY ***
Total pot $2.72 | Rake $0.13 | Jackpot $0.07 | Bingo $0 | Fortune $0 | Tax $0
Board [Jd 5c 3d 7d 9s]
Seat 1: 9e198b9d (button) folded before Flop (didn't bet)
Seat 2: e1219075 (small blind) folded before Flop
Seat 3: ce517e5d (big blind) showed [Ad Tc] and lost with Ace high
Seat 4: Hero showed [Ts Jh] and won ($2.52) with a pair of Jacks
Seat 5: fa9ba740 folded before Flop (didn't bet)
Seat 6: d15704b8 folded before Flop (didn't bet)


Poker Hand #RC3795414759: Hold'em No Limit ($0.02/$0.05) - 2025/08/10 02:14:39
Table 'RushAndCash10960019' 6-max Seat #1 is the button
Seat 1: e1c62858 ($5 in chips)
Seat 2: 862768c6 ($5.87 in chips)
Seat 3: 50881796 ($5.23 in chips)
Seat 4: 7fa2bdfb ($10.08 in chips)
Seat 5: 9efe33b0 ($5 in chips)
Seat 6: Hero ($4.18 in chips)
862768c6: posts small blind $0.02
50881796: posts big blind $0.05
*** HOLE CARDS ***
Dealt to e1c62858 
Dealt to 862768c6 
Dealt to 50881796 
Dealt to 7fa2bdfb 
Dealt to 9efe33b0 
Dealt to Hero [4h 9c]
7fa2bdfb: folds
9efe33b0: folds
Hero: folds
e1c62858: folds
862768c6: raises $0.15 to $0.2
50881796: folds
Uncalled bet ($0.15) returned to 862768c6
*** SHOWDOWN ***
862768c6 collected $0.1 from pot
*** SUMMARY ***
Total pot $0.1 | Rake $0 | Jackpot $0 | Bingo $0 | Fortune $0 | Tax $0
Seat 1: e1c62858 (button) folded before Flop (didn't bet)
Seat 2: 862768c6 (small blind) collected ($0.1)
Seat 3: 50881796 (big blind) folded before Flop
Seat 4: 7fa2bdfb folded before Flop (didn't bet)
Seat 5: 9efe33b0 folded before Flop (didn't bet)
Seat 6: Hero folded before Flop (didn't bet)


Poker Hand #RC3795364656: Hold'em No Limit ($0.02/$0.05) - 2025/08/10 02:14:22
Table 'RushAndCash10959916' 6-max Seat #1 is the button
Seat 1: 5a0c42c1 ($27.08 in chips)
Seat 2: Hero ($4.2 in chips)
Seat 3: 6e86a7c4 ($5.88 in chips)
Seat 4: 4c05a0ff ($7.82 in chips)
Seat 5: 6d5c1f77 ($10.61 in chips)
Seat 6: 52310931 ($5.89 in chips)
Hero: posts small blind $0.02
6e86a7c4: posts big blind $0.05
*** HOLE CARDS ***
Dealt to 5a0c42c1 
Dealt to Hero [4d Jd]
Dealt to 6e86a7c4 
Dealt to 4c05a0ff 
Dealt to 6d5c1f77 
Dealt to 52310931 
4c05a0ff: folds
6d5c1f77: raises $0.08 to $0.13
52310931: calls $0.13
5a0c42c1: folds
Hero: folds
6e86a7c4: folds
*** FLOP *** [9s Js 5h]
6d5c1f77: checks
52310931: checks
*** TURN *** [9s Js 5h] [6d]
6d5c1f77: checks
52310931: checks
*** RIVER *** [9s Js 5h 6d] [Ts]
6d5c1f77: checks
52310931: checks
6d5c1f77: shows [Qd Ah] (Ace high)
52310931: shows [Tc As] (a pair of Tens)
*** SHOWDOWN ***
52310931 collected $0.32 from pot
*** SUMMARY ***
Total pot $0.33 | Rake $0.01 | Jackpot $0 | Bingo $0 | Fortune $0 | Tax $0
Board [9s Js 5h 6d Ts]
Seat 1: 5a0c42c1 (button) folded before Flop (didn't bet)
Seat 2: Hero (small blind) folded before Flop
Seat 3: 6e86a7c4 (big blind) folded before Flop
Seat 4: 4c05a0ff folded before Flop (didn't bet)
Seat 5: 6d5c1f77 showed [Qd Ah] and lost with Ace high
Seat 6: 52310931 showed [Tc As] and won ($0.32) with a pair of Tens


Poker Hand #RC3795364600: Hold'em No Limit ($0.02/$0.05) - 2025/08/10 02:14:14
Table 'RushAndCash10959860' 6-max Seat #1 is the button
Seat 1: Hero ($4.2 in chips)
Seat 2: ec883d23 ($7.65 in chips)
Seat 3: c4e2527e ($6.23 in chips)
Seat 4: 76f349fd ($4.72 in chips)
Seat 5: d15704b8 ($6.77 in chips)
Seat 6: 5f6e556d ($6.12 in chips)
ec883d23: posts small blind $0.02
c4e2527e: posts big blind $0.05
*** HOLE CARDS ***
Dealt to Hero [6c 5d]
Dealt to ec883d23 
Dealt to c4e2527e 
Dealt to 76f349fd 
Dealt to d15704b8 
Dealt to 5f6e556d 
76f349fd: raises $0.05 to $0.1
d15704b8: folds
5f6e556d: folds
Hero: folds
ec883d23: calls $0.08
c4e2527e: folds
*** FLOP *** [Qs Jh Th]
ec883d23: checks
76f349fd: bets $0.13
ec883d23: calls $0.13
*** TURN *** [Qs Jh Th] [9d]
ec883d23: bets $0.38
76f349fd: folds
Uncalled bet ($0.38) returned to ec883d23
*** SHOWDOWN ***
ec883d23 collected $0.49 from pot
*** SUMMARY ***
Total pot $0.51 | Rake $0.02 | Jackpot $0 | Bingo $0 | Fortune $0 | Tax $0
Board [Qs Jh Th 9d]
Seat 1: Hero (button) folded before Flop (didn't bet)
Seat 2: ec883d23 (small blind) won ($0.49)
Seat 3: c4e2527e (big blind) folded before Flop
Seat 4: 76f349fd folded on the Turn
Seat 5: d15704b8 folded before Flop (didn't bet)
Seat 6: 5f6e556d folded before Flop (didn't bet)


Poker Hand #RC3795364528: Hold'em No Limit ($0.02/$0.05) - 2025/08/10 02:14:01
Table 'RushAndCash10959788' 6-max Seat #1 is the button
Seat 1: 6f1e89b6 ($13.12 in chips)
Seat 2: 264d4d37 ($5.16 in chips)
Seat 3: Hero ($4.25 in chips)
Seat 4: 514c35b7 ($6.38 in chips)
Seat 5: 50870e74 ($5.3 in chips)
Seat 6: 19819752 ($6.11 in chips)
264d4d37: posts small blind $0.02
Hero: posts big blind $0.05
*** HOLE CARDS ***
Dealt to 6f1e89b6 
Dealt to 264d4d37 
Dealt to Hero [Js Tc]
Dealt to 514c35b7 
Dealt to 50870e74 
Dealt to 19819752 
514c35b7: raises $0.08 to $0.13
50870e74: folds
19819752: raises $0.25 to $0.38
6f1e89b6: folds
264d4d37: folds
Hero: folds
514c35b7: calls $0.25
*** FLOP *** [5c 7s Ks]
514c35b7: checks
19819752: bets $0.4
514c35b7: calls $0.4
*** TURN *** [5c 7s Ks] [Qd]
514c35b7: checks
19819752: bets $1.25
514c35b7: folds
Uncalled bet ($1.25) returned to 19819752
*** SHOWDOWN ***
19819752 collected $1.49 from pot
*** SUMMARY ***
Total pot $1.63 | Rake $0.07 | Jackpot $0.07 | Bingo $0 | Fortune $0 | Tax $0
Board [5c 7s Ks Qd]
Seat 1: 6f1e89b6 (button) folded before Flop (didn't bet)
Seat 2: 264d4d37 (small blind) folded before Flop
Seat 3: Hero (big blind) folded before Flop
Seat 4: 514c35b7 folded on the Turn
Seat 5: 50870e74 folded before Flop (didn't bet)
Seat 6: 19819752 won ($1.49)


Poker Hand #RC3795364505: Hold'em No Limit ($0.02/$0.05) - 2025/08/10 02:13:57
Table 'RushAndCash10959765' 6-max Seat #1 is the button
Seat 1: c69852d8 ($5.81 in chips)
Seat 2: 97b7df65 ($1.95 in chips)
Seat 3: 7df1621d ($7.5 in chips)
Seat 4: 6728f33c ($3.79 in chips)
Seat 5: 50870e74 ($5.3 in chips)
Seat 6: Hero ($4.25 in chips)
97b7df65: posts small blind $0.02
7df1621d: posts big blind $0.05
*** HOLE CARDS ***
Dealt to c69852d8 
Dealt to 97b7df65 
Dealt to 7df1621d 
Dealt to 6728f33c 
Dealt to 50870e74 
Dealt to Hero [2h 4c]
6728f33c: folds
50870e74: folds
Hero: folds
c69852d8: folds
97b7df65: folds
Uncalled bet ($0.03) returned to 7df1621d
*** SHOWDOWN ***
7df1621d collected $0.04 from pot
*** SUMMARY ***
Total pot $0.04 | Rake $0 | Jackpot $0 | Bingo $0 | Fortune $0 | Tax $0
Seat 1: c69852d8 (button) folded before Flop (didn't bet)
Seat 2: 97b7df65 (small blind) folded before Flop
Seat 3: 7df1621d (big blind) collected ($0.04)
Seat 4: 6728f33c folded before Flop (didn't bet)
Seat 5: 50870e74 folded before Flop (didn't bet)
Seat 6: Hero folded before Flop (didn't bet)


Poker Hand #RC3795364482: Hold'em No Limit ($0.02/$0.05) - 2025/08/10 02:13:54
Table 'RushAndCash10959742' 6-max Seat #1 is the button
Seat 1: 2120892e ($10.05 in chips)
Seat 2: ee87ee96 ($17.11 in chips)
Seat 3: 8a16ebe2 ($5.12 in chips)
Seat 4: 81120f1 ($5 in chips)
Seat 5: af4acd4a ($15.56 in chips)
Seat 6: Hero ($4.25 in chips)
ee87ee96: posts small blind $0.02
8a16ebe2: posts big blind $0.05
*** HOLE CARDS ***
Dealt to 2120892e 
Dealt to ee87ee96 
Dealt to 8a16ebe2 
Dealt to 81120f1 
Dealt to af4acd4a 
Dealt to Hero [Kd 9c]
81120f1: folds
af4acd4a: raises $0.06 to $0.11
Hero: folds
2120892e: folds
ee87ee96: folds
8a16ebe2: folds
Uncalled bet ($0.06) returned to af4acd4a
*** SHOWDOWN ***
af4acd4a collected $0.12 from pot
*** SUMMARY ***
Total pot $0.12 | Rake $0 | Jackpot $0 | Bingo $0 | Fortune $0 | Tax $0
Seat 1: 2120892e (button) folded before Flop (didn't bet)
Seat 2: ee87ee96 (small blind) folded before Flop
Seat 3: 8a16ebe2 (big blind) folded before Flop
Seat 4: 81120f1 folded before Flop (didn't bet)
Seat 5: af4acd4a collected ($0.12)
Seat 6: Hero folded before Flop (didn't bet)


Poker Hand #RC3795364053: Hold'em No Limit ($0.02/$0.05) - 2025/08/10 02:12:50
Table 'RushAndCash10959313' 6-max Seat #1 is the button
Seat 1: 68ac9514 ($27.39 in chips)
Seat 2: cb80c9e ($15.03 in chips)
Seat 3: 9e198b9d ($5 in chips)
Seat 4: af4acd4a ($15.39 in chips)
Seat 5: 70aa16d9 ($6.84 in chips)
Seat 6: Hero ($4.36 in chips)
cb80c9e: posts small blind $0.02
9e198b9d: posts big blind $0.05
*** HOLE CARDS ***
Dealt to 68ac9514 
Dealt to cb80c9e 
Dealt to 9e198b9d 
Dealt to af4acd4a 
Dealt to 70aa16d9 
Dealt to Hero [Qh Kh]
af4acd4a: raises $0.06 to $0.11
70aa16d9: folds
Hero: calls $0.11
68ac9514: folds
cb80c9e: folds
9e198b9d: folds
*** FLOP *** [As Ad Js]
af4acd4a: checks
Hero: checks
*** TURN *** [As Ad Js] [8s]
af4acd4a: checks
Hero: checks
*** RIVER *** [As Ad Js 8s] [6h]
af4acd4a: bets $0.21
Hero: folds
Uncalled bet ($0.21) returned to af4acd4a
*** SHOWDOWN ***
af4acd4a collected $0.28 from pot
*** SUMMARY ***
Total pot $0.29 | Rake $0.01 | Jackpot $0 | Bingo $0 | Fortune $0 | Tax $0
Board [As Ad Js 8s 6h]
Seat 1: 68ac9514 (button) folded before Flop (didn't bet)
Seat 2: cb80c9e (small blind) folded before Flop
Seat 3: 9e198b9d (big blind) folded before Flop
Seat 4: af4acd4a won ($0.28)
Seat 5: 70aa16d9 folded before Flop (didn't bet)
Seat 6: Hero folded on the River


Poker Hand #RC3795363906: Hold'em No Limit ($0.02/$0.05) - 2025/08/10 02:12:26
Table 'RushAndCash10959166' 6-max Seat #1 is the button
Seat 1: af4acd4a ($15.23 in chips)
Seat 2: d9d39bb8 ($5.96 in chips)
Seat 3: 109477d4 ($5.56 in chips)
Seat 4: 978c86db ($4.24 in chips)
Seat 5: cc20b970 ($5.09 in chips)
Seat 6: Hero ($4.46 in chips)
d9d39bb8: posts small blind $0.02
109477d4: posts big blind $0.05
*** HOLE CARDS ***
Dealt to af4acd4a 
Dealt to d9d39bb8 
Dealt to 109477d4 
Dealt to 978c86db 
Dealt to cc20b970 
Dealt to Hero [Jh Kd]
978c86db: folds
cc20b970: folds
Hero: raises $0.05 to $0.1
af4acd4a: raises $0.28 to $0.38
d9d39bb8: folds
109477d4: folds
Hero: folds
Uncalled bet ($0.28) returned to af4acd4a
*** SHOWDOWN ***
af4acd4a collected $0.26 from pot
*** SUMMARY ***
Total pot $0.27 | Rake $0.01 | Jackpot $0 | Bingo $0 | Fortune $0 | Tax $0
Seat 1: af4acd4a (button) collected ($0.26)
Seat 2: d9d39bb8 (small blind) folded before Flop
Seat 3: 109477d4 (big blind) folded before Flop
Seat 4: 978c86db folded before Flop (didn't bet)
Seat 5: cc20b970 folded before Flop (didn't bet)
Seat 6: Hero folded before Flop


Poker Hand #RC3795363790: Hold'em No Limit ($0.02/$0.05) - 2025/08/10 02:12:06
Table 'RushAndCash10959050' 6-max Seat #1 is the button
Seat 1: e0602eaa ($2.7 in chips)
Seat 2: Hero ($4.48 in chips)
Seat 3: 143f3b35 ($4.61 in chips)
Seat 4: bc3d0893 ($11.47 in chips)
Seat 5: 789c6c53 ($3.72 in chips)
Seat 6: 3845acf7 ($6.09 in chips)
Hero: posts small blind $0.02
143f3b35: posts big blind $0.05
*** HOLE CARDS ***
Dealt to e0602eaa 
Dealt to Hero [5s Js]
Dealt to 143f3b35 
Dealt to bc3d0893 
Dealt to 789c6c53 
Dealt to 3845acf7 
bc3d0893: folds
789c6c53: calls $0.05
3845acf7: folds
e0602eaa: folds
Hero: folds
143f3b35: checks
*** FLOP *** [7h 5d 6c]
143f3b35: checks
789c6c53: bets $0.1
143f3b35: calls $0.1
*** TURN *** [7h 5d 6c] [9h]
143f3b35: bets $0.11
789c6c53: raises $0.27 to $0.38
143f3b35: calls $0.27
*** RIVER *** [7h 5d 6c 9h] [Jh]
143f3b35: checks
789c6c53: bets $1.08
143f3b35: folds
Uncalled bet ($1.08) returned to 789c6c53
*** SHOWDOWN ***
789c6c53 collected $1.03 from pot
*** SUMMARY ***
Total pot $1.08 | Rake $0.05 | Jackpot $0 | Bingo $0 | Fortune $0 | Tax $0
Board [7h 5d 6c 9h Jh]
Seat 1: e0602eaa (button) folded before Flop (didn't bet)
Seat 2: Hero (small blind) folded before Flop
Seat 3: 143f3b35 (big blind) folded on the River
Seat 4: bc3d0893 folded before Flop (didn't bet)
Seat 5: 789c6c53 won ($1.03)
Seat 6: 3845acf7 folded before Flop (didn't bet)


Poker Hand #RC3795363460: Hold'em No Limit ($0.02/$0.05) - 2025/08/10 02:11:14
Table 'RushAndCash10958720' 6-max Seat #1 is the button
Seat 1: cc57fc1c ($14.28 in chips)
Seat 2: 9626a0e3 ($5.98 in chips)
Seat 3: Hero ($4.68 in chips)
Seat 4: 789c6c53 ($3.52 in chips)
Seat 5: e6507657 ($20.02 in chips)
Seat 6: a579ea8 ($7.67 in chips)
9626a0e3: posts small blind $0.02
Hero: posts big blind $0.05
*** HOLE CARDS ***
Dealt to cc57fc1c 
Dealt to 9626a0e3 
Dealt to Hero [8s Js]
Dealt to 789c6c53 
Dealt to e6507657 
Dealt to a579ea8 
789c6c53: calls $0.05
e6507657: folds
a579ea8: folds
cc57fc1c: folds
9626a0e3: folds
Hero: raises $0.15 to $0.2
789c6c53: calls $0.15
*** FLOP *** [7d 5s Ah]
Hero: checks
789c6c53: bets $0.34
Hero: folds
Uncalled bet ($0.34) returned to 789c6c53
*** SHOWDOWN ***
789c6c53 collected $0.4 from pot
*** SUMMARY ***
Total pot $0.42 | Rake $0.02 | Jackpot $0 | Bingo $0 | Fortune $0 | Tax $0
Board [7d 5s Ah]
Seat 1: cc57fc1c (button) folded before Flop (didn't bet)
Seat 2: 9626a0e3 (small blind) folded before Flop
Seat 3: Hero (big blind) folded on the Flop
Seat 4: 789c6c53 won ($0.4)
Seat 5: e6507657 folded before Flop (didn't bet)
Seat 6: a579ea8 folded before Flop (didn't bet)


Poker Hand #RC3795363421: Hold'em No Limit ($0.02/$0.05) - 2025/08/10 02:11:08
Table 'RushAndCash10958681' 6-max Seat #1 is the button
Seat 1: Hero ($4.68 in chips)
Seat 2: b1603441 ($5.02 in chips)
Seat 3: eac403b8 ($7.98 in chips)
Seat 4: 696a490 ($6.98 in chips)
Seat 5: 8f698dc ($5.23 in chips)
Seat 6: 286965fb ($5.41 in chips)
b1603441: posts small blind $0.02
eac403b8: posts big blind $0.05
*** HOLE CARDS ***
Dealt to Hero [9d 7c]
Dealt to b1603441 
Dealt to eac403b8 
Dealt to 696a490 
Dealt to 8f698dc 
Dealt to 286965fb 
696a490: folds
8f698dc: raises $0.08 to $0.13
286965fb: folds
Hero: folds
b1603441: folds
eac403b8: raises $0.32 to $0.45
8f698dc: raises $0.69 to $1.14
eac403b8: folds
Uncalled bet ($0.69) returned to 8f698dc
*** SHOWDOWN ***
8f698dc collected $0.88 from pot
*** SUMMARY ***
Total pot $0.92 | Rake $0.04 | Jackpot $0 | Bingo $0 | Fortune $0 | Tax $0
Seat 1: Hero (button) folded before Flop (didn't bet)
Seat 2: b1603441 (small blind) folded before Flop
Seat 3: eac403b8 (big blind) folded before Flop
Seat 4: 696a490 folded before Flop (didn't bet)
Seat 5: 8f698dc collected ($0.88)
Seat 6: 286965fb folded before Flop (didn't bet)


Poker Hand #RC3795363281: Hold'em No Limit ($0.02/$0.05) - 2025/08/10 02:10:46
Table 'RushAndCash10958541' 6-max Seat #1 is the button
Seat 1: 709d6fad ($12.04 in chips)
Seat 2: Hero ($4.7 in chips)
Seat 3: ee9d96cb ($5.57 in chips)
Seat 4: 143f3b35 ($4.91 in chips)
Seat 5: 9b8f0db5 ($4.85 in chips)
Seat 6: e1219075 ($7.31 in chips)
Hero: posts small blind $0.02
ee9d96cb: posts big blind $0.05
*** HOLE CARDS ***
Dealt to 709d6fad 
Dealt to Hero [5s 6h]
Dealt to ee9d96cb 
Dealt to 143f3b35 
Dealt to 9b8f0db5 
Dealt to e1219075 
143f3b35: folds
9b8f0db5: raises $0.1 to $0.15
e1219075: folds
709d6fad: folds
Hero: folds
ee9d96cb: folds
Uncalled bet ($0.1) returned to 9b8f0db5
*** SHOWDOWN ***
9b8f0db5 collected $0.12 from pot
*** SUMMARY ***
Total pot $0.12 | Rake $0 | Jackpot $0 | Bingo $0 | Fortune $0 | Tax $0
Seat 1: 709d6fad (button) folded before Flop (didn't bet)
Seat 2: Hero (small blind) folded before Flop
Seat 3: ee9d96cb (big blind) folded before Flop
Seat 4: 143f3b35 folded before Flop (didn't bet)
Seat 5: 9b8f0db5 collected ($0.12)
Seat 6: e1219075 folded before Flop (didn't bet)


Poker Hand #RC3795363048: Hold'em No Limit ($0.02/$0.05) - 2025/08/10 02:10:09
Table 'RushAndCash10958308' 6-max Seat #1 is the button
Seat 1: 74785f10 ($9.02 in chips)
Seat 2: 192d221d ($4.39 in chips)
Seat 3: Hero ($5.18 in chips)
Seat 4: 709d6fad ($11.49 in chips)
Seat 5: 3c2d08e6 ($5.02 in chips)
Seat 6: 83f3b278 ($5 in chips)
192d221d: posts small blind $0.02
Hero: posts big blind $0.05
*** HOLE CARDS ***
Dealt to 74785f10 
Dealt to 192d221d 
Dealt to Hero [Ah Qs]
Dealt to 709d6fad 
Dealt to 3c2d08e6 
Dealt to 83f3b278 
709d6fad: raises $0.05 to $0.1
3c2d08e6: folds
83f3b278: calls $0.1
74785f10: folds
192d221d: folds
Hero: raises $0.38 to $0.48
709d6fad: raises $0.81 to $1.29
83f3b278: folds
Hero: folds
Uncalled bet ($0.81) returned to 709d6fad
*** SHOWDOWN ***
709d6fad collected $1.03 from pot
*** SUMMARY ***
Total pot $1.08 | Rake $0.05 | Jackpot $0 | Bingo $0 | Fortune $0 | Tax $0
Seat 1: 74785f10 (button) folded before Flop (didn't bet)
Seat 2: 192d221d (small blind) folded before Flop
Seat 3: Hero (big blind) folded before Flop
Seat 4: 709d6fad collected ($1.03)
Seat 5: 3c2d08e6 folded before Flop (didn't bet)
Seat 6: 83f3b278 folded before Flop


Poker Hand #RC3795363019: Hold'em No Limit ($0.02/$0.05) - 2025/08/10 02:10:04
Table 'RushAndCash10958279' 6-max Seat #1 is the button
Seat 1: ca274c3 ($6.15 in chips)
Seat 2: f5930c62 ($5.24 in chips)
Seat 3: d811f18f ($5 in chips)
Seat 4: 12d4819b ($5.57 in chips)
Seat 5: Hero ($5.18 in chips)
Seat 6: 34e4d292 ($7.75 in chips)
f5930c62: posts small blind $0.02
d811f18f: posts big blind $0.05
*** HOLE CARDS ***
Dealt to ca274c3 
Dealt to f5930c62 
Dealt to d811f18f 
Dealt to 12d4819b 
Dealt to Hero [Kc 7d]
Dealt to 34e4d292 
12d4819b: folds
Hero: folds
34e4d292: folds
ca274c3: folds
f5930c62: folds
Uncalled bet ($0.03) returned to d811f18f
*** SHOWDOWN ***
d811f18f collected $0.04 from pot
*** SUMMARY ***
Total pot $0.04 | Rake $0 | Jackpot $0 | Bingo $0 | Fortune $0 | Tax $0
Seat 1: ca274c3 (button) folded before Flop (didn't bet)
Seat 2: f5930c62 (small blind) folded before Flop
Seat 3: d811f18f (big blind) collected ($0.04)
Seat 4: 12d4819b folded before Flop (didn't bet)
Seat 5: Hero folded before Flop (didn't bet)
Seat 6: 34e4d292 folded before Flop (didn't bet)


Poker Hand #RC3795362865: Hold'em No Limit ($0.02/$0.05) - 2025/08/10 02:09:40
Table 'RushAndCash10958125' 6-max Seat #1 is the button
Seat 1: fbb724ae ($2.93 in chips)
Seat 2: 6160e53f ($5.68 in chips)
Seat 3: 9ae88339 ($1.77 in chips)
Seat 4: Hero ($5.18 in chips)
Seat 5: 70aa16d9 ($6.57 in chips)
Seat 6: 19819752 ($5.37 in chips)
Cash Drop to Pot : total $0.5 
6160e53f: posts small blind $0.02
9ae88339: posts big blind $0.05
*** HOLE CARDS ***
Dealt to fbb724ae 
Dealt to 6160e53f 
Dealt to 9ae88339 
Dealt to Hero [3d 7h]
Dealt to 70aa16d9 
Dealt to 19819752 
Hero: folds
70aa16d9: folds
19819752: calls $0.05
fbb724ae: folds
6160e53f: calls $0.03
9ae88339: checks
*** FLOP *** [Js Kc Tc]
6160e53f: checks
9ae88339: checks
19819752: bets $0.33
6160e53f: folds
9ae88339: folds
Uncalled bet ($0.33) returned to 19819752
*** SHOWDOWN ***
19819752 collected $0.62 from pot
*** SUMMARY ***
Total pot $0.65 | Rake $0.03 | Jackpot $0 | Bingo $0 | Fortune $0 | Tax $0
Board [Js Kc Tc]
Seat 1: fbb724ae (button) folded before Flop (didn't bet)
Seat 2: 6160e53f (small blind) folded on the Flop
Seat 3: 9ae88339 (big blind) folded on the Flop
Seat 4: Hero folded before Flop (didn't bet)
Seat 5: 70aa16d9 folded before Flop (didn't bet)
Seat 6: 19819752 won ($0.62)


Poker Hand #RC3795362774: Hold'em No Limit ($0.02/$0.05) - 2025/08/10 02:09:25
Table 'RushAndCash10958034' 6-max Seat #1 is the button
Seat 1: Hero ($5.18 in chips)
Seat 2: dd8777a7 ($5 in chips)
Seat 3: b2591c47 ($5.22 in chips)
Seat 4: 7ff1a84a ($6.82 in chips)
Seat 5: 5a0773bb ($5.07 in chips)
Seat 6: b7cf9a6f ($4.97 in chips)
dd8777a7: posts small blind $0.02
b2591c47: posts big blind $0.05
*** HOLE CARDS ***
Dealt to Hero [Th 3s]
Dealt to dd8777a7 
Dealt to b2591c47 
Dealt to 7ff1a84a 
Dealt to 5a0773bb 
Dealt to b7cf9a6f 
7ff1a84a: folds
5a0773bb: raises $0.05 to $0.1
b7cf9a6f: folds
Hero: folds
dd8777a7: folds
b2591c47: folds
Uncalled bet ($0.05) returned to 5a0773bb
*** SHOWDOWN ***
5a0773bb collected $0.12 from pot
*** SUMMARY ***
Total pot $0.12 | Rake $0 | Jackpot $0 | Bingo $0 | Fortune $0 | Tax $0
Seat 1: Hero (button) folded before Flop (didn't bet)
Seat 2: dd8777a7 (small blind) folded before Flop
Seat 3: b2591c47 (big blind) folded before Flop
Seat 4: 7ff1a84a folded before Flop (didn't bet)
Seat 5: 5a0773bb collected ($0.12)
Seat 6: b7cf9a6f folded before Flop (didn't bet)


Poker Hand #RC3795362737: Hold'em No Limit ($0.02/$0.05) - 2025/08/10 02:09:20
Table 'RushAndCash10957997' 6-max Seat #1 is the button
Seat 1: 6c9a5dd8 ($5.64 in chips)
Seat 2: 14c6d3dd ($5.27 in chips)
Seat 3: e9f90326 ($11.77 in chips)
Seat 4: 28b6bd40 ($15.78 in chips)
Seat 5: f9f8cb03 ($5.68 in chips)
Seat 6: Hero ($5.18 in chips)
14c6d3dd: posts small blind $0.02
e9f90326: posts big blind $0.05
*** HOLE CARDS ***
Dealt to 6c9a5dd8 
Dealt to 14c6d3dd 
Dealt to e9f90326 
Dealt to 28b6bd40 
Dealt to f9f8cb03 
Dealt to Hero [4c 9s]
28b6bd40: raises $0.05 to $0.1
f9f8cb03: folds
Hero: folds
6c9a5dd8: folds
14c6d3dd: folds
e9f90326: calls $0.05
*** FLOP *** [Qc 2d 6s]
e9f90326: checks
28b6bd40: checks
*** TURN *** [Qc 2d 6s] [6h]
e9f90326: bets $0.17
28b6bd40: folds
Uncalled bet ($0.17) returned to e9f90326
*** SHOWDOWN ***
e9f90326 collected $0.21 from pot
*** SUMMARY ***
Total pot $0.22 | Rake $0.01 | Jackpot $0 | Bingo $0 | Fortune $0 | Tax $0
Board [Qc 2d 6s 6h]
Seat 1: 6c9a5dd8 (button) folded before Flop (didn't bet)
Seat 2: 14c6d3dd (small blind) folded before Flop
Seat 3: e9f90326 (big blind) won ($0.21)
Seat 4: 28b6bd40 folded on the Turn
Seat 5: f9f8cb03 folded before Flop (didn't bet)
Seat 6: Hero folded before Flop (didn't bet)


Poker Hand #RC3795362604: Hold'em No Limit ($0.02/$0.05) - 2025/08/10 02:08:59
Table 'RushAndCash10957864' 6-max Seat #1 is the button
Seat 1: 1e85b50 ($29.83 in chips)
Seat 2: Hero ($5.2 in chips)
Seat 3: 61875d12 ($5 in chips)
Seat 4: 569a45d0 ($1.86 in chips)
Seat 5: f617d80c ($7.11 in chips)
Seat 6: 6bf799c1 ($5.41 in chips)
Hero: posts small blind $0.02
61875d12: posts big blind $0.05
*** HOLE CARDS ***
Dealt to 1e85b50 
Dealt to Hero [Qd 9c]
Dealt to 61875d12 
Dealt to 569a45d0 
Dealt to f617d80c 
Dealt to 6bf799c1 
569a45d0: folds
f617d80c: folds
6bf799c1: folds
1e85b50: raises $0.08 to $0.13
Hero: folds
61875d12: folds
Uncalled bet ($0.08) returned to 1e85b50
*** SHOWDOWN ***
1e85b50 collected $0.12 from pot
*** SUMMARY ***
Total pot $0.12 | Rake $0 | Jackpot $0 | Bingo $0 | Fortune $0 | Tax $0
Seat 1: 1e85b50 (button) collected ($0.12)
Seat 2: Hero (small blind) folded before Flop
Seat 3: 61875d12 (big blind) folded before Flop
Seat 4: 569a45d0 folded before Flop (didn't bet)
Seat 5: f617d80c folded before Flop (didn't bet)
Seat 6: 6bf799c1 folded before Flop (didn't bet)


Poker Hand #RC3795362583: Hold'em No Limit ($0.02/$0.05) - 2025/08/10 02:08:56
Table 'RushAndCash10957843' 6-max Seat #1 is the button
Seat 1: f1205850 ($5.09 in chips)
Seat 2: b0a25e76 ($1.88 in chips)
Seat 3: 2d81f74b ($13.72 in chips)
Seat 4: 61875d12 ($5 in chips)
Seat 5: 53f36306 ($5.23 in chips)
Seat 6: Hero ($5.2 in chips)
b0a25e76: posts small blind $0.02
2d81f74b: posts big blind $0.05
*** HOLE CARDS ***
Dealt to f1205850 
Dealt to b0a25e76 
Dealt to 2d81f74b 
Dealt to 61875d12 
Dealt to 53f36306 
Dealt to Hero [3c 9s]
61875d12: folds
53f36306: folds
Hero: folds
f1205850: folds
b0a25e76: raises $0.05 to $0.1
2d81f74b: folds
Uncalled bet ($0.05) returned to b0a25e76
*** SHOWDOWN ***
b0a25e76 collected $0.1 from pot
*** SUMMARY ***
Total pot $0.1 | Rake $0 | Jackpot $0 | Bingo $0 | Fortune $0 | Tax $0
Seat 1: f1205850 (button) folded before Flop (didn't bet)
Seat 2: b0a25e76 (small blind) collected ($0.1)
Seat 3: 2d81f74b (big blind) folded before Flop
Seat 4: 61875d12 folded before Flop (didn't bet)
Seat 5: 53f36306 folded before Flop (didn't bet)
Seat 6: Hero folded before Flop (didn't bet)


Poker Hand #RC3795362557: Hold'em No Limit ($0.02/$0.05) - 2025/08/10 02:08:52
Table 'RushAndCash10957817' 6-max Seat #1 is the button
Seat 1: 9366af84 ($14.44 in chips)
Seat 2: ebe5f93a ($5.64 in chips)
Seat 3: 8c0de850 ($5.02 in chips)
Seat 4: c233e8c8 ($5.43 in chips)
Seat 5: 53a63ea1 ($9.08 in chips)
Seat 6: Hero ($5.2 in chips)
ebe5f93a: posts small blind $0.02
8c0de850: posts big blind $0.05
*** HOLE CARDS ***
Dealt to 9366af84 
Dealt to ebe5f93a 
Dealt to 8c0de850 
Dealt to c233e8c8 
Dealt to 53a63ea1 
Dealt to Hero [7s Jd]
c233e8c8: raises $0.05 to $0.1
53a63ea1: folds
Hero: folds
9366af84: folds
ebe5f93a: folds
8c0de850: folds
Uncalled bet ($0.05) returned to c233e8c8
*** SHOWDOWN ***
c233e8c8 collected $0.12 from pot
*** SUMMARY ***
Total pot $0.12 | Rake $0 | Jackpot $0 | Bingo $0 | Fortune $0 | Tax $0
Seat 1: 9366af84 (button) folded before Flop (didn't bet)
Seat 2: ebe5f93a (small blind) folded before Flop
Seat 3: 8c0de850 (big blind) folded before Flop
Seat 4: c233e8c8 collected ($0.12)
Seat 5: 53a63ea1 folded before Flop (didn't bet)
Seat 6: Hero folded before Flop (didn't bet)


Poker Hand #RC3795362510: Hold'em No Limit ($0.02/$0.05) - 2025/08/10 02:08:44
Table 'RushAndCash10957770' 6-max Seat #1 is the button
Seat 1: 867d2c83 ($5.31 in chips)
Seat 2: 9b2ae90e ($5.76 in chips)
Seat 3: Hero ($5.25 in chips)
Seat 4: d8ee5171 ($8.08 in chips)
Seat 5: cf2ee802 ($3.05 in chips)
Seat 6: dd8777a7 ($5 in chips)
9b2ae90e: posts small blind $0.02
Hero: posts big blind $0.05
*** HOLE CARDS ***
Dealt to 867d2c83 
Dealt to 9b2ae90e 
Dealt to Hero [Ks 7c]
Dealt to d8ee5171 
Dealt to cf2ee802 
Dealt to dd8777a7 
d8ee5171: folds
cf2ee802: raises $0.05 to $0.1
dd8777a7: folds
867d2c83: folds
9b2ae90e: folds
Hero: folds
Uncalled bet ($0.05) returned to cf2ee802
*** SHOWDOWN ***
cf2ee802 collected $0.12 from pot
*** SUMMARY ***
Total pot $0.12 | Rake $0 | Jackpot $0 | Bingo $0 | Fortune $0 | Tax $0
Seat 1: 867d2c83 (button) folded before Flop (didn't bet)
Seat 2: 9b2ae90e (small blind) folded before Flop
Seat 3: Hero (big blind) folded before Flop
Seat 4: d8ee5171 folded before Flop (didn't bet)
Seat 5: cf2ee802 collected ($0.12)
Seat 6: dd8777a7 folded before Flop (didn't bet)


Poker Hand #RC3795362473: Hold'em No Limit ($0.02/$0.05) - 2025/08/10 02:08:38
Table 'RushAndCash10957733' 6-max Seat #1 is the button
Seat 1: c4549f6c ($5.49 in chips)
Seat 2: 3389168b ($9.8 in chips)
Seat 3: a18f15bd ($5.76 in chips)
Seat 4: ee9eafe3 ($27.93 in chips)
Seat 5: Hero ($5.25 in chips)
Seat 6: ad670634 ($9.63 in chips)
3389168b: posts small blind $0.02
a18f15bd: posts big blind $0.05
*** HOLE CARDS ***
Dealt to c4549f6c 
Dealt to 3389168b 
Dealt to a18f15bd 
Dealt to ee9eafe3 
Dealt to Hero [9h Ts]
Dealt to ad670634 
ee9eafe3: raises $0.08 to $0.13
Hero: folds
ad670634: folds
c4549f6c: folds
3389168b: calls $0.11
a18f15bd: folds
*** FLOP *** [Ks Kc Qd]
3389168b: checks
ee9eafe3: checks
*** TURN *** [Ks Kc Qd] [7c]
3389168b: checks
ee9eafe3: checks
*** RIVER *** [Ks Kc Qd 7c] [3s]
3389168b: checks
ee9eafe3: bets $0.11
3389168b: folds
Uncalled bet ($0.11) returned to ee9eafe3
*** SHOWDOWN ***
ee9eafe3 collected $0.3 from pot
*** SUMMARY ***
Total pot $0.31 | Rake $0.01 | Jackpot $0 | Bingo $0 | Fortune $0 | Tax $0
Board [Ks Kc Qd 7c 3s]
Seat 1: c4549f6c (button) folded before Flop (didn't bet)
Seat 2: 3389168b (small blind) folded on the River
Seat 3: a18f15bd (big blind) folded before Flop
Seat 4: ee9eafe3 won ($0.3)
Seat 5: Hero folded before Flop (didn't bet)
Seat 6: ad670634 folded before Flop (didn't bet)


Poker Hand #RC3795362338: Hold'em No Limit ($0.02/$0.05) - 2025/08/10 02:08:15
Table 'RushAndCash10957598' 6-max Seat #1 is the button
Seat 1: Hero ($5.25 in chips)
Seat 2: f32deb6b ($8.15 in chips)
Seat 3: b829d894 ($5.27 in chips)
Seat 4: 341b726c ($5 in chips)
Seat 5: 5f592c19 ($7.32 in chips)
Seat 6: 99c9b3ec ($6.33 in chips)
f32deb6b: posts small blind $0.02
b829d894: posts big blind $0.05
*** HOLE CARDS ***
Dealt to Hero [3d Tc]
Dealt to f32deb6b 
Dealt to b829d894 
Dealt to 341b726c 
Dealt to 5f592c19 
Dealt to 99c9b3ec 
341b726c: folds
5f592c19: folds
99c9b3ec: raises $0.07 to $0.12
Hero: folds
f32deb6b: folds
b829d894: folds
Uncalled bet ($0.07) returned to 99c9b3ec
*** SHOWDOWN ***
99c9b3ec collected $0.12 from pot
*** SUMMARY ***
Total pot $0.12 | Rake $0 | Jackpot $0 | Bingo $0 | Fortune $0 | Tax $0
Seat 1: Hero (button) folded before Flop (didn't bet)
Seat 2: f32deb6b (small blind) folded before Flop
Seat 3: b829d894 (big blind) folded before Flop
Seat 4: 341b726c folded before Flop (didn't bet)
Seat 5: 5f592c19 folded before Flop (didn't bet)
Seat 6: 99c9b3ec collected ($0.12)


Poker Hand #RC3795362318: Hold'em No Limit ($0.02/$0.05) - 2025/08/10 02:08:12
Table 'RushAndCash10957578' 6-max Seat #1 is the button
Seat 1: dd0df2bb ($5 in chips)
Seat 2: 6392f6fa ($5 in chips)
Seat 3: db9525e1 ($5.11 in chips)
Seat 4: 4d5a4ee5 ($10.53 in chips)
Seat 5: Hero ($5.25 in chips)
Seat 6: 2120892e ($10.29 in chips)
6392f6fa: posts small blind $0.02
db9525e1: posts big blind $0.05
*** HOLE CARDS ***
Dealt to dd0df2bb 
Dealt to 6392f6fa 
Dealt to db9525e1 
Dealt to 4d5a4ee5 
Dealt to Hero [6s Qc]
Dealt to 2120892e 
4d5a4ee5: folds
Hero: folds
2120892e: folds
dd0df2bb: folds
6392f6fa: folds
Uncalled bet ($0.03) returned to db9525e1
*** SHOWDOWN ***
db9525e1 collected $0.04 from pot
*** SUMMARY ***
Total pot $0.04 | Rake $0 | Jackpot $0 | Bingo $0 | Fortune $0 | Tax $0
Seat 1: dd0df2bb (button) folded before Flop (didn't bet)
Seat 2: 6392f6fa (small blind) folded before Flop
Seat 3: db9525e1 (big blind) collected ($0.04)
Seat 4: 4d5a4ee5 folded before Flop (didn't bet)
Seat 5: Hero folded before Flop (didn't bet)
Seat 6: 2120892e folded before Flop (didn't bet)


Poker Hand #RC3795362297: Hold'em No Limit ($0.02/$0.05) - 2025/08/10 02:08:08
Table 'RushAndCash10957557' 6-max Seat #1 is the button
Seat 1: b311f36c ($7.01 in chips)
Seat 2: b45a0726 ($11.76 in chips)
Seat 3: 68311139 ($5 in chips)
Seat 4: daeab3be ($5.64 in chips)
Seat 5: Hero ($5.25 in chips)
Seat 6: f617d80c ($7.18 in chips)
b45a0726: posts small blind $0.02
68311139: posts big blind $0.05
*** HOLE CARDS ***
Dealt to b311f36c 
Dealt to b45a0726 
Dealt to 68311139 
Dealt to daeab3be 
Dealt to Hero [9h Td]
Dealt to f617d80c 
daeab3be: folds
Hero: folds
f617d80c: folds
b311f36c: raises $0.07 to $0.12
b45a0726: folds
68311139: folds
Uncalled bet ($0.07) returned to b311f36c
*** SHOWDOWN ***
b311f36c collected $0.12 from pot
*** SUMMARY ***
Total pot $0.12 | Rake $0 | Jackpot $0 | Bingo $0 | Fortune $0 | Tax $0
Seat 1: b311f36c (button) collected ($0.12)
Seat 2: b45a0726 (small blind) folded before Flop
Seat 3: 68311139 (big blind) folded before Flop
Seat 4: daeab3be folded before Flop (didn't bet)
Seat 5: Hero folded before Flop (didn't bet)
Seat 6: f617d80c folded before Flop (didn't bet)


Poker Hand #RC3795361970: Hold'em No Limit ($0.02/$0.05) - 2025/08/10 02:07:14
Table 'RushAndCash10957230' 6-max Seat #1 is the button
Seat 1: Hero ($5.61 in chips)
Seat 2: 3f567c76 ($8.38 in chips)
Seat 3: f617d80c ($6.83 in chips)
Seat 4: 32f680d4 ($4.61 in chips)
Seat 5: db9525e1 ($5.21 in chips)
Seat 6: b61cb97f ($9.12 in chips)
3f567c76: posts small blind $0.02
f617d80c: posts big blind $0.05
*** HOLE CARDS ***
Dealt to Hero [5h 6h]
Dealt to 3f567c76 
Dealt to f617d80c 
Dealt to 32f680d4 
Dealt to db9525e1 
Dealt to b61cb97f 
32f680d4: folds
db9525e1: folds
b61cb97f: folds
Hero: raises $0.05 to $0.1
3f567c76: folds
f617d80c: calls $0.05
*** FLOP *** [Ad Js Qd]
f617d80c: checks
Hero: checks
*** TURN *** [Ad Js Qd] [Jh]
f617d80c: checks
Hero: checks
*** RIVER *** [Ad Js Qd Jh] [4d]
f617d80c: checks
Hero: bets $0.26
f617d80c: calls $0.26
Hero: shows [5h 6h] (a pair of Jacks)
f617d80c: shows [6d 4h] (two pair, Jacks and Fours)
*** SHOWDOWN ***
f617d80c collected $0.71 from pot
*** SUMMARY ***
Total pot $0.74 | Rake $0.03 | Jackpot $0 | Bingo $0 | Fortune $0 | Tax $0
Board [Ad Js Qd Jh 4d]
Seat 1: Hero (button) showed [5h 6h] and lost with a pair of Jacks
Seat 2: 3f567c76 (small blind) folded before Flop
Seat 3: f617d80c (big blind) showed [6d 4h] and won ($0.71) with two pair, Jacks and Fours
Seat 4: 32f680d4 folded before Flop (didn't bet)
Seat 5: db9525e1 folded before Flop (didn't bet)
Seat 6: b61cb97f folded before Flop (didn't bet)


Poker Hand #RC3795361939: Hold'em No Limit ($0.02/$0.05) - 2025/08/10 02:07:09
Table 'RushAndCash10957199' 6-max Seat #1 is the button
Seat 1: 37ddfa94 ($4.58 in chips)
Seat 2: Hero ($5.63 in chips)
Seat 3: 8772cba ($13.3 in chips)
Seat 4: 12d4819b ($5.48 in chips)
Seat 5: 2f46fd74 ($4.29 in chips)
Seat 6: 15e16149 ($7.9 in chips)
Hero: posts small blind $0.02
8772cba: posts big blind $0.05
*** HOLE CARDS ***
Dealt to 37ddfa94 
Dealt to Hero [3d 8c]
Dealt to 8772cba 
Dealt to 12d4819b 
Dealt to 2f46fd74 
Dealt to 15e16149 
12d4819b: folds
2f46fd74: folds
15e16149: folds
37ddfa94: folds
Hero: folds
Uncalled bet ($0.03) returned to 8772cba
*** SHOWDOWN ***
8772cba collected $0.04 from pot
*** SUMMARY ***
Total pot $0.04 | Rake $0 | Jackpot $0 | Bingo $0 | Fortune $0 | Tax $0
Seat 1: 37ddfa94 (button) folded before Flop (didn't bet)
Seat 2: Hero (small blind) folded before Flop
Seat 3: 8772cba (big blind) collected ($0.04)
Seat 4: 12d4819b folded before Flop (didn't bet)
Seat 5: 2f46fd74 folded before Flop (didn't bet)
Seat 6: 15e16149 folded before Flop (didn't bet)


Poker Hand #RC3795361828: Hold'em No Limit ($0.02/$0.05) - 2025/08/10 02:06:49
Table 'RushAndCash10957088' 6-max Seat #1 is the button
Seat 1: 9c1d6952 ($5.01 in chips)
Seat 2: 359b44cd ($5.16 in chips)
Seat 3: Hero ($5.68 in chips)
Seat 4: 75816c99 ($5 in chips)
Seat 5: 92682e4 ($26.73 in chips)
Seat 6: cda08fd1 ($5 in chips)
359b44cd: posts small blind $0.02
Hero: posts big blind $0.05
*** HOLE CARDS ***
Dealt to 9c1d6952 
Dealt to 359b44cd 
Dealt to Hero [Ad 9d]
Dealt to 75816c99 
Dealt to 92682e4 
Dealt to cda08fd1 
75816c99: folds
92682e4: raises $0.08 to $0.13
cda08fd1: raises $0.25 to $0.38
9c1d6952: folds
359b44cd: folds
Hero: folds
92682e4: calls $0.25
*** FLOP *** [6s Kc 8c]
92682e4: bets $0.63
cda08fd1: folds
Uncalled bet ($0.63) returned to 92682e4
*** SHOWDOWN ***
92682e4 collected $0.79 from pot
*** SUMMARY ***
Total pot $0.83 | Rake $0.04 | Jackpot $0 | Bingo $0 | Fortune $0 | Tax $0
Board [6s Kc 8c]
Seat 1: 9c1d6952 (button) folded before Flop (didn't bet)
Seat 2: 359b44cd (small blind) folded before Flop
Seat 3: Hero (big blind) folded before Flop
Seat 4: 75816c99 folded before Flop (didn't bet)
Seat 5: 92682e4 won ($0.79)
Seat 6: cda08fd1 folded on the Flop


Poker Hand #RC3795361623: Hold'em No Limit ($0.02/$0.05) - 2025/08/10 02:06:14
Table 'RushAndCash10956883' 6-max Seat #1 is the button
Seat 1: 359b44cd ($5 in chips)
Seat 2: e9a34763 ($5 in chips)
Seat 3: 4e431ea6 ($5 in chips)
Seat 4: d9d39bb8 ($5 in chips)
Seat 5: 6daec6e5 ($5 in chips)
Seat 6: Hero ($5.78 in chips)
e9a34763: posts small blind $0.02
4e431ea6: posts big blind $0.05
*** HOLE CARDS ***
Dealt to 359b44cd 
Dealt to e9a34763 
Dealt to 4e431ea6 
Dealt to d9d39bb8 
Dealt to 6daec6e5 
Dealt to Hero [Ks Td]
d9d39bb8: folds
6daec6e5: folds
Hero: raises $0.05 to $0.1
359b44cd: calls $0.1
e9a34763: folds
4e431ea6: folds
*** FLOP *** [5d 8s 5c]
Hero: checks
359b44cd: bets $0.1
Hero: folds
Uncalled bet ($0.1) returned to 359b44cd
*** SHOWDOWN ***
359b44cd collected $0.26 from pot
*** SUMMARY ***
Total pot $0.27 | Rake $0.01 | Jackpot $0 | Bingo $0 | Fortune $0 | Tax $0
Board [5d 8s 5c]
Seat 1: 359b44cd (button) won ($0.26)
Seat 2: e9a34763 (small blind) folded before Flop
Seat 3: 4e431ea6 (big blind) folded before Flop
Seat 4: d9d39bb8 folded before Flop (didn't bet)
Seat 5: 6daec6e5 folded before Flop (didn't bet)
Seat 6: Hero folded on the Flop


Poker Hand #RC3795361600: Hold'em No Limit ($0.02/$0.05) - 2025/08/10 02:06:10
Table 'RushAndCash10956860' 6-max Seat #1 is the button
Seat 1: 9980de00 ($5.03 in chips)
Seat 2: ae33334 ($5.29 in chips)
Seat 3: 8a1fba16 ($7.4 in chips)
Seat 4: c48f6f4f ($12.11 in chips)
Seat 5: 109477d4 ($5.54 in chips)
Seat 6: Hero ($5.78 in chips)
ae33334: posts small blind $0.02
8a1fba16: posts big blind $0.05
*** HOLE CARDS ***
Dealt to 9980de00 
Dealt to ae33334 
Dealt to 8a1fba16 
Dealt to c48f6f4f 
Dealt to 109477d4 
Dealt to Hero [Tc 6h]
c48f6f4f: folds
109477d4: folds
Hero: folds
9980de00: raises $0.05 to $0.1
ae33334: calls $0.08
8a1fba16: calls $0.05
*** FLOP *** [Ts Jc 5d]
ae33334: checks
8a1fba16: checks
9980de00: bets $0.16
ae33334: folds
8a1fba16: calls $0.16
*** TURN *** [Ts Jc 5d] [7c]
8a1fba16: checks
9980de00: checks
*** RIVER *** [Ts Jc 5d 7c] [8h]
8a1fba16: checks
9980de00: checks
8a1fba16: shows [Jd 8d] (two pair, Jacks and Eights)
9980de00: shows [5s Js] (two pair, Jacks and Fives)
*** SHOWDOWN ***
8a1fba16 collected $0.59 from pot
*** SUMMARY ***
Total pot $0.62 | Rake $0.03 | Jackpot $0 | Bingo $0 | Fortune $0 | Tax $0
Board [Ts Jc 5d 7c 8h]
Seat 1: 9980de00 (button) showed [5s Js] and lost with two pair, Jacks and Fives
Seat 2: ae33334 (small blind) folded on the Flop
Seat 3: 8a1fba16 (big blind) showed [Jd 8d] and won ($0.59) with two pair, Jacks and Eights
Seat 4: c48f6f4f folded before Flop (didn't bet)
Seat 5: 109477d4 folded before Flop (didn't bet)
Seat 6: Hero folded before Flop (didn't bet)


Poker Hand #RC3795361583: Hold'em No Limit ($0.02/$0.05) - 2025/08/10 02:06:07
Table 'RushAndCash10956843' 6-max Seat #1 is the button
Seat 1: eef9fa0e ($8.43 in chips)
Seat 2: b7cf9a6f ($5 in chips)
Seat 3: 6241d5ea ($2 in chips)
Seat 4: bfe8a9c2 ($5.07 in chips)
Seat 5: Hero ($5.78 in chips)
Seat 6: 14c6d3dd ($5 in chips)
b7cf9a6f: posts small blind $0.02
6241d5ea: posts big blind $0.05
*** HOLE CARDS ***
Dealt to eef9fa0e 
Dealt to b7cf9a6f 
Dealt to 6241d5ea 
Dealt to bfe8a9c2 
Dealt to Hero [8c 3c]
Dealt to 14c6d3dd 
bfe8a9c2: folds
Hero: folds
14c6d3dd: folds
eef9fa0e: folds
b7cf9a6f: folds
Uncalled bet ($0.03) returned to 6241d5ea
*** SHOWDOWN ***
6241d5ea collected $0.04 from pot
*** SUMMARY ***
Total pot $0.04 | Rake $0 | Jackpot $0 | Bingo $0 | Fortune $0 | Tax $0
Seat 1: eef9fa0e (button) folded before Flop (didn't bet)
Seat 2: b7cf9a6f (small blind) folded before Flop
Seat 3: 6241d5ea (big blind) collected ($0.04)
Seat 4: bfe8a9c2 folded before Flop (didn't bet)
Seat 5: Hero folded before Flop (didn't bet)
Seat 6: 14c6d3dd folded before Flop (didn't bet)


Poker Hand #RC3795361487: Hold'em No Limit ($0.02/$0.05) - 2025/08/10 02:05:48
Table 'RushAndCash10956747' 6-max Seat #1 is the button
Seat 1: Hero ($5.78 in chips)
Seat 2: b2e4e02f ($5 in chips)
Seat 3: 82a34580 ($8.05 in chips)
Seat 4: 7656ad46 ($8.27 in chips)
Seat 5: 79a5f3b ($10.57 in chips)
Seat 6: 791c5af2 ($6.68 in chips)
b2e4e02f: posts small blind $0.02
82a34580: posts big blind $0.05
*** HOLE CARDS ***
Dealt to Hero [4s As]
Dealt to b2e4e02f 
Dealt to 82a34580 
Dealt to 7656ad46 
Dealt to 79a5f3b 
Dealt to 791c5af2 
7656ad46: folds
79a5f3b: raises $0.05 to $0.1
791c5af2: folds
Hero: folds
b2e4e02f: calls $0.08
82a34580: folds
*** FLOP *** [Ad 3s Jd]
b2e4e02f: checks
79a5f3b: bets $0.09
b2e4e02f: folds
Uncalled bet ($0.09) returned to 79a5f3b
*** SHOWDOWN ***
79a5f3b collected $0.24 from pot
*** SUMMARY ***
Total pot $0.25 | Rake $0.01 | Jackpot $0 | Bingo $0 | Fortune $0 | Tax $0
Board [Ad 3s Jd]
Seat 1: Hero (button) folded before Flop (didn't bet)
Seat 2: b2e4e02f (small blind) folded on the Flop
Seat 3: 82a34580 (big blind) folded before Flop
Seat 4: 7656ad46 folded before Flop (didn't bet)
Seat 5: 79a5f3b won ($0.24)
Seat 6: 791c5af2 folded before Flop (didn't bet)


Poker Hand #RC3795361460: Hold'em No Limit ($0.02/$0.05) - 2025/08/10 02:05:42
Table 'RushAndCash10956720' 6-max Seat #1 is the button
Seat 1: 935ecf12 ($5.1 in chips)
Seat 2: 67934742 ($4.95 in chips)
Seat 3: 63c1e34b ($5.17 in chips)
Seat 4: daeab3be ($5.64 in chips)
Seat 5: Hero ($5.78 in chips)
Seat 6: 1d709ff6 ($5 in chips)
67934742: posts small blind $0.02
63c1e34b: posts big blind $0.05
*** HOLE CARDS ***
Dealt to 935ecf12 
Dealt to 67934742 
Dealt to 63c1e34b 
Dealt to daeab3be 
Dealt to Hero [3d Ah]
Dealt to 1d709ff6 
daeab3be: folds
Hero: folds
1d709ff6: folds
935ecf12: raises $0.08 to $0.13
67934742: folds
63c1e34b: folds
Uncalled bet ($0.08) returned to 935ecf12
*** SHOWDOWN ***
935ecf12 collected $0.12 from pot
*** SUMMARY ***
Total pot $0.12 | Rake $0 | Jackpot $0 | Bingo $0 | Fortune $0 | Tax $0
Seat 1: 935ecf12 (button) collected ($0.12)
Seat 2: 67934742 (small blind) folded before Flop
Seat 3: 63c1e34b (big blind) folded before Flop
Seat 4: daeab3be folded before Flop (didn't bet)
Seat 5: Hero folded before Flop (didn't bet)
Seat 6: 1d709ff6 folded before Flop (didn't bet)


Poker Hand #RC3795361298: Hold'em No Limit ($0.02/$0.05) - 2025/08/10 02:05:13
Table 'RushAndCash10956558' 6-max Seat #1 is the button
Seat 1: 867d2c83 ($5 in chips)
Seat 2: 9629b901 ($5.41 in chips)
Seat 3: Hero ($5.83 in chips)
Seat 4: 1faba582 ($10.56 in chips)
Seat 5: 65dae0f9 ($4.66 in chips)
Seat 6: 4a11baaf ($5.16 in chips)
9629b901: posts small blind $0.02
Hero: posts big blind $0.05
*** HOLE CARDS ***
Dealt to 867d2c83 
Dealt to 9629b901 
Dealt to Hero [Ks 5d]
Dealt to 1faba582 
Dealt to 65dae0f9 
Dealt to 4a11baaf 
1faba582: folds
65dae0f9: raises $0.06 to $0.11
4a11baaf: folds
867d2c83: folds
9629b901: folds
Hero: folds
Uncalled bet ($0.06) returned to 65dae0f9
*** SHOWDOWN ***
65dae0f9 collected $0.12 from pot
*** SUMMARY ***
Total pot $0.12 | Rake $0 | Jackpot $0 | Bingo $0 | Fortune $0 | Tax $0
Seat 1: 867d2c83 (button) folded before Flop (didn't bet)
Seat 2: 9629b901 (small blind) folded before Flop
Seat 3: Hero (big blind) folded before Flop
Seat 4: 1faba582 folded before Flop (didn't bet)
Seat 5: 65dae0f9 collected ($0.12)
Seat 6: 4a11baaf folded before Flop (didn't bet)


Poker Hand #RC3795361200: Hold'em No Limit ($0.02/$0.05) - 2025/08/10 02:04:57
Table 'RushAndCash10956460' 6-max Seat #1 is the button
Seat 1: d23220ed ($2.29 in chips)
Seat 2: Hero ($5.85 in chips)
Seat 3: 9c1d6952 ($5.69 in chips)
Seat 4: e2f651aa ($5.83 in chips)
Seat 5: 264b0521 ($21.94 in chips)
Seat 6: dd8777a7 ($5.05 in chips)
Hero: posts small blind $0.02
9c1d6952: posts big blind $0.05
*** HOLE CARDS ***
Dealt to d23220ed 
Dealt to Hero [6s Ah]
Dealt to 9c1d6952 
Dealt to e2f651aa 
Dealt to 264b0521 
Dealt to dd8777a7 
e2f651aa: folds
264b0521: folds
dd8777a7: folds
d23220ed: raises $0.05 to $0.1
Hero: folds
9c1d6952: folds
Uncalled bet ($0.05) returned to d23220ed
*** SHOWDOWN ***
d23220ed collected $0.12 from pot
*** SUMMARY ***
Total pot $0.12 | Rake $0 | Jackpot $0 | Bingo $0 | Fortune $0 | Tax $0
Seat 1: d23220ed (button) collected ($0.12)
Seat 2: Hero (small blind) folded before Flop
Seat 3: 9c1d6952 (big blind) folded before Flop
Seat 4: e2f651aa folded before Flop (didn't bet)
Seat 5: 264b0521 folded before Flop (didn't bet)
Seat 6: dd8777a7 folded before Flop (didn't bet)


Poker Hand #RC3795361180: Hold'em No Limit ($0.02/$0.05) - 2025/08/10 02:04:54
Table 'RushAndCash10956440' 6-max Seat #1 is the button
Seat 1: a82810b1 ($9.73 in chips)
Seat 2: 81ad14f2 ($5 in chips)
Seat 3: e1c62858 ($5.28 in chips)
Seat 4: Hero ($5.85 in chips)
Seat 5: e2f651aa ($5.83 in chips)
Seat 6: 5b7eadf2 ($8.13 in chips)
81ad14f2: posts small blind $0.02
e1c62858: posts big blind $0.05
*** HOLE CARDS ***
Dealt to a82810b1 
Dealt to 81ad14f2 
Dealt to e1c62858 
Dealt to Hero [Th 4c]
Dealt to e2f651aa 
Dealt to 5b7eadf2 
Hero: folds
e2f651aa: folds
5b7eadf2: folds
a82810b1: folds
81ad14f2: folds
Uncalled bet ($0.03) returned to e1c62858
*** SHOWDOWN ***
e1c62858 collected $0.04 from pot
*** SUMMARY ***
Total pot $0.04 | Rake $0 | Jackpot $0 | Bingo $0 | Fortune $0 | Tax $0
Seat 1: a82810b1 (button) folded before Flop (didn't bet)
Seat 2: 81ad14f2 (small blind) folded before Flop
Seat 3: e1c62858 (big blind) collected ($0.04)
Seat 4: Hero folded before Flop (didn't bet)
Seat 5: e2f651aa folded before Flop (didn't bet)
Seat 6: 5b7eadf2 folded before Flop (didn't bet)


Poker Hand #RC3795361159: Hold'em No Limit ($0.02/$0.05) - 2025/08/10 02:04:50
Table 'RushAndCash10956419' 6-max Seat #1 is the button
Seat 1: 9a763e3c ($9.2 in chips)
Seat 2: 52ac8d1c ($13.73 in chips)
Seat 3: 867d2c83 ($5 in chips)
Seat 4: 81ad14f2 ($5 in chips)
Seat 5: Hero ($5.85 in chips)
Seat 6: 7e60d7cc ($5.7 in chips)
52ac8d1c: posts small blind $0.02
867d2c83: posts big blind $0.05
*** HOLE CARDS ***
Dealt to 9a763e3c 
Dealt to 52ac8d1c 
Dealt to 867d2c83 
Dealt to 81ad14f2 
Dealt to Hero [3h 5s]
Dealt to 7e60d7cc 
81ad14f2: folds
Hero: folds
7e60d7cc: folds
9a763e3c: raises $0.07 to $0.12
52ac8d1c: calls $0.1
867d2c83: folds
*** FLOP *** [2s 2d 5h]
52ac8d1c: checks
9a763e3c: checks
*** TURN *** [2s 2d 5h] [4h]
52ac8d1c: bets $0.21
9a763e3c: folds
Uncalled bet ($0.21) returned to 52ac8d1c
*** SHOWDOWN ***
52ac8d1c collected $0.28 from pot
*** SUMMARY ***
Total pot $0.29 | Rake $0.01 | Jackpot $0 | Bingo $0 | Fortune $0 | Tax $0
Board [2s 2d 5h 4h]
Seat 1: 9a763e3c (button) folded on the Turn
Seat 2: 52ac8d1c (small blind) won ($0.28)
Seat 3: 867d2c83 (big blind) folded before Flop
Seat 4: 81ad14f2 folded before Flop (didn't bet)
Seat 5: Hero folded before Flop (didn't bet)
Seat 6: 7e60d7cc folded before Flop (didn't bet)


Poker Hand #RC3795360987: Hold'em No Limit ($0.02/$0.05) - 2025/08/10 02:04:20
Table 'RushAndCash10956247' 6-max Seat #1 is the button
Seat 1: 5f592c19 ($7.63 in chips)
Seat 2: 85e8b1ca ($6.04 in chips)
Seat 3: 435e1e6c ($5.56 in chips)
Seat 4: 8231d84f ($5 in chips)
Seat 5: Hero ($5.78 in chips)
Seat 6: 709d6fad ($12.55 in chips)
85e8b1ca: posts small blind $0.02
435e1e6c: posts big blind $0.05
*** HOLE CARDS ***
Dealt to 5f592c19 
Dealt to 85e8b1ca 
Dealt to 435e1e6c 
Dealt to 8231d84f 
Dealt to Hero [Jc Ts]
Dealt to 709d6fad 
8231d84f: folds
Hero: raises $0.05 to $0.1
709d6fad: folds
5f592c19: folds
85e8b1ca: folds
435e1e6c: folds
Uncalled bet ($0.05) returned to Hero
*** SHOWDOWN ***
Hero collected $0.12 from pot
*** SUMMARY ***
Total pot $0.12 | Rake $0 | Jackpot $0 | Bingo $0 | Fortune $0 | Tax $0
Seat 1: 5f592c19 (button) folded before Flop (didn't bet)
Seat 2: 85e8b1ca (small blind) folded before Flop
Seat 3: 435e1e6c (big blind) folded before Flop
Seat 4: 8231d84f folded before Flop (didn't bet)
Seat 5: Hero collected ($0.12)
Seat 6: 709d6fad folded before Flop (didn't bet)


Poker Hand #RC3795360865: Hold'em No Limit ($0.02/$0.05) - 2025/08/10 02:03:58
Table 'RushAndCash10956125' 6-max Seat #1 is the button
Seat 1: 4d5a4ee5 ($11.1 in chips)
Seat 2: Hero ($5.8 in chips)
Seat 3: 76ef6bc6 ($23.24 in chips)
Seat 4: 970372f9 ($5.09 in chips)
Seat 5: f07b9ed2 ($6.05 in chips)
Seat 6: c8adc5c2 ($10.87 in chips)
Hero: posts small blind $0.02
76ef6bc6: posts big blind $0.05
*** HOLE CARDS ***
Dealt to 4d5a4ee5 
Dealt to Hero [Ks 7c]
Dealt to 76ef6bc6 
Dealt to 970372f9 
Dealt to f07b9ed2 
Dealt to c8adc5c2 
970372f9: raises $0.05 to $0.1
f07b9ed2: folds
c8adc5c2: folds
4d5a4ee5: raises $0.21 to $0.31
Hero: folds
76ef6bc6: folds
970372f9: folds
Uncalled bet ($0.21) returned to 4d5a4ee5
*** SHOWDOWN ***
4d5a4ee5 collected $0.26 from pot
*** SUMMARY ***
Total pot $0.27 | Rake $0.01 | Jackpot $0 | Bingo $0 | Fortune $0 | Tax $0
Seat 1: 4d5a4ee5 (button) collected ($0.26)
Seat 2: Hero (small blind) folded before Flop
Seat 3: 76ef6bc6 (big blind) folded before Flop
Seat 4: 970372f9 folded before Flop
Seat 5: f07b9ed2 folded before Flop (didn't bet)
Seat 6: c8adc5c2 folded before Flop (didn't bet)


Poker Hand #RC3795360306: Hold'em No Limit ($0.02/$0.05) - 2025/08/10 02:02:13
Table 'RushAndCash10955566' 6-max Seat #1 is the button
Seat 1: ec2dd998 ($3.74 in chips)
Seat 2: f07b9ed2 ($7.92 in chips)
Seat 3: Hero ($3.74 in chips)
Seat 4: bd8827c8 ($5.19 in chips)
Seat 5: fe1f7cf7 ($6.25 in chips)
Seat 6: b37a864b ($8.97 in chips)
f07b9ed2: posts small blind $0.02
Hero: posts big blind $0.05
*** HOLE CARDS ***
Dealt to ec2dd998 
Dealt to f07b9ed2 
Dealt to Hero [6d Kd]
Dealt to bd8827c8 
Dealt to fe1f7cf7 
Dealt to b37a864b 
bd8827c8: folds
fe1f7cf7: folds
b37a864b: raises $0.07 to $0.12
ec2dd998: folds
f07b9ed2: calls $0.1
Hero: calls $0.07
*** FLOP *** [Kc 6s 5c]
f07b9ed2: checks
Hero: checks
b37a864b: checks
*** TURN *** [Kc 6s 5c] [Ts]
f07b9ed2: checks
Hero: bets $0.29
b37a864b: calls $0.29
f07b9ed2: calls $0.29
*** RIVER *** [Kc 6s 5c Ts] [2d]
f07b9ed2: checks
Hero: bets $1.46
b37a864b: folds
f07b9ed2: calls $1.46
Hero: shows [6d Kd] (two pair, Kings and Sixes)
f07b9ed2: shows [Th Js] (a pair of Tens)
*** SHOWDOWN ***
Hero collected $3.93 from pot
*** SUMMARY ***
Total pot $4.15 | Rake $0.15 | Jackpot $0.07 | Bingo $0 | Fortune $0 | Tax $0
Board [Kc 6s 5c Ts 2d]
Seat 1: ec2dd998 (button) folded before Flop (didn't bet)
Seat 2: f07b9ed2 (small blind) showed [Th Js] and lost with a pair of Tens
Seat 3: Hero (big blind) showed [6d Kd] and won ($3.93) with two pair, Kings and Sixes
Seat 4: bd8827c8 folded before Flop (didn't bet)
Seat 5: fe1f7cf7 folded before Flop (didn't bet)
Seat 6: b37a864b folded on the River


Poker Hand #RC3795360268: Hold'em No Limit ($0.02/$0.05) - 2025/08/10 02:02:07
Table 'RushAndCash10955528' 6-max Seat #1 is the button
Seat 1: Hero ($3.74 in chips)
Seat 2: 9366af84 ($14.48 in chips)
Seat 3: e386de17 ($7.02 in chips)
Seat 4: f32deb6b ($8.91 in chips)
Seat 5: e9a34763 ($5 in chips)
Seat 6: e403bbc1 ($5.51 in chips)
9366af84: posts small blind $0.02
e386de17: posts big blind $0.05
*** HOLE CARDS ***
Dealt to Hero [3h 9s]
Dealt to 9366af84 
Dealt to e386de17 
Dealt to f32deb6b 
Dealt to e9a34763 
Dealt to e403bbc1 
f32deb6b: folds
e9a34763: folds
e403bbc1: folds
Hero: folds
9366af84: raises $0.1 to $0.15
e386de17: folds
Uncalled bet ($0.1) returned to 9366af84
*** SHOWDOWN ***
9366af84 collected $0.1 from pot
*** SUMMARY ***
Total pot $0.1 | Rake $0 | Jackpot $0 | Bingo $0 | Fortune $0 | Tax $0
Seat 1: Hero (button) folded before Flop (didn't bet)
Seat 2: 9366af84 (small blind) collected ($0.1)
Seat 3: e386de17 (big blind) folded before Flop
Seat 4: f32deb6b folded before Flop (didn't bet)
Seat 5: e9a34763 folded before Flop (didn't bet)
Seat 6: e403bbc1 folded before Flop (didn't bet)


Poker Hand #RC3795360247: Hold'em No Limit ($0.02/$0.05) - 2025/08/10 02:02:03
Table 'RushAndCash10955507' 6-max Seat #1 is the button
Seat 1: e12e8997 ($7.73 in chips)
Seat 2: ec2dd998 ($3.81 in chips)
Seat 3: 9366af84 ($14.53 in chips)
Seat 4: 791c5af2 ($5 in chips)
Seat 5: e403bbc1 ($5.51 in chips)
Seat 6: Hero ($3.74 in chips)
ec2dd998: posts small blind $0.02
9366af84: posts big blind $0.05
*** HOLE CARDS ***
Dealt to e12e8997 
Dealt to ec2dd998 
Dealt to 9366af84 
Dealt to 791c5af2 
Dealt to e403bbc1 
Dealt to Hero [Th 7d]
791c5af2: folds
e403bbc1: folds
Hero: folds
e12e8997: folds
ec2dd998: folds
Uncalled bet ($0.03) returned to 9366af84
*** SHOWDOWN ***
9366af84 collected $0.04 from pot
*** SUMMARY ***
Total pot $0.04 | Rake $0 | Jackpot $0 | Bingo $0 | Fortune $0 | Tax $0
Seat 1: e12e8997 (button) folded before Flop (didn't bet)
Seat 2: ec2dd998 (small blind) folded before Flop
Seat 3: 9366af84 (big blind) collected ($0.04)
Seat 4: 791c5af2 folded before Flop (didn't bet)
Seat 5: e403bbc1 folded before Flop (didn't bet)
Seat 6: Hero folded before Flop (didn't bet)


Poker Hand #RC3795360226: Hold'em No Limit ($0.02/$0.05) - 2025/08/10 02:02:00
Table 'RushAndCash10955486' 6-max Seat #1 is the button
Seat 1: 48ecb088 ($5.09 in chips)
Seat 2: f95d2fb8 ($6.25 in chips)
Seat 3: 50870e74 ($5.07 in chips)
Seat 4: Hero ($3.74 in chips)
Seat 5: 57582fe7 ($7.64 in chips)
Seat 6: a4931689 ($7.09 in chips)
f95d2fb8: posts small blind $0.02
50870e74: posts big blind $0.05
*** HOLE CARDS ***
Dealt to 48ecb088 
Dealt to f95d2fb8 
Dealt to 50870e74 
Dealt to Hero [2c Qd]
Dealt to 57582fe7 
Dealt to a4931689 
Hero: folds
57582fe7: raises $0.1 to $0.15
a4931689: folds
48ecb088: folds
f95d2fb8: folds
50870e74: folds
Uncalled bet ($0.1) returned to 57582fe7
*** SHOWDOWN ***
57582fe7 collected $0.12 from pot
*** SUMMARY ***
Total pot $0.12 | Rake $0 | Jackpot $0 | Bingo $0 | Fortune $0 | Tax $0
Seat 1: 48ecb088 (button) folded before Flop (didn't bet)
Seat 2: f95d2fb8 (small blind) folded before Flop
Seat 3: 50870e74 (big blind) folded before Flop
Seat 4: Hero folded before Flop (didn't bet)
Seat 5: 57582fe7 collected ($0.12)
Seat 6: a4931689 folded before Flop (didn't bet)


Poker Hand #RC3795360179: Hold'em No Limit ($0.02/$0.05) - 2025/08/10 02:01:50
Table 'RushAndCash10955439' 6-max Seat #1 is the button
Seat 1: 43e3e204 ($5.17 in chips)
Seat 2: Hero ($3.76 in chips)
Seat 3: 5f592c19 ($7.73 in chips)
Seat 4: 50870e74 ($5.07 in chips)
Seat 5: 1ee502bf ($6.47 in chips)
Seat 6: 679c5ea0 ($11.84 in chips)
Hero: posts small blind $0.02
5f592c19: posts big blind $0.05
*** HOLE CARDS ***
Dealt to 43e3e204 
Dealt to Hero [Kd 4h]
Dealt to 5f592c19 
Dealt to 50870e74 
Dealt to 1ee502bf 
Dealt to 679c5ea0 
50870e74: folds
1ee502bf: folds
679c5ea0: folds
43e3e204: raises $0.1 to $0.15
Hero: folds
5f592c19: calls $0.1
*** FLOP *** [7c 6d Th]
5f592c19: checks
43e3e204: bets $0.16
5f592c19: folds
Uncalled bet ($0.16) returned to 43e3e204
*** SHOWDOWN ***
43e3e204 collected $0.31 from pot
*** SUMMARY ***
Total pot $0.32 | Rake $0.01 | Jackpot $0 | Bingo $0 | Fortune $0 | Tax $0
Board [7c 6d Th]
Seat 1: 43e3e204 (button) won ($0.31)
Seat 2: Hero (small blind) folded before Flop
Seat 3: 5f592c19 (big blind) folded on the Flop
Seat 4: 50870e74 folded before Flop (didn't bet)
Seat 5: 1ee502bf folded before Flop (didn't bet)
Seat 6: 679c5ea0 folded before Flop (didn't bet)


Poker Hand #RC3795359980: Hold'em No Limit ($0.02/$0.05) - 2025/08/10 02:01:13
Table 'RushAndCash10955240' 6-max Seat #1 is the button
Seat 1: db28d989 ($4.77 in chips)
Seat 2: 43e3e204 ($5.47 in chips)
Seat 3: Hero ($3.49 in chips)
Seat 4: 34e4d292 ($5.41 in chips)
Seat 5: 2dffe3d3 ($5.31 in chips)
Seat 6: 3c3c41c1 ($5.31 in chips)
43e3e204: posts small blind $0.02
Hero: posts big blind $0.05
*** HOLE CARDS ***
Dealt to db28d989 
Dealt to 43e3e204 
Dealt to Hero [Tc 9h]
Dealt to 34e4d292 
Dealt to 2dffe3d3 
Dealt to 3c3c41c1 
34e4d292: folds
2dffe3d3: folds
3c3c41c1: folds
db28d989: folds
43e3e204: raises $0.1 to $0.15
Hero: calls $0.1
*** FLOP *** [2d 6h 9s]
43e3e204: bets $0.15
Hero: raises $0.21 to $0.36
43e3e204: folds
Uncalled bet ($0.21) returned to Hero
*** SHOWDOWN ***
Hero collected $0.57 from pot
*** SUMMARY ***
Total pot $0.6 | Rake $0.03 | Jackpot $0 | Bingo $0 | Fortune $0 | Tax $0
Board [2d 6h 9s]
Seat 1: db28d989 (button) folded before Flop (didn't bet)
Seat 2: 43e3e204 (small blind) folded on the Flop
Seat 3: Hero (big blind) won ($0.57)
Seat 4: 34e4d292 folded before Flop (didn't bet)
Seat 5: 2dffe3d3 folded before Flop (didn't bet)
Seat 6: 3c3c41c1 folded before Flop (didn't bet)


Poker Hand #RC3795359961: Hold'em No Limit ($0.02/$0.05) - 2025/08/10 02:01:09
Table 'RushAndCash10955221' 6-max Seat #1 is the button
Seat 1: 8d7b2ffb ($7.53 in chips)
Seat 2: 39442e30 ($5.37 in chips)
Seat 3: 6e8ff630 ($2.09 in chips)
Seat 4: Hero ($3.49 in chips)
Seat 5: 125e0487 ($5.67 in chips)
Seat 6: 43e3e204 ($5.47 in chips)
39442e30: posts small blind $0.02
6e8ff630: posts big blind $0.05
*** HOLE CARDS ***
Dealt to 8d7b2ffb 
Dealt to 39442e30 
Dealt to 6e8ff630 
Dealt to Hero [Qh 9s]
Dealt to 125e0487 
Dealt to 43e3e204 
Hero: folds
125e0487: folds
43e3e204: folds
8d7b2ffb: raises $0.12 to $0.17
39442e30: folds
6e8ff630: calls $0.12
*** FLOP *** [Ks 8d Tc]
6e8ff630: checks
8d7b2ffb: bets $0.45
6e8ff630: folds
Uncalled bet ($0.45) returned to 8d7b2ffb
*** SHOWDOWN ***
8d7b2ffb collected $0.34 from pot
*** SUMMARY ***
Total pot $0.36 | Rake $0.02 | Jackpot $0 | Bingo $0 | Fortune $0 | Tax $0
Board [Ks 8d Tc]
Seat 1: 8d7b2ffb (button) won ($0.34)
Seat 2: 39442e30 (small blind) folded before Flop
Seat 3: 6e8ff630 (big blind) folded on the Flop
Seat 4: Hero folded before Flop (didn't bet)
Seat 5: 125e0487 folded before Flop (didn't bet)
Seat 6: 43e3e204 folded before Flop (didn't bet)


Poker Hand #RC3795359935: Hold'em No Limit ($0.02/$0.05) - 2025/08/10 02:01:04
Table 'RushAndCash10955195' 6-max Seat #1 is the button
Seat 1: Hero ($3.49 in chips)
Seat 2: 5deb03c4 ($8.16 in chips)
Seat 3: a82810b1 ($9.6 in chips)
Seat 4: a6d5a8d0 ($5.78 in chips)
Seat 5: b724cb2 ($5 in chips)
Seat 6: 20e4ab0f ($5.07 in chips)
5deb03c4: posts small blind $0.02
a82810b1: posts big blind $0.05
*** HOLE CARDS ***
Dealt to Hero [3s Kc]
Dealt to 5deb03c4 
Dealt to a82810b1 
Dealt to a6d5a8d0 
Dealt to b724cb2 
Dealt to 20e4ab0f 
a6d5a8d0: folds
b724cb2: folds
20e4ab0f: raises $0.08 to $0.13
Hero: folds
5deb03c4: folds
a82810b1: folds
Uncalled bet ($0.08) returned to 20e4ab0f
*** SHOWDOWN ***
20e4ab0f collected $0.12 from pot
*** SUMMARY ***
Total pot $0.12 | Rake $0 | Jackpot $0 | Bingo $0 | Fortune $0 | Tax $0
Seat 1: Hero (button) folded before Flop (didn't bet)
Seat 2: 5deb03c4 (small blind) folded before Flop
Seat 3: a82810b1 (big blind) folded before Flop
Seat 4: a6d5a8d0 folded before Flop (didn't bet)
Seat 5: b724cb2 folded before Flop (didn't bet)
Seat 6: 20e4ab0f collected ($0.12)


Poker Hand #RC3795359912: Hold'em No Limit ($0.02/$0.05) - 2025/08/10 02:01:00
Table 'RushAndCash10955172' 6-max Seat #1 is the button
Seat 1: 8b602c49 ($2.09 in chips)
Seat 2: f17a1c15 ($5 in chips)
Seat 3: e1b6a64 ($5 in chips)
Seat 4: ad670634 ($10.45 in chips)
Seat 5: d23220ed ($2.13 in chips)
Seat 6: Hero ($3.49 in chips)
f17a1c15: posts small blind $0.02
e1b6a64: posts big blind $0.05
*** HOLE CARDS ***
Dealt to 8b602c49 
Dealt to f17a1c15 
Dealt to e1b6a64 
Dealt to ad670634 
Dealt to d23220ed 
Dealt to Hero [4c 7h]
ad670634: folds
d23220ed: folds
Hero: folds
8b602c49: folds
f17a1c15: raises $0.08 to $0.13
e1b6a64: calls $0.08
*** FLOP *** [Ah Kh As]
f17a1c15: checks
e1b6a64: bets $0.08
f17a1c15: raises $0.08 to $0.16
e1b6a64: folds
Uncalled bet ($0.08) returned to f17a1c15
*** SHOWDOWN ***
f17a1c15 collected $0.4 from pot
*** SUMMARY ***
Total pot $0.42 | Rake $0.02 | Jackpot $0 | Bingo $0 | Fortune $0 | Tax $0
Board [Ah Kh As]
Seat 1: 8b602c49 (button) folded before Flop (didn't bet)
Seat 2: f17a1c15 (small blind) won ($0.4)
Seat 3: e1b6a64 (big blind) folded on the Flop
Seat 4: ad670634 folded before Flop (didn't bet)
Seat 5: d23220ed folded before Flop (didn't bet)
Seat 6: Hero folded before Flop (didn't bet)


Poker Hand #RC3795359892: Hold'em No Limit ($0.02/$0.05) - 2025/08/10 02:00:57
Table 'RushAndCash10955152' 6-max Seat #1 is the button
Seat 1: 17111202 ($7 in chips)
Seat 2: fd11db74 ($9.2 in chips)
Seat 3: 8d1f433e ($6.38 in chips)
Seat 4: Hero ($3.49 in chips)
Seat 5: 4780776f ($8.82 in chips)
Seat 6: 21ce60f7 ($5 in chips)
fd11db74: posts small blind $0.02
8d1f433e: posts big blind $0.05
*** HOLE CARDS ***
Dealt to 17111202 
Dealt to fd11db74 
Dealt to 8d1f433e 
Dealt to Hero [2h Ad]
Dealt to 4780776f 
Dealt to 21ce60f7 
Hero: folds
4780776f: folds
21ce60f7: raises $0.08 to $0.13
17111202: raises $0.27 to $0.4
fd11db74: folds
8d1f433e: folds
21ce60f7: folds
Uncalled bet ($0.27) returned to 17111202
*** SHOWDOWN ***
17111202 collected $0.32 from pot
*** SUMMARY ***
Total pot $0.33 | Rake $0.01 | Jackpot $0 | Bingo $0 | Fortune $0 | Tax $0
Seat 1: 17111202 (button) collected ($0.32)
Seat 2: fd11db74 (small blind) folded before Flop
Seat 3: 8d1f433e (big blind) folded before Flop
Seat 4: Hero folded before Flop (didn't bet)
Seat 5: 4780776f folded before Flop (didn't bet)
Seat 6: 21ce60f7 folded before Flop


Poker Hand #RC3795359874: Hold'em No Limit ($0.02/$0.05) - 2025/08/10 02:00:53
Table 'RushAndCash10955134' 6-max Seat #1 is the button
Seat 1: b37a864b ($8.98 in chips)
Seat 2: e4ed5218 ($7.18 in chips)
Seat 3: 492edabf ($4.3 in chips)
Seat 4: Hero ($3.49 in chips)
Seat 5: e0461ef9 ($5.07 in chips)
Seat 6: 12d4819b ($5.59 in chips)
e4ed5218: posts small blind $0.02
492edabf: posts big blind $0.05
*** HOLE CARDS ***
Dealt to b37a864b 
Dealt to e4ed5218 
Dealt to 492edabf 
Dealt to Hero [7h Kd]
Dealt to e0461ef9 
Dealt to 12d4819b 
Hero: folds
e0461ef9: folds
12d4819b: raises $0.05 to $0.1
b37a864b: folds
e4ed5218: folds
492edabf: folds
Uncalled bet ($0.05) returned to 12d4819b
*** SHOWDOWN ***
12d4819b collected $0.12 from pot
*** SUMMARY ***
Total pot $0.12 | Rake $0 | Jackpot $0 | Bingo $0 | Fortune $0 | Tax $0
Seat 1: b37a864b (button) folded before Flop (didn't bet)
Seat 2: e4ed5218 (small blind) folded before Flop
Seat 3: 492edabf (big blind) folded before Flop
Seat 4: Hero folded before Flop (didn't bet)
Seat 5: e0461ef9 folded before Flop (didn't bet)
Seat 6: 12d4819b collected ($0.12)


Poker Hand #RC3795359556: Hold'em No Limit ($0.02/$0.05) - 2025/08/10 01:59:56
Table 'RushAndCash10954816' 6-max Seat #1 is the button
Seat 1: a65f2dcc ($5.09 in chips)
Seat 2: Hero ($3.61 in chips)
Seat 3: bfe8a9c2 ($6.73 in chips)
Seat 4: 65272089 ($5.43 in chips)
Seat 5: c49c46e6 ($8.46 in chips)
Seat 6: 7053fe31 ($11.02 in chips)
Hero: posts small blind $0.02
bfe8a9c2: posts big blind $0.05
*** HOLE CARDS ***
Dealt to a65f2dcc 
Dealt to Hero [9h Kh]
Dealt to bfe8a9c2 
Dealt to 65272089 
Dealt to c49c46e6 
Dealt to 7053fe31 
65272089: folds
c49c46e6: folds
7053fe31: folds
a65f2dcc: raises $0.07 to $0.12
Hero: calls $0.1
bfe8a9c2: folds
*** FLOP *** [Qs 4c Ac]
Hero: checks
a65f2dcc: bets $0.07
Hero: folds
Uncalled bet ($0.07) returned to a65f2dcc
*** SHOWDOWN ***
a65f2dcc collected $0.28 from pot
*** SUMMARY ***
Total pot $0.29 | Rake $0.01 | Jackpot $0 | Bingo $0 | Fortune $0 | Tax $0
Board [Qs 4c Ac]
Seat 1: a65f2dcc (button) won ($0.28)
Seat 2: Hero (small blind) folded on the Flop
Seat 3: bfe8a9c2 (big blind) folded before Flop
Seat 4: 65272089 folded before Flop (didn't bet)
Seat 5: c49c46e6 folded before Flop (didn't bet)
Seat 6: 7053fe31 folded before Flop (didn't bet)


Poker Hand #RC3795359471: Hold'em No Limit ($0.02/$0.05) - 2025/08/10 01:59:40
Table 'RushAndCash10954731' 6-max Seat #1 is the button
Seat 1: ac2fe91f ($5 in chips)
Seat 2: 94c5fa01 ($5.27 in chips)
Seat 3: Hero ($3.66 in chips)
Seat 4: 6d5c1f77 ($15.72 in chips)
Seat 5: f871ac56 ($3.4 in chips)
Seat 6: cc20b970 ($5.77 in chips)
94c5fa01: posts small blind $0.02
Hero: posts big blind $0.05
*** HOLE CARDS ***
Dealt to ac2fe91f 
Dealt to 94c5fa01 
Dealt to Hero [3c 9h]
Dealt to 6d5c1f77 
Dealt to f871ac56 
Dealt to cc20b970 
6d5c1f77: raises $0.08 to $0.13
f871ac56: folds
cc20b970: calls $0.13
ac2fe91f: calls $0.13
94c5fa01: folds
Hero: folds
*** FLOP *** [3s 2d 7d]
6d5c1f77: bets $0.28
cc20b970: folds
ac2fe91f: folds
Uncalled bet ($0.28) returned to 6d5c1f77
*** SHOWDOWN ***
6d5c1f77 collected $0.44 from pot
*** SUMMARY ***
Total pot $0.46 | Rake $0.02 | Jackpot $0 | Bingo $0 | Fortune $0 | Tax $0
Board [3s 2d 7d]
Seat 1: ac2fe91f (button) folded on the Flop
Seat 2: 94c5fa01 (small blind) folded before Flop
Seat 3: Hero (big blind) folded before Flop
Seat 4: 6d5c1f77 won ($0.44)
Seat 5: f871ac56 folded before Flop (didn't bet)
Seat 6: cc20b970 folded on the Flop


Poker Hand #RC3795359448: Hold'em No Limit ($0.02/$0.05) - 2025/08/10 01:59:37
Table 'RushAndCash10954708' 6-max Seat #1 is the button
Seat 1: Hero ($3.66 in chips)
Seat 2: 8088c6e8 ($4.09 in chips)
Seat 3: 570b3a56 ($4.56 in chips)
Seat 4: 927b1d08 ($5 in chips)
Seat 5: 13f80275 ($5.14 in chips)
Seat 6: 42cf61ea ($6.21 in chips)
8088c6e8: posts small blind $0.02
570b3a56: posts big blind $0.05
*** HOLE CARDS ***
Dealt to Hero [Jd 3s]
Dealt to 8088c6e8 
Dealt to 570b3a56 
Dealt to 927b1d08 
Dealt to 13f80275 
Dealt to 42cf61ea 
927b1d08: folds
13f80275: folds
42cf61ea: folds
Hero: folds
8088c6e8: folds
Uncalled bet ($0.03) returned to 570b3a56
*** SHOWDOWN ***
570b3a56 collected $0.04 from pot
*** SUMMARY ***
Total pot $0.04 | Rake $0 | Jackpot $0 | Bingo $0 | Fortune $0 | Tax $0
Seat 1: Hero (button) folded before Flop (didn't bet)
Seat 2: 8088c6e8 (small blind) folded before Flop
Seat 3: 570b3a56 (big blind) collected ($0.04)
Seat 4: 927b1d08 folded before Flop (didn't bet)
Seat 5: 13f80275 folded before Flop (didn't bet)
Seat 6: 42cf61ea folded before Flop (didn't bet)


Poker Hand #RC3795359426: Hold'em No Limit ($0.02/$0.05) - 2025/08/10 01:59:33
Table 'RushAndCash10954686' 6-max Seat #1 is the button
Seat 1: fe16dbf2 ($5.02 in chips)
Seat 2: 379fa602 ($4.19 in chips)
Seat 3: 8d9adfc0 ($5 in chips)
Seat 4: Hero ($3.66 in chips)
Seat 5: daeab3be ($5 in chips)
Seat 6: aa3dbb59 ($4.93 in chips)
379fa602: posts small blind $0.02
8d9adfc0: posts big blind $0.05
*** HOLE CARDS ***
Dealt to fe16dbf2 
Dealt to 379fa602 
Dealt to 8d9adfc0 
Dealt to Hero [6s 2h]
Dealt to daeab3be 
Dealt to aa3dbb59 
Hero: folds
daeab3be: folds
aa3dbb59: raises $0.12 to $0.17
fe16dbf2: folds
379fa602: folds
8d9adfc0: calls $0.12
*** FLOP *** [Th 5s Jh]
8d9adfc0: bets $0.18
aa3dbb59: raises $0.72 to $0.9
8d9adfc0: calls $0.72
*** TURN *** [Th 5s Jh] [5h]
8d9adfc0: checks
aa3dbb59: bets $2.16
8d9adfc0: folds
Uncalled bet ($2.16) returned to aa3dbb59
*** SHOWDOWN ***
aa3dbb59 collected $1.99 from pot
*** SUMMARY ***
Total pot $2.16 | Rake $0.1 | Jackpot $0.07 | Bingo $0 | Fortune $0 | Tax $0
Board [Th 5s Jh 5h]
Seat 1: fe16dbf2 (button) folded before Flop (didn't bet)
Seat 2: 379fa602 (small blind) folded before Flop
Seat 3: 8d9adfc0 (big blind) folded on the Turn
Seat 4: Hero folded before Flop (didn't bet)
Seat 5: daeab3be folded before Flop (didn't bet)
Seat 6: aa3dbb59 won ($1.99)


Poker Hand #RC3795359207: Hold'em No Limit ($0.02/$0.05) - 2025/08/10 01:58:56
Table 'RushAndCash10954467' 6-max Seat #1 is the button
Seat 1: 69e23229 ($4.85 in chips)
Seat 2: f0eb6393 ($11.03 in chips)
Seat 3: 379fa602 ($4.31 in chips)
Seat 4: 39442e30 ($5.16 in chips)
Seat 5: 94c5fa01 ($5.39 in chips)
Seat 6: Hero ($3.53 in chips)
f0eb6393: posts small blind $0.02
379fa602: posts big blind $0.05
*** HOLE CARDS ***
Dealt to 69e23229 
Dealt to f0eb6393 
Dealt to 379fa602 
Dealt to 39442e30 
Dealt to 94c5fa01 
Dealt to Hero [Kh Ks]
39442e30: folds
94c5fa01: folds
Hero: raises $0.07 to $0.12
69e23229: folds
f0eb6393: folds
379fa602: calls $0.07
*** FLOP *** [6s 8h 2d]
379fa602: checks
Hero: checks
*** TURN *** [6s 8h 2d] [5c]
379fa602: checks
Hero: bets $0.21
379fa602: folds
Uncalled bet ($0.21) returned to Hero
*** SHOWDOWN ***
Hero collected $0.25 from pot
*** SUMMARY ***
Total pot $0.26 | Rake $0.01 | Jackpot $0 | Bingo $0 | Fortune $0 | Tax $0
Board [6s 8h 2d 5c]
Seat 1: 69e23229 (button) folded before Flop (didn't bet)
Seat 2: f0eb6393 (small blind) folded before Flop
Seat 3: 379fa602 (big blind) folded on the Turn
Seat 4: 39442e30 folded before Flop (didn't bet)
Seat 5: 94c5fa01 folded before Flop (didn't bet)
Seat 6: Hero won ($0.25)


Poker Hand #RC3795359185: Hold'em No Limit ($0.02/$0.05) - 2025/08/10 01:58:52
Table 'RushAndCash10954445' 6-max Seat #1 is the button
Seat 1: 6203897c ($5 in chips)
Seat 2: 314a342c ($15.8 in chips)
Seat 3: 4780776f ($9.22 in chips)
Seat 4: 69e23229 ($4.85 in chips)
Seat 5: Hero ($3.53 in chips)
Seat 6: a65f2dcc ($5.04 in chips)
314a342c: posts small blind $0.02
4780776f: posts big blind $0.05
*** HOLE CARDS ***
Dealt to 6203897c 
Dealt to 314a342c 
Dealt to 4780776f 
Dealt to 69e23229 
Dealt to Hero [8d 6c]
Dealt to a65f2dcc 
69e23229: folds
Hero: folds
a65f2dcc: raises $0.07 to $0.12
6203897c: raises $0.31 to $0.43
314a342c: folds
4780776f: folds
a65f2dcc: folds
Uncalled bet ($0.31) returned to 6203897c
*** SHOWDOWN ***
6203897c collected $0.3 from pot
*** SUMMARY ***
Total pot $0.31 | Rake $0.01 | Jackpot $0 | Bingo $0 | Fortune $0 | Tax $0
Seat 1: 6203897c (button) collected ($0.3)
Seat 2: 314a342c (small blind) folded before Flop
Seat 3: 4780776f (big blind) folded before Flop
Seat 4: 69e23229 folded before Flop (didn't bet)
Seat 5: Hero folded before Flop (didn't bet)
Seat 6: a65f2dcc folded before Flop


Poker Hand #RC3795359035: Hold'em No Limit ($0.02/$0.05) - 2025/08/10 01:58:25
Table 'RushAndCash10954295' 6-max Seat #1 is the button
Seat 1: 4780776f ($9.34 in chips)
Seat 2: Hero ($3.37 in chips)
Seat 3: b2591c47 ($5.07 in chips)
Seat 4: e386de17 ($6.74 in chips)
Seat 5: 9642cc26 ($12.48 in chips)
Seat 6: 7656ad46 ($7.38 in chips)
Hero: posts small blind $0.02
b2591c47: posts big blind $0.05
*** HOLE CARDS ***
Dealt to 4780776f 
Dealt to Hero [As Ks]
Dealt to b2591c47 
Dealt to e386de17 
Dealt to 9642cc26 
Dealt to 7656ad46 
e386de17: folds
9642cc26: folds
7656ad46: folds
4780776f: raises $0.07 to $0.12
Hero: raises $0.28 to $0.4
b2591c47: folds
4780776f: folds
Uncalled bet ($0.28) returned to Hero
*** SHOWDOWN ***
Hero collected $0.28 from pot
*** SUMMARY ***
Total pot $0.29 | Rake $0.01 | Jackpot $0 | Bingo $0 | Fortune $0 | Tax $0
Seat 1: 4780776f (button) folded before Flop
Seat 2: Hero (small blind) collected ($0.28)
Seat 3: b2591c47 (big blind) folded before Flop
Seat 4: e386de17 folded before Flop (didn't bet)
Seat 5: 9642cc26 folded before Flop (didn't bet)
Seat 6: 7656ad46 folded before Flop (didn't bet)


Poker Hand #RC3795358976: Hold'em No Limit ($0.02/$0.05) - 2025/08/10 01:58:15
Table 'RushAndCash10954236' 6-max Seat #1 is the button
Seat 1: f95d2fb8 ($5.82 in chips)
Seat 2: efb11525 ($5.02 in chips)
Seat 3: Hero ($3.35 in chips)
Seat 4: 125e0487 ($5.12 in chips)
Seat 5: ee87ee96 ($16.95 in chips)
Seat 6: ac2fe91f ($5.07 in chips)
efb11525: posts small blind $0.02
Hero: posts big blind $0.05
*** HOLE CARDS ***
Dealt to f95d2fb8 
Dealt to efb11525 
Dealt to Hero [6c Jc]
Dealt to 125e0487 
Dealt to ee87ee96 
Dealt to ac2fe91f 
125e0487: folds
ee87ee96: folds
ac2fe91f: folds
f95d2fb8: folds
efb11525: folds
Uncalled bet ($0.03) returned to Hero
*** SHOWDOWN ***
Hero collected $0.04 from pot
*** SUMMARY ***
Total pot $0.04 | Rake $0 | Jackpot $0 | Bingo $0 | Fortune $0 | Tax $0
Seat 1: f95d2fb8 (button) folded before Flop (didn't bet)
Seat 2: efb11525 (small blind) folded before Flop
Seat 3: Hero (big blind) collected ($0.04)
Seat 4: 125e0487 folded before Flop (didn't bet)
Seat 5: ee87ee96 folded before Flop (didn't bet)
Seat 6: ac2fe91f folded before Flop (didn't bet)


Poker Hand #RC3795358748: Hold'em No Limit ($0.02/$0.05) - 2025/08/10 01:57:36
Table 'RushAndCash10954008' 6-max Seat #1 is the button
Seat 1: Hero ($3.57 in chips)
Seat 2: b311f36c ($6.87 in chips)
Seat 3: 8143fd2b ($2.07 in chips)
Seat 4: 2d81f74b ($11.85 in chips)
Seat 5: 9d73b62a ($5 in chips)
Seat 6: 679c5ea0 ($12.15 in chips)
b311f36c: posts small blind $0.02
8143fd2b: posts big blind $0.05
*** HOLE CARDS ***
Dealt to Hero [5h 5c]
Dealt to b311f36c 
Dealt to 8143fd2b 
Dealt to 2d81f74b 
Dealt to 9d73b62a 
Dealt to 679c5ea0 
2d81f74b: folds
9d73b62a: folds
679c5ea0: folds
Hero: raises $0.05 to $0.1
b311f36c: calls $0.08
8143fd2b: folds
*** FLOP *** [As Qs 8h]
b311f36c: checks
Hero: bets $0.12
b311f36c: raises $0.23 to $0.35
Hero: folds
Uncalled bet ($0.23) returned to b311f36c
*** SHOWDOWN ***
b311f36c collected $0.47 from pot
*** SUMMARY ***
Total pot $0.49 | Rake $0.02 | Jackpot $0 | Bingo $0 | Fortune $0 | Tax $0
Board [As Qs 8h]
Seat 1: Hero (button) folded on the Flop
Seat 2: b311f36c (small blind) won ($0.47)
Seat 3: 8143fd2b (big blind) folded before Flop
Seat 4: 2d81f74b folded before Flop (didn't bet)
Seat 5: 9d73b62a folded before Flop (didn't bet)
Seat 6: 679c5ea0 folded before Flop (didn't bet)


Poker Hand #RC3795358720: Hold'em No Limit ($0.02/$0.05) - 2025/08/10 01:57:32
Table 'RushAndCash10953980' 6-max Seat #1 is the button
Seat 1: 82a34580 ($6.61 in chips)
Seat 2: 9c1d6952 ($2.56 in chips)
Seat 3: d8ee5171 ($6.84 in chips)
Seat 4: 2732db68 ($3.33 in chips)
Seat 5: Hero ($3.57 in chips)
Seat 6: d7f7b374 ($6.77 in chips)
9c1d6952: posts small blind $0.02
d8ee5171: posts big blind $0.05
*** HOLE CARDS ***
Dealt to 82a34580 
Dealt to 9c1d6952 
Dealt to d8ee5171 
Dealt to 2732db68 
Dealt to Hero [Jd 2h]
Dealt to d7f7b374 
2732db68: folds
Hero: folds
d7f7b374: folds
82a34580: raises $0.07 to $0.12
9c1d6952: folds
d8ee5171: folds
Uncalled bet ($0.07) returned to 82a34580
*** SHOWDOWN ***
82a34580 collected $0.12 from pot
*** SUMMARY ***
Total pot $0.12 | Rake $0 | Jackpot $0 | Bingo $0 | Fortune $0 | Tax $0
Seat 1: 82a34580 (button) collected ($0.12)
Seat 2: 9c1d6952 (small blind) folded before Flop
Seat 3: d8ee5171 (big blind) folded before Flop
Seat 4: 2732db68 folded before Flop (didn't bet)
Seat 5: Hero folded before Flop (didn't bet)
Seat 6: d7f7b374 folded before Flop (didn't bet)


Poker Hand #RC3795358696: Hold'em No Limit ($0.02/$0.05) - 2025/08/10 01:57:28
Table 'RushAndCash10953956' 6-max Seat #1 is the button
Seat 1: 86c0d0eb ($5.33 in chips)
Seat 2: 87e502f1 ($5.31 in chips)
Seat 3: a52639d2 ($9.91 in chips)
Seat 4: Hero ($3.57 in chips)
Seat 5: 2b32692e ($7.46 in chips)
Seat 6: 980bd9db ($5.36 in chips)
87e502f1: posts small blind $0.02
a52639d2: posts big blind $0.05
*** HOLE CARDS ***
Dealt to 86c0d0eb 
Dealt to 87e502f1 
Dealt to a52639d2 
Dealt to Hero [9h Qs]
Dealt to 2b32692e 
Dealt to 980bd9db 
Hero: folds
2b32692e: folds
980bd9db: calls $0.05
86c0d0eb: folds
87e502f1: folds
a52639d2: checks
*** FLOP *** [2c 5c 4h]
a52639d2: checks
980bd9db: bets $0.06
a52639d2: folds
Uncalled bet ($0.06) returned to 980bd9db
*** SHOWDOWN ***
980bd9db collected $0.12 from pot
*** SUMMARY ***
Total pot $0.12 | Rake $0 | Jackpot $0 | Bingo $0 | Fortune $0 | Tax $0
Board [2c 5c 4h]
Seat 1: 86c0d0eb (button) folded before Flop (didn't bet)
Seat 2: 87e502f1 (small blind) folded before Flop
Seat 3: a52639d2 (big blind) folded on the Flop
Seat 4: Hero folded before Flop (didn't bet)
Seat 5: 2b32692e folded before Flop (didn't bet)
Seat 6: 980bd9db won ($0.12)


Poker Hand #RC3795358607: Hold'em No Limit ($0.02/$0.05) - 2025/08/10 01:57:14
Table 'RushAndCash10953867' 6-max Seat #1 is the button
Seat 1: Hero ($3.57 in chips)
Seat 2: 8eb4f6f7 ($5.04 in chips)
Seat 3: 885055bb ($8.59 in chips)
Seat 4: 4780776f ($9.41 in chips)
Seat 5: dd0df2bb ($5.13 in chips)
Seat 6: 8d9adfc0 ($5.4 in chips)
8eb4f6f7: posts small blind $0.02
885055bb: posts big blind $0.05
*** HOLE CARDS ***
Dealt to Hero [3s Th]
Dealt to 8eb4f6f7 
Dealt to 885055bb 
Dealt to 4780776f 
Dealt to dd0df2bb 
Dealt to 8d9adfc0 
4780776f: folds
dd0df2bb: folds
8d9adfc0: folds
Hero: folds
8eb4f6f7: raises $0.1 to $0.15
885055bb: folds
Uncalled bet ($0.1) returned to 8eb4f6f7
*** SHOWDOWN ***
8eb4f6f7 collected $0.1 from pot
*** SUMMARY ***
Total pot $0.1 | Rake $0 | Jackpot $0 | Bingo $0 | Fortune $0 | Tax $0
Seat 1: Hero (button) folded before Flop (didn't bet)
Seat 2: 8eb4f6f7 (small blind) collected ($0.1)
Seat 3: 885055bb (big blind) folded before Flop
Seat 4: 4780776f folded before Flop (didn't bet)
Seat 5: dd0df2bb folded before Flop (didn't bet)
Seat 6: 8d9adfc0 folded before Flop (didn't bet)


Poker Hand #RC3795358557: Hold'em No Limit ($0.02/$0.05) - 2025/08/10 01:57:06
Table 'RushAndCash10953817' 6-max Seat #1 is the button
Seat 1: 8af153cf ($9.29 in chips)
Seat 2: Hero ($3.59 in chips)
Seat 3: c4e2527e ($6.42 in chips)
Seat 4: 264b0521 ($21.88 in chips)
Seat 5: 379fa602 ($4.93 in chips)
Seat 6: daeab3be ($5.07 in chips)
Hero: posts small blind $0.02
c4e2527e: posts big blind $0.05
*** HOLE CARDS ***
Dealt to 8af153cf 
Dealt to Hero [8s 9d]
Dealt to c4e2527e 
Dealt to 264b0521 
Dealt to 379fa602 
Dealt to daeab3be 
264b0521: folds
379fa602: folds
daeab3be: folds
8af153cf: raises $0.08 to $0.13
Hero: folds
c4e2527e: folds
Uncalled bet ($0.08) returned to 8af153cf
*** SHOWDOWN ***
8af153cf collected $0.12 from pot
*** SUMMARY ***
Total pot $0.12 | Rake $0 | Jackpot $0 | Bingo $0 | Fortune $0 | Tax $0
Seat 1: 8af153cf (button) collected ($0.12)
Seat 2: Hero (small blind) folded before Flop
Seat 3: c4e2527e (big blind) folded before Flop
Seat 4: 264b0521 folded before Flop (didn't bet)
Seat 5: 379fa602 folded before Flop (didn't bet)
Seat 6: daeab3be folded before Flop (didn't bet)


Poker Hand #RC3795358469: Hold'em No Limit ($0.02/$0.05) - 2025/08/10 01:56:51
Table 'RushAndCash10953729' 6-max Seat #1 is the button
Seat 1: 383bb86f ($5.83 in chips)
Seat 2: 3486f641 ($5 in chips)
Seat 3: Hero ($3.64 in chips)
Seat 4: 3b42ac71 ($5.79 in chips)
Seat 5: acc100c6 ($5.7 in chips)
Seat 6: 85e8b1ca ($7.78 in chips)
3486f641: posts small blind $0.02
Hero: posts big blind $0.05
*** HOLE CARDS ***
Dealt to 383bb86f 
Dealt to 3486f641 
Dealt to Hero [8s Qd]
Dealt to 3b42ac71 
Dealt to acc100c6 
Dealt to 85e8b1ca 
3b42ac71: raises $0.05 to $0.1
acc100c6: folds
85e8b1ca: folds
383bb86f: folds
3486f641: folds
Hero: folds
Uncalled bet ($0.05) returned to 3b42ac71
*** SHOWDOWN ***
3b42ac71 collected $0.12 from pot
*** SUMMARY ***
Total pot $0.12 | Rake $0 | Jackpot $0 | Bingo $0 | Fortune $0 | Tax $0
Seat 1: 383bb86f (button) folded before Flop (didn't bet)
Seat 2: 3486f641 (small blind) folded before Flop
Seat 3: Hero (big blind) folded before Flop
Seat 4: 3b42ac71 collected ($0.12)
Seat 5: acc100c6 folded before Flop (didn't bet)
Seat 6: 85e8b1ca folded before Flop (didn't bet)


Poker Hand #RC3795358448: Hold'em No Limit ($0.02/$0.05) - 2025/08/10 01:56:47
Table 'RushAndCash10953708' 6-max Seat #1 is the button
Seat 1: 62b724e0 ($6.28 in chips)
Seat 2: 17550682 ($9.57 in chips)
Seat 3: 383bb86f ($5.88 in chips)
Seat 4: acc100c6 ($5.7 in chips)
Seat 5: 7d0aea7b ($2.9 in chips)
Seat 6: Hero ($3.64 in chips)
17550682: posts small blind $0.02
383bb86f: posts big blind $0.05
*** HOLE CARDS ***
Dealt to 62b724e0 
Dealt to 17550682 
Dealt to 383bb86f 
Dealt to acc100c6 
Dealt to 7d0aea7b 
Dealt to Hero [Js 9d]
acc100c6: folds
7d0aea7b: folds
Hero: folds
62b724e0: raises $0.1 to $0.15
17550682: raises $0.3 to $0.45
383bb86f: folds
62b724e0: raises $5.83 to $6.28 and is all-in
17550682: folds
Uncalled bet ($5.83) returned to 62b724e0
*** SHOWDOWN ***
62b724e0 collected $0.91 from pot
*** SUMMARY ***
Total pot $0.95 | Rake $0.04 | Jackpot $0 | Bingo $0 | Fortune $0 | Tax $0
Seat 1: 62b724e0 (button) collected ($0.91)
Seat 2: 17550682 (small blind) folded before Flop
Seat 3: 383bb86f (big blind) folded before Flop
Seat 4: acc100c6 folded before Flop (didn't bet)
Seat 5: 7d0aea7b folded before Flop (didn't bet)
Seat 6: Hero folded before Flop (didn't bet)


Poker Hand #RC3795358428: Hold'em No Limit ($0.02/$0.05) - 2025/08/10 01:56:44
Table 'RushAndCash10953688' 6-max Seat #1 is the button
Seat 1: e1a2449d ($8.98 in chips)
Seat 2: acc100c6 ($5.72 in chips)
Seat 3: 696a490 ($6.38 in chips)
Seat 4: Hero ($3.64 in chips)
Seat 5: 2a18a2d6 ($8.99 in chips)
Seat 6: 51270fe ($7.97 in chips)
acc100c6: posts small blind $0.02
696a490: posts big blind $0.05
*** HOLE CARDS ***
Dealt to e1a2449d 
Dealt to acc100c6 
Dealt to 696a490 
Dealt to Hero [8h 3s]
Dealt to 2a18a2d6 
Dealt to 51270fe 
Hero: folds
2a18a2d6: folds
51270fe: folds
e1a2449d: folds
acc100c6: folds
Uncalled bet ($0.03) returned to 696a490
*** SHOWDOWN ***
696a490 collected $0.04 from pot
*** SUMMARY ***
Total pot $0.04 | Rake $0 | Jackpot $0 | Bingo $0 | Fortune $0 | Tax $0
Seat 1: e1a2449d (button) folded before Flop (didn't bet)
Seat 2: acc100c6 (small blind) folded before Flop
Seat 3: 696a490 (big blind) collected ($0.04)
Seat 4: Hero folded before Flop (didn't bet)
Seat 5: 2a18a2d6 folded before Flop (didn't bet)
Seat 6: 51270fe folded before Flop (didn't bet)


Poker Hand #RC3795358408: Hold'em No Limit ($0.02/$0.05) - 2025/08/10 01:56:40
Table 'RushAndCash10953668' 6-max Seat #1 is the button
Seat 1: ee87ee96 ($16.37 in chips)
Seat 2: 9c1d6952 ($1.34 in chips)
Seat 3: 967e75a ($6.67 in chips)
Seat 4: 8423540 ($4.85 in chips)
Seat 5: Hero ($3.64 in chips)
Seat 6: 4919a3cb ($10.9 in chips)
9c1d6952: posts small blind $0.02
967e75a: posts big blind $0.05
*** HOLE CARDS ***
Dealt to ee87ee96 
Dealt to 9c1d6952 
Dealt to 967e75a 
Dealt to 8423540 
Dealt to Hero [7h 6d]
Dealt to 4919a3cb 
8423540: folds
Hero: folds
4919a3cb: folds
ee87ee96: raises $0.05 to $0.1
9c1d6952: folds
967e75a: calls $0.05
*** FLOP *** [As Kh Jh]
967e75a: checks
ee87ee96: bets $0.1
967e75a: calls $0.1
*** TURN *** [As Kh Jh] [8s]
967e75a: checks
ee87ee96: checks
*** RIVER *** [As Kh Jh 8s] [2c]
967e75a: bets $0.42
ee87ee96: calls $0.42
967e75a: shows [5h 3h] (Ace high)
ee87ee96: shows [5c Ad] (a pair of Aces)
*** SHOWDOWN ***
ee87ee96 collected $1.2 from pot
*** SUMMARY ***
Total pot $1.26 | Rake $0.06 | Jackpot $0 | Bingo $0 | Fortune $0 | Tax $0
Board [As Kh Jh 8s 2c]
Seat 1: ee87ee96 (button) showed [5c Ad] and won ($1.2) with a pair of Aces
Seat 2: 9c1d6952 (small blind) folded before Flop
Seat 3: 967e75a (big blind) showed [5h 3h] and lost with Ace high
Seat 4: 8423540 folded before Flop (didn't bet)
Seat 5: Hero folded before Flop (didn't bet)
Seat 6: 4919a3cb folded before Flop (didn't bet)


Poker Hand #RC3795358359: Hold'em No Limit ($0.02/$0.05) - 2025/08/10 01:56:31
Table 'RushAndCash10953619' 6-max Seat #1 is the button
Seat 1: Hero ($3.64 in chips)
Seat 2: db28d989 ($4.83 in chips)
Seat 3: 492edabf ($5 in chips)
Seat 4: b988df3 ($15.7 in chips)
Seat 5: 3c2f6868 ($7.67 in chips)
Seat 6: 97afc7b6 ($4.55 in chips)
db28d989: posts small blind $0.02
492edabf: posts big blind $0.05
*** HOLE CARDS ***
Dealt to Hero [6d Qh]
Dealt to db28d989 
Dealt to 492edabf 
Dealt to b988df3 
Dealt to 3c2f6868 
Dealt to 97afc7b6 
b988df3: raises $0.08 to $0.13
3c2f6868: folds
97afc7b6: folds
Hero: folds
db28d989: folds
492edabf: folds
Uncalled bet ($0.08) returned to b988df3
*** SHOWDOWN ***
b988df3 collected $0.12 from pot
*** SUMMARY ***
Total pot $0.12 | Rake $0 | Jackpot $0 | Bingo $0 | Fortune $0 | Tax $0
Seat 1: Hero (button) folded before Flop (didn't bet)
Seat 2: db28d989 (small blind) folded before Flop
Seat 3: 492edabf (big blind) folded before Flop
Seat 4: b988df3 collected ($0.12)
Seat 5: 3c2f6868 folded before Flop (didn't bet)
Seat 6: 97afc7b6 folded before Flop (didn't bet)


Poker Hand #RC3795358269: Hold'em No Limit ($0.02/$0.05) - 2025/08/10 01:56:15
Table 'RushAndCash10953529' 6-max Seat #1 is the button
Seat 1: acc100c6 ($5.55 in chips)
Seat 2: Hero ($3.66 in chips)
Seat 3: ae33334 ($4 in chips)
Seat 4: ffb0dd00 ($5.14 in chips)
Seat 5: 9487a697 ($5.3 in chips)
Seat 6: 50881796 ($6.15 in chips)
Hero: posts small blind $0.02
ae33334: posts big blind $0.05
*** HOLE CARDS ***
Dealt to acc100c6 
Dealt to Hero [3d 3h]
Dealt to ae33334 
Dealt to ffb0dd00 
Dealt to 9487a697 
Dealt to 50881796 
ffb0dd00: folds
9487a697: raises $0.06 to $0.11
50881796: folds
acc100c6: raises $0.33 to $0.44
Hero: folds
ae33334: folds
9487a697: folds
Uncalled bet ($0.33) returned to acc100c6
*** SHOWDOWN ***
acc100c6 collected $0.28 from pot
*** SUMMARY ***
Total pot $0.29 | Rake $0.01 | Jackpot $0 | Bingo $0 | Fortune $0 | Tax $0
Seat 1: acc100c6 (button) collected ($0.28)
Seat 2: Hero (small blind) folded before Flop
Seat 3: ae33334 (big blind) folded before Flop
Seat 4: ffb0dd00 folded before Flop (didn't bet)
Seat 5: 9487a697 folded before Flop
Seat 6: 50881796 folded before Flop (didn't bet)


Poker Hand #RC3795358245: Hold'em No Limit ($0.02/$0.05) - 2025/08/10 01:56:10
Table 'RushAndCash10953505' 6-max Seat #1 is the button
Seat 1: fc2e7133 ($19.75 in chips)
Seat 2: cc57fc1c ($12 in chips)
Seat 3: Hero ($3.71 in chips)
Seat 4: c251cc1b ($3.04 in chips)
Seat 5: 69eb63dd ($5 in chips)
Seat 6: a731f2b4 ($4.83 in chips)
cc57fc1c: posts small blind $0.02
Hero: posts big blind $0.05
*** HOLE CARDS ***
Dealt to fc2e7133 
Dealt to cc57fc1c 
Dealt to Hero [9s Kh]
Dealt to c251cc1b 
Dealt to 69eb63dd 
Dealt to a731f2b4 
c251cc1b: folds
69eb63dd: folds
a731f2b4: folds
fc2e7133: raises $0.1 to $0.15
cc57fc1c: folds
Hero: folds
Uncalled bet ($0.1) returned to fc2e7133
*** SHOWDOWN ***
fc2e7133 collected $0.12 from pot
*** SUMMARY ***
Total pot $0.12 | Rake $0 | Jackpot $0 | Bingo $0 | Fortune $0 | Tax $0
Seat 1: fc2e7133 (button) collected ($0.12)
Seat 2: cc57fc1c (small blind) folded before Flop
Seat 3: Hero (big blind) folded before Flop
Seat 4: c251cc1b folded before Flop (didn't bet)
Seat 5: 69eb63dd folded before Flop (didn't bet)
Seat 6: a731f2b4 folded before Flop (didn't bet)


Poker Hand #RC3795358225: Hold'em No Limit ($0.02/$0.05) - 2025/08/10 01:56:06
Table 'RushAndCash10953485' 6-max Seat #1 is the button
Seat 1: 17111202 ($5 in chips)
Seat 2: 84a6e006 ($14.62 in chips)
Seat 3: 3e1e935d ($5.09 in chips)
Seat 4: c37b07e3 ($5 in chips)
Seat 5: Hero ($3.71 in chips)
Seat 6: d54ccd5d ($7.18 in chips)
84a6e006: posts small blind $0.02
3e1e935d: posts big blind $0.05
*** HOLE CARDS ***
Dealt to 17111202 
Dealt to 84a6e006 
Dealt to 3e1e935d 
Dealt to c37b07e3 
Dealt to Hero [5s 6d]
Dealt to d54ccd5d 
c37b07e3: folds
Hero: folds
d54ccd5d: folds
17111202: raises $0.08 to $0.13
84a6e006: folds
3e1e935d: folds
Uncalled bet ($0.08) returned to 17111202
*** SHOWDOWN ***
17111202 collected $0.12 from pot
*** SUMMARY ***
Total pot $0.12 | Rake $0 | Jackpot $0 | Bingo $0 | Fortune $0 | Tax $0
Seat 1: 17111202 (button) collected ($0.12)
Seat 2: 84a6e006 (small blind) folded before Flop
Seat 3: 3e1e935d (big blind) folded before Flop
Seat 4: c37b07e3 folded before Flop (didn't bet)
Seat 5: Hero folded before Flop (didn't bet)
Seat 6: d54ccd5d folded before Flop (didn't bet)


Poker Hand #RC3795358205: Hold'em No Limit ($0.02/$0.05) - 2025/08/10 01:56:03
Table 'RushAndCash10953465' 6-max Seat #1 is the button
Seat 1: 456c346f ($4.88 in chips)
Seat 2: f786a78a ($4.78 in chips)
Seat 3: 9c1d6952 ($1.44 in chips)
Seat 4: Hero ($3.71 in chips)
Seat 5: 264b0521 ($21.84 in chips)
Seat 6: 65272089 ($5.64 in chips)
f786a78a: posts small blind $0.02
9c1d6952: posts big blind $0.05
*** HOLE CARDS ***
Dealt to 456c346f 
Dealt to f786a78a 
Dealt to 9c1d6952 
Dealt to Hero [4s Tc]
Dealt to 264b0521 
Dealt to 65272089 
Hero: folds
264b0521: folds
65272089: raises $0.05 to $0.1
456c346f: calls $0.1
f786a78a: folds
9c1d6952: calls $0.05
*** FLOP *** [3d 8d Qc]
9c1d6952: checks
65272089: checks
456c346f: bets $0.23
9c1d6952: folds
65272089: folds
Uncalled bet ($0.23) returned to 456c346f
*** SHOWDOWN ***
456c346f collected $0.31 from pot
*** SUMMARY ***
Total pot $0.32 | Rake $0.01 | Jackpot $0 | Bingo $0 | Fortune $0 | Tax $0
Board [3d 8d Qc]
Seat 1: 456c346f (button) won ($0.31)
Seat 2: f786a78a (small blind) folded before Flop
Seat 3: 9c1d6952 (big blind) folded on the Flop
Seat 4: Hero folded before Flop (didn't bet)
Seat 5: 264b0521 folded before Flop (didn't bet)
Seat 6: 65272089 folded on the Flop


Poker Hand #RC3795358080: Hold'em No Limit ($0.02/$0.05) - 2025/08/10 01:55:41
Table 'RushAndCash10953340' 6-max Seat #1 is the button
Seat 1: e145fcb0 ($5.48 in chips)
Seat 2: 946f0758 ($10.21 in chips)
Seat 3: 274e598f ($5.11 in chips)
Seat 4: dc451d90 ($1.73 in chips)
Seat 5: dbc63050 ($6.4 in chips)
Seat 6: Hero ($3.64 in chips)
946f0758: posts small blind $0.02
274e598f: posts big blind $0.05
*** HOLE CARDS ***
Dealt to e145fcb0 
Dealt to 946f0758 
Dealt to 274e598f 
Dealt to dc451d90 
Dealt to dbc63050 
Dealt to Hero [Jd Qd]
dc451d90: folds
dbc63050: folds
Hero: raises $0.05 to $0.1
e145fcb0: folds
946f0758: folds
274e598f: folds
Uncalled bet ($0.05) returned to Hero
*** SHOWDOWN ***
Hero collected $0.12 from pot
*** SUMMARY ***
Total pot $0.12 | Rake $0 | Jackpot $0 | Bingo $0 | Fortune $0 | Tax $0
Seat 1: e145fcb0 (button) folded before Flop (didn't bet)
Seat 2: 946f0758 (small blind) folded before Flop
Seat 3: 274e598f (big blind) folded before Flop
Seat 4: dc451d90 folded before Flop (didn't bet)
Seat 5: dbc63050 folded before Flop (didn't bet)
Seat 6: Hero collected ($0.12)


Poker Hand #RC3795358056: Hold'em No Limit ($0.02/$0.05) - 2025/08/10 01:55:37
Table 'RushAndCash10953316' 6-max Seat #1 is the button
Seat 1: aa804731 ($5.72 in chips)
Seat 2: 147b2fb5 ($10.55 in chips)
Seat 3: 3def62d1 ($5 in chips)
Seat 4: 42d519b7 ($7.14 in chips)
Seat 5: Hero ($3.64 in chips)
Seat 6: c4e2527e ($7.36 in chips)
147b2fb5: posts small blind $0.02
3def62d1: posts big blind $0.05
*** HOLE CARDS ***
Dealt to aa804731 
Dealt to 147b2fb5 
Dealt to 3def62d1 
Dealt to 42d519b7 
Dealt to Hero [4c Kc]
Dealt to c4e2527e 
42d519b7: raises $0.05 to $0.1
Hero: folds
c4e2527e: folds
aa804731: folds
147b2fb5: folds
3def62d1: calls $0.05
*** FLOP *** [Js 7s Ah]
3def62d1: checks
42d519b7: bets $0.08
3def62d1: calls $0.08
*** TURN *** [Js 7s Ah] [9s]
3def62d1: checks
42d519b7: checks
*** RIVER *** [Js 7s Ah 9s] [Ad]
3def62d1: bets $0.23
42d519b7: folds
Uncalled bet ($0.23) returned to 3def62d1
*** SHOWDOWN ***
3def62d1 collected $0.37 from pot
*** SUMMARY ***
Total pot $0.38 | Rake $0.01 | Jackpot $0 | Bingo $0 | Fortune $0 | Tax $0
Board [Js 7s Ah 9s Ad]
Seat 1: aa804731 (button) folded before Flop (didn't bet)
Seat 2: 147b2fb5 (small blind) folded before Flop
Seat 3: 3def62d1 (big blind) won ($0.37)
Seat 4: 42d519b7 folded on the River
Seat 5: Hero folded before Flop (didn't bet)
Seat 6: c4e2527e folded before Flop (didn't bet)


Poker Hand #RC3795357616: Hold'em No Limit ($0.02/$0.05) - 2025/08/10 01:54:18
Table 'RushAndCash10952876' 6-max Seat #1 is the button
Seat 1: Hero ($5 in chips)
Seat 2: 19662f7f ($5.06 in chips)
Seat 3: 8088c6e8 ($2 in chips)
Seat 4: 147b2fb5 ($9.32 in chips)
Seat 5: 1220101f ($10.38 in chips)
Seat 6: 9d73b62a ($5 in chips)
19662f7f: posts small blind $0.02
8088c6e8: posts big blind $0.05
*** HOLE CARDS ***
Dealt to Hero [8d 5d]
Dealt to 19662f7f 
Dealt to 8088c6e8 
Dealt to 147b2fb5 
Dealt to 1220101f 
Dealt to 9d73b62a 
147b2fb5: raises $0.1 to $0.15
1220101f: folds
9d73b62a: folds
Hero: calls $0.15
19662f7f: folds
8088c6e8: folds
*** FLOP *** [3d 5s 6h]
147b2fb5: bets $0.13
Hero: calls $0.13
*** TURN *** [3d 5s 6h] [2s]
147b2fb5: bets $0.38
Hero: calls $0.38
*** RIVER *** [3d 5s 6h 2s] [3s]
147b2fb5: bets $0.7
Hero: calls $0.7
147b2fb5: shows [8s As] (a flush Ace high)
Hero: shows [8d 5d] (two pair, Fives and Threes)
*** SHOWDOWN ***
147b2fb5 collected $2.59 from pot
*** SUMMARY ***
Total pot $2.79 | Rake $0.13 | Jackpot $0.07 | Bingo $0 | Fortune $0 | Tax $0
Board [3d 5s 6h 2s 3s]
Seat 1: Hero (button) showed [8d 5d] and lost with two pair, Fives and Threes
Seat 2: 19662f7f (small blind) folded before Flop
Seat 3: 8088c6e8 (big blind) folded before Flop
Seat 4: 147b2fb5 showed [8s As] and won ($2.59) with a flush Ace high
Seat 5: 1220101f folded before Flop (didn't bet)
Seat 6: 9d73b62a folded before Flop (didn't bet)


Poker Hand #RC3795357544: Hold'em No Limit ($0.02/$0.05) - 2025/08/10 01:54:06
Table 'RushAndCash10952804' 6-max Seat #1 is the button
Seat 1: 3c3c41c1 ($10.47 in chips)
Seat 2: Hero ($4.95 in chips)
Seat 3: 7ba30c43 ($5.62 in chips)
Seat 4: a82810b1 ($10.36 in chips)
Seat 5: dc451d90 ($1.97 in chips)
Seat 6: ccfb4953 ($6.3 in chips)
Hero: posts small blind $0.02
7ba30c43: posts big blind $0.05
*** HOLE CARDS ***
Dealt to 3c3c41c1 
Dealt to Hero [9c 8h]
Dealt to 7ba30c43 
Dealt to a82810b1 
Dealt to dc451d90 
Dealt to ccfb4953 
a82810b1: folds
dc451d90: raises $0.05 to $0.1
ccfb4953: folds
3c3c41c1: folds
Hero: folds
7ba30c43: folds
Uncalled bet ($0.05) returned to dc451d90
*** SHOWDOWN ***
dc451d90 collected $0.12 from pot
*** SUMMARY ***
Total pot $0.12 | Rake $0 | Jackpot $0 | Bingo $0 | Fortune $0 | Tax $0
Seat 1: 3c3c41c1 (button) folded before Flop (didn't bet)
Seat 2: Hero (small blind) folded before Flop
Seat 3: 7ba30c43 (big blind) folded before Flop
Seat 4: a82810b1 folded before Flop (didn't bet)
Seat 5: dc451d90 collected ($0.12)
Seat 6: ccfb4953 folded before Flop (didn't bet)


Poker Hand #RC3795357442: Hold'em No Limit ($0.02/$0.05) - 2025/08/10 01:53:49
Table 'RushAndCash10952702' 6-max Seat #1 is the button
Seat 1: 5b7eadf2 ($8.53 in chips)
Seat 2: 713b695f ($5.81 in chips)
Seat 3: Hero ($5 in chips)
Seat 4: 82a34580 ($7.49 in chips)
Seat 5: 455f6583 ($6.93 in chips)
Seat 6: 570b3a56 ($5.05 in chips)
713b695f: posts small blind $0.02
Hero: posts big blind $0.05
*** HOLE CARDS ***
Dealt to 5b7eadf2 
Dealt to 713b695f 
Dealt to Hero [Jd Th]
Dealt to 82a34580 
Dealt to 455f6583 
Dealt to 570b3a56 
82a34580: folds
455f6583: folds
570b3a56: folds
5b7eadf2: folds
713b695f: folds
Uncalled bet ($0.03) returned to Hero
*** SHOWDOWN ***
Hero collected $0.04 from pot
*** SUMMARY ***
Total pot $0.04 | Rake $0 | Jackpot $0 | Bingo $0 | Fortune $0 | Tax $0
Seat 1: 5b7eadf2 (button) folded before Flop (didn't bet)
Seat 2: 713b695f (small blind) folded before Flop
Seat 3: Hero (big blind) collected ($0.04)
Seat 4: 82a34580 folded before Flop (didn't bet)
Seat 5: 455f6583 folded before Flop (didn't bet)
Seat 6: 570b3a56 folded before Flop (didn't bet)


