Poker Hand #RC3795976759: Hold'em No Limit ($0.02/$0.05) - 2025/08/10 08:55:39
Table 'RushAndCash11072019' 6-max Seat #1 is the button
Seat 1: 62280863 ($8.6 in chips)
Seat 2: Hero ($5.69 in chips)
Seat 3: 662fd34 ($3.24 in chips)
Seat 4: 7165cda2 ($5.27 in chips)
Seat 5: 6d940edd ($8.64 in chips)
Seat 6: 69e805cf ($11.17 in chips)
Hero: posts small blind $0.02
662fd34: posts big blind $0.05
*** HOLE CARDS ***
Dealt to 62280863 
Dealt to Hero [Tc 5h]
Dealt to 662fd34 
Dealt to 7165cda2 
Dealt to 6d940edd 
Dealt to 69e805cf 
7165cda2: folds
6d940edd: folds
69e805cf: folds
62280863: folds
Hero: folds
Uncalled bet ($0.03) returned to 662fd34
*** SHOWDOWN ***
662fd34 collected $0.04 from pot
*** SUMMARY ***
Total pot $0.04 | Rake $0 | Jackpot $0 | Bingo $0 | Fortune $0 | Tax $0
Seat 1: 62280863 (button) folded before Flop (didn't bet)
Seat 2: Hero (small blind) folded before Flop
Seat 3: 662fd34 (big blind) collected ($0.04)
Seat 4: 7165cda2 folded before Flop (didn't bet)
Seat 5: 6d940edd folded before Flop (didn't bet)
Seat 6: 69e805cf folded before Flop (didn't bet)


Poker Hand #RC3795976566: Hold'em No Limit ($0.02/$0.05) - 2025/08/10 08:54:47
Table 'RushAndCash11071826' 6-max Seat #1 is the button
Seat 1: 7165cda2 ($5.27 in chips)
Seat 2: f0e15475 ($8.29 in chips)
Seat 3: Hero ($5.69 in chips)
Seat 4: a66cb400 ($6.26 in chips)
Seat 5: 39881702 ($6.09 in chips)
Seat 6: 15c880d8 ($5 in chips)
f0e15475: posts small blind $0.02
Hero: posts big blind $0.05
*** HOLE CARDS ***
Dealt to 7165cda2 
Dealt to f0e15475 
Dealt to Hero [9c Ac]
Dealt to a66cb400 
Dealt to 39881702 
Dealt to 15c880d8 
a66cb400: folds
39881702: folds
15c880d8: folds
7165cda2: raises $0.05 to $0.1
f0e15475: folds
Hero: calls $0.05
*** FLOP *** [Ad 3h 7s]
Hero: checks
7165cda2: checks
*** TURN *** [Ad 3h 7s] [Th]
Hero: bets $0.11
7165cda2: calls $0.11
*** RIVER *** [Ad 3h 7s Th] [7h]
Hero: checks
7165cda2: checks
Hero: shows [9c Ac] (two pair, Aces and Sevens)
7165cda2: shows [6c Ah] (two pair, Aces and Sevens)
*** SHOWDOWN ***
Hero collected $0.21 from pot
7165cda2 collected $0.21 from pot
*** SUMMARY ***
Total pot $0.44 | Rake $0.02 | Jackpot $0 | Bingo $0 | Fortune $0 | Tax $0
Board [Ad 3h 7s Th 7h]
Seat 1: 7165cda2 (button) showed [6c Ah] and won ($0.21) with two pair, Aces and Sevens
Seat 2: f0e15475 (small blind) folded before Flop
Seat 3: Hero (big blind) showed [9c Ac] and won ($0.21) with two pair, Aces and Sevens
Seat 4: a66cb400 folded before Flop (didn't bet)
Seat 5: 39881702 folded before Flop (didn't bet)
Seat 6: 15c880d8 folded before Flop (didn't bet)


Poker Hand #RC3795976554: Hold'em No Limit ($0.02/$0.05) - 2025/08/10 08:54:43
Table 'RushAndCash11071814' 6-max Seat #1 is the button
Seat 1: 6521a0bf ($4.69 in chips)
Seat 2: 8f2169c9 ($4.71 in chips)
Seat 3: 73e2fb85 ($5.14 in chips)
Seat 4: 97b1f31 ($7.04 in chips)
Seat 5: Hero ($5.69 in chips)
Seat 6: 7244fd77 ($5.62 in chips)
8f2169c9: posts small blind $0.02
73e2fb85: posts big blind $0.05
*** HOLE CARDS ***
Dealt to 6521a0bf 
Dealt to 8f2169c9 
Dealt to 73e2fb85 
Dealt to 97b1f31 
Dealt to Hero [8s Qh]
Dealt to 7244fd77 
97b1f31: folds
Hero: folds
7244fd77: folds
6521a0bf: folds
8f2169c9: folds
Uncalled bet ($0.03) returned to 73e2fb85
*** SHOWDOWN ***
73e2fb85 collected $0.04 from pot
*** SUMMARY ***
Total pot $0.04 | Rake $0 | Jackpot $0 | Bingo $0 | Fortune $0 | Tax $0
Seat 1: 6521a0bf (button) folded before Flop (didn't bet)
Seat 2: 8f2169c9 (small blind) folded before Flop
Seat 3: 73e2fb85 (big blind) collected ($0.04)
Seat 4: 97b1f31 folded before Flop (didn't bet)
Seat 5: Hero folded before Flop (didn't bet)
Seat 6: 7244fd77 folded before Flop (didn't bet)


Poker Hand #RC3795976537: Hold'em No Limit ($0.02/$0.05) - 2025/08/10 08:54:39
Table 'RushAndCash11071797' 6-max Seat #1 is the button
Seat 1: Hero ($5.69 in chips)
Seat 2: c6ab3de5 ($5 in chips)
Seat 3: d27c038b ($3.38 in chips)
Seat 4: 69bc96d4 ($8.07 in chips)
Seat 5: 67671ee6 ($6 in chips)
Seat 6: a361fe13 ($7.57 in chips)
c6ab3de5: posts small blind $0.02
d27c038b: posts big blind $0.05
*** HOLE CARDS ***
Dealt to Hero [9h 2c]
Dealt to c6ab3de5 
Dealt to d27c038b 
Dealt to 69bc96d4 
Dealt to 67671ee6 
Dealt to a361fe13 
69bc96d4: folds
67671ee6: folds
a361fe13: folds
Hero: folds
c6ab3de5: raises $0.1 to $0.15
d27c038b: folds
Uncalled bet ($0.1) returned to c6ab3de5
*** SHOWDOWN ***
c6ab3de5 collected $0.1 from pot
*** SUMMARY ***
Total pot $0.1 | Rake $0 | Jackpot $0 | Bingo $0 | Fortune $0 | Tax $0
Seat 1: Hero (button) folded before Flop (didn't bet)
Seat 2: c6ab3de5 (small blind) collected ($0.1)
Seat 3: d27c038b (big blind) folded before Flop
Seat 4: 69bc96d4 folded before Flop (didn't bet)
Seat 5: 67671ee6 folded before Flop (didn't bet)
Seat 6: a361fe13 folded before Flop (didn't bet)


Poker Hand #RC3795976522: Hold'em No Limit ($0.02/$0.05) - 2025/08/10 08:54:35
Table 'RushAndCash11071782' 6-max Seat #1 is the button
Seat 1: 67671ee6 ($6 in chips)
Seat 2: d27c038b ($3.4 in chips)
Seat 3: 41ed372d ($8.3 in chips)
Seat 4: Hero ($5.69 in chips)
Seat 5: 4ba45dd4 ($5 in chips)
Seat 6: 138096db ($6.47 in chips)
d27c038b: posts small blind $0.02
41ed372d: posts big blind $0.05
*** HOLE CARDS ***
Dealt to 67671ee6 
Dealt to d27c038b 
Dealt to 41ed372d 
Dealt to Hero [3c 4d]
Dealt to 4ba45dd4 
Dealt to 138096db 
Hero: folds
4ba45dd4: folds
138096db: folds
67671ee6: folds
d27c038b: folds
Uncalled bet ($0.03) returned to 41ed372d
*** SHOWDOWN ***
41ed372d collected $0.04 from pot
*** SUMMARY ***
Total pot $0.04 | Rake $0 | Jackpot $0 | Bingo $0 | Fortune $0 | Tax $0
Seat 1: 67671ee6 (button) folded before Flop (didn't bet)
Seat 2: d27c038b (small blind) folded before Flop
Seat 3: 41ed372d (big blind) collected ($0.04)
Seat 4: Hero folded before Flop (didn't bet)
Seat 5: 4ba45dd4 folded before Flop (didn't bet)
Seat 6: 138096db folded before Flop (didn't bet)


Poker Hand #RC3795976281: Hold'em No Limit ($0.02/$0.05) - 2025/08/10 08:53:34
Table 'RushAndCash11071541' 6-max Seat #1 is the button
Seat 1: 4ba45dd4 ($5 in chips)
Seat 2: 91b024bc ($11.57 in chips)
Seat 3: Hero ($5.49 in chips)
Seat 4: 7bd4810f ($5.45 in chips)
Seat 5: b3eab32a ($5 in chips)
Seat 6: 6521a0bf ($4.76 in chips)
91b024bc: posts small blind $0.02
Hero: posts big blind $0.05
*** HOLE CARDS ***
Dealt to 4ba45dd4 
Dealt to 91b024bc 
Dealt to Hero [8c As]
Dealt to 7bd4810f 
Dealt to b3eab32a 
Dealt to 6521a0bf 
7bd4810f: folds
b3eab32a: folds
6521a0bf: folds
4ba45dd4: raises $0.05 to $0.1
91b024bc: folds
Hero: calls $0.05
*** FLOP *** [Ac Kd 2h]
Hero: checks
4ba45dd4: bets $0.1
Hero: calls $0.1
*** TURN *** [Ac Kd 2h] [Ad]
Hero: checks
4ba45dd4: checks
*** RIVER *** [Ac Kd 2h Ad] [6c]
Hero: checks
4ba45dd4: checks
Hero: shows [8c As] (three of a kind, Aces)
4ba45dd4: shows [9c Qs] (a pair of Aces)
*** SHOWDOWN ***
Hero collected $0.4 from pot
*** SUMMARY ***
Total pot $0.42 | Rake $0.02 | Jackpot $0 | Bingo $0 | Fortune $0 | Tax $0
Board [Ac Kd 2h Ad 6c]
Seat 1: 4ba45dd4 (button) showed [9c Qs] and lost with a pair of Aces
Seat 2: 91b024bc (small blind) folded before Flop
Seat 3: Hero (big blind) showed [8c As] and won ($0.4) with three of a kind, Aces
Seat 4: 7bd4810f folded before Flop (didn't bet)
Seat 5: b3eab32a folded before Flop (didn't bet)
Seat 6: 6521a0bf folded before Flop (didn't bet)


Poker Hand #RC3795976249: Hold'em No Limit ($0.02/$0.05) - 2025/08/10 08:53:26
Table 'RushAndCash11071509' 6-max Seat #1 is the button
Seat 1: Hero ($5.49 in chips)
Seat 2: d8b9a478 ($7.04 in chips)
Seat 3: e2ddd0b5 ($4.38 in chips)
Seat 4: db1b4045 ($5 in chips)
Seat 5: e792c630 ($5.67 in chips)
Seat 6: 9e684ec7 ($5 in chips)
d8b9a478: posts small blind $0.02
e2ddd0b5: posts big blind $0.05
*** HOLE CARDS ***
Dealt to Hero [7h Qc]
Dealt to d8b9a478 
Dealt to e2ddd0b5 
Dealt to db1b4045 
Dealt to e792c630 
Dealt to 9e684ec7 
db1b4045: folds
e792c630: folds
9e684ec7: calls $0.05
Hero: folds
d8b9a478: folds
e2ddd0b5: raises $0.4 to $0.45
9e684ec7: folds
Uncalled bet ($0.4) returned to e2ddd0b5
*** SHOWDOWN ***
e2ddd0b5 collected $0.12 from pot
*** SUMMARY ***
Total pot $0.12 | Rake $0 | Jackpot $0 | Bingo $0 | Fortune $0 | Tax $0
Seat 1: Hero (button) folded before Flop (didn't bet)
Seat 2: d8b9a478 (small blind) folded before Flop
Seat 3: e2ddd0b5 (big blind) collected ($0.12)
Seat 4: db1b4045 folded before Flop (didn't bet)
Seat 5: e792c630 folded before Flop (didn't bet)
Seat 6: 9e684ec7 folded before Flop


Poker Hand #RC3795976237: Hold'em No Limit ($0.02/$0.05) - 2025/08/10 08:53:22
Table 'RushAndCash11071497' 6-max Seat #1 is the button
Seat 1: 7bd4810f ($5.45 in chips)
Seat 2: a1651cdc ($7.91 in chips)
Seat 3: b3eab32a ($5 in chips)
Seat 4: cef92baa ($7.25 in chips)
Seat 5: 66a574d1 ($5.28 in chips)
Seat 6: Hero ($5.49 in chips)
a1651cdc: posts small blind $0.02
b3eab32a: posts big blind $0.05
*** HOLE CARDS ***
Dealt to 7bd4810f 
Dealt to a1651cdc 
Dealt to b3eab32a 
Dealt to cef92baa 
Dealt to 66a574d1 
Dealt to Hero [2c 5s]
cef92baa: folds
66a574d1: folds
Hero: folds
7bd4810f: folds
a1651cdc: raises $0.08 to $0.13
b3eab32a: folds
Uncalled bet ($0.08) returned to a1651cdc
*** SHOWDOWN ***
a1651cdc collected $0.1 from pot
*** SUMMARY ***
Total pot $0.1 | Rake $0 | Jackpot $0 | Bingo $0 | Fortune $0 | Tax $0
Seat 1: 7bd4810f (button) folded before Flop (didn't bet)
Seat 2: a1651cdc (small blind) collected ($0.1)
Seat 3: b3eab32a (big blind) folded before Flop
Seat 4: cef92baa folded before Flop (didn't bet)
Seat 5: 66a574d1 folded before Flop (didn't bet)
Seat 6: Hero folded before Flop (didn't bet)


Poker Hand #RC3795976222: Hold'em No Limit ($0.02/$0.05) - 2025/08/10 08:53:18
Table 'RushAndCash11071482' 6-max Seat #1 is the button
Seat 1: Hero ($5.49 in chips)
Seat 2: ac3a4080 ($5 in chips)
Seat 3: d3b2bf87 ($9.91 in chips)
Seat 4: 2ae3e290 ($7.44 in chips)
Seat 5: eb6b9c9e ($5.28 in chips)
Seat 6: d95dfe1c ($5.34 in chips)
ac3a4080: posts small blind $0.02
d3b2bf87: posts big blind $0.05
*** HOLE CARDS ***
Dealt to Hero [2s 6d]
Dealt to ac3a4080 
Dealt to d3b2bf87 
Dealt to 2ae3e290 
Dealt to eb6b9c9e 
Dealt to d95dfe1c 
2ae3e290: folds
eb6b9c9e: folds
d95dfe1c: folds
Hero: folds
ac3a4080: folds
Uncalled bet ($0.03) returned to d3b2bf87
*** SHOWDOWN ***
d3b2bf87 collected $0.04 from pot
*** SUMMARY ***
Total pot $0.04 | Rake $0 | Jackpot $0 | Bingo $0 | Fortune $0 | Tax $0
Seat 1: Hero (button) folded before Flop (didn't bet)
Seat 2: ac3a4080 (small blind) folded before Flop
Seat 3: d3b2bf87 (big blind) collected ($0.04)
Seat 4: 2ae3e290 folded before Flop (didn't bet)
Seat 5: eb6b9c9e folded before Flop (didn't bet)
Seat 6: d95dfe1c folded before Flop (didn't bet)


Poker Hand #RC3795976106: Hold'em No Limit ($0.02/$0.05) - 2025/08/10 08:52:51
Table 'RushAndCash11071366' 6-max Seat #1 is the button
Seat 1: 55b6c449 ($6.76 in chips)
Seat 2: Hero ($5.35 in chips)
Seat 3: d97bce4f ($16.79 in chips)
Seat 4: 7fbe4590 ($6.31 in chips)
Seat 5: 5c5d4a8d ($12.26 in chips)
Seat 6: d95dfe1c ($5.44 in chips)
Hero: posts small blind $0.02
d97bce4f: posts big blind $0.05
*** HOLE CARDS ***
Dealt to 55b6c449 
Dealt to Hero [Kc Ah]
Dealt to d97bce4f 
Dealt to 7fbe4590 
Dealt to 5c5d4a8d 
Dealt to d95dfe1c 
7fbe4590: folds
5c5d4a8d: folds
d95dfe1c: raises $0.05 to $0.1
55b6c449: folds
Hero: raises $0.36 to $0.46
d97bce4f: folds
d95dfe1c: folds
Uncalled bet ($0.36) returned to Hero
*** SHOWDOWN ***
Hero collected $0.24 from pot
*** SUMMARY ***
Total pot $0.25 | Rake $0.01 | Jackpot $0 | Bingo $0 | Fortune $0 | Tax $0
Seat 1: 55b6c449 (button) folded before Flop (didn't bet)
Seat 2: Hero (small blind) collected ($0.24)
Seat 3: d97bce4f (big blind) folded before Flop
Seat 4: 7fbe4590 folded before Flop (didn't bet)
Seat 5: 5c5d4a8d folded before Flop (didn't bet)
Seat 6: d95dfe1c folded before Flop


Poker Hand #RC3795976092: Hold'em No Limit ($0.02/$0.05) - 2025/08/10 08:52:47
Table 'RushAndCash11071352' 6-max Seat #1 is the button
Seat 1: 2ae3e290 ($7.44 in chips)
Seat 2: bbe7580 ($3.38 in chips)
Seat 3: 95dae023 ($6.37 in chips)
Seat 4: f009f5ba ($4.43 in chips)
Seat 5: Hero ($5.35 in chips)
Seat 6: 9a343d90 ($10 in chips)
bbe7580: posts small blind $0.02
95dae023: posts big blind $0.05
*** HOLE CARDS ***
Dealt to 2ae3e290 
Dealt to bbe7580 
Dealt to 95dae023 
Dealt to f009f5ba 
Dealt to Hero [4s 4d]
Dealt to 9a343d90 
f009f5ba: raises $0.05 to $0.1
Hero: folds
9a343d90: folds
2ae3e290: folds
bbe7580: folds
95dae023: folds
Uncalled bet ($0.05) returned to f009f5ba
*** SHOWDOWN ***
f009f5ba collected $0.12 from pot
*** SUMMARY ***
Total pot $0.12 | Rake $0 | Jackpot $0 | Bingo $0 | Fortune $0 | Tax $0
Seat 1: 2ae3e290 (button) folded before Flop (didn't bet)
Seat 2: bbe7580 (small blind) folded before Flop
Seat 3: 95dae023 (big blind) folded before Flop
Seat 4: f009f5ba collected ($0.12)
Seat 5: Hero folded before Flop (didn't bet)
Seat 6: 9a343d90 folded before Flop (didn't bet)


Poker Hand #RC3795975910: Hold'em No Limit ($0.02/$0.05) - 2025/08/10 08:51:59
Table 'RushAndCash11071170' 6-max Seat #1 is the button
Seat 1: 97b1f31 ($7.19 in chips)
Seat 2: Hero ($4.91 in chips)
Seat 3: 1dafb1bc ($38.49 in chips)
Seat 4: 9c6cac08 ($5 in chips)
Seat 5: aa95eeae ($7.43 in chips)
Seat 6: bbe7580 ($3.81 in chips)
Hero: posts small blind $0.02
1dafb1bc: posts big blind $0.05
*** HOLE CARDS ***
Dealt to 97b1f31 
Dealt to Hero [Js Ts]
Dealt to 1dafb1bc 
Dealt to 9c6cac08 
Dealt to aa95eeae 
Dealt to bbe7580 
9c6cac08: folds
aa95eeae: folds
bbe7580: raises $0.1 to $0.15
97b1f31: folds
Hero: calls $0.13
1dafb1bc: folds
*** FLOP *** [2h Ah Qh]
Hero: checks
bbe7580: checks
*** TURN *** [2h Ah Qh] [Kc]
Hero: bets $0.28
bbe7580: calls $0.28
*** RIVER *** [2h Ah Qh Kc] [8d]
Hero: bets $1.08
bbe7580: folds
Uncalled bet ($1.08) returned to Hero
*** SHOWDOWN ***
Hero collected $0.87 from pot
*** SUMMARY ***
Total pot $0.91 | Rake $0.04 | Jackpot $0 | Bingo $0 | Fortune $0 | Tax $0
Board [2h Ah Qh Kc 8d]
Seat 1: 97b1f31 (button) folded before Flop (didn't bet)
Seat 2: Hero (small blind) won ($0.87)
Seat 3: 1dafb1bc (big blind) folded before Flop
Seat 4: 9c6cac08 folded before Flop (didn't bet)
Seat 5: aa95eeae folded before Flop (didn't bet)
Seat 6: bbe7580 folded on the River


Poker Hand #RC3795975727: Hold'em No Limit ($0.02/$0.05) - 2025/08/10 08:51:07
Table 'RushAndCash11070987' 6-max Seat #1 is the button
Seat 1: Hero ($4.44 in chips)
Seat 2: dfb00ca4 ($5.72 in chips)
Seat 3: fccf4928 ($12.17 in chips)
Seat 4: d3b2bf87 ($9.57 in chips)
Seat 5: 8d1c252c ($9.84 in chips)
Seat 6: bbe7580 ($4.25 in chips)
dfb00ca4: posts small blind $0.02
fccf4928: posts big blind $0.05
*** HOLE CARDS ***
Dealt to Hero [Jd Kc]
Dealt to dfb00ca4 
Dealt to fccf4928 
Dealt to d3b2bf87 
Dealt to 8d1c252c 
Dealt to bbe7580 
d3b2bf87: folds
8d1c252c: folds
bbe7580: raises $0.1 to $0.15
Hero: calls $0.15
dfb00ca4: folds
fccf4928: folds
*** FLOP *** [9h 2d Jh]
bbe7580: checks
Hero: checks
*** TURN *** [9h 2d Jh] [Jc]
bbe7580: checks
Hero: bets $0.29
bbe7580: calls $0.29
*** RIVER *** [9h 2d Jh Jc] [9d]
bbe7580: checks
Hero: bets $1.14
bbe7580: folds
Uncalled bet ($1.14) returned to Hero
*** SHOWDOWN ***
Hero collected $0.91 from pot
*** SUMMARY ***
Total pot $0.95 | Rake $0.04 | Jackpot $0 | Bingo $0 | Fortune $0 | Tax $0
Board [9h 2d Jh Jc 9d]
Seat 1: Hero (button) won ($0.91)
Seat 2: dfb00ca4 (small blind) folded before Flop
Seat 3: fccf4928 (big blind) folded before Flop
Seat 4: d3b2bf87 folded before Flop (didn't bet)
Seat 5: 8d1c252c folded before Flop (didn't bet)
Seat 6: bbe7580 folded on the River


Poker Hand #RC3795975682: Hold'em No Limit ($0.02/$0.05) - 2025/08/10 08:50:55
Table 'RushAndCash11070942' 6-max Seat #1 is the button
Seat 1: 2b56ac20 ($20 in chips)
Seat 2: 73869740 ($5.9 in chips)
Seat 3: Hero ($4.49 in chips)
Seat 4: c1c6f9fc ($5 in chips)
Seat 5: e2ddd0b5 ($4.47 in chips)
Seat 6: 84a6e006 ($7.79 in chips)
73869740: posts small blind $0.02
Hero: posts big blind $0.05
*** HOLE CARDS ***
Dealt to 2b56ac20 
Dealt to 73869740 
Dealt to Hero [Jc 6d]
Dealt to c1c6f9fc 
Dealt to e2ddd0b5 
Dealt to 84a6e006 
c1c6f9fc: folds
e2ddd0b5: raises $0.1 to $0.15
84a6e006: folds
2b56ac20: calls $0.15
73869740: folds
Hero: folds
*** FLOP *** [Js 4c 2h]
e2ddd0b5: checks
2b56ac20: bets $0.19
e2ddd0b5: calls $0.19
*** TURN *** [Js 4c 2h] [7c]
e2ddd0b5: checks
2b56ac20: bets $0.44
e2ddd0b5: folds
Uncalled bet ($0.44) returned to 2b56ac20
*** SHOWDOWN ***
2b56ac20 collected $0.72 from pot
*** SUMMARY ***
Total pot $0.75 | Rake $0.03 | Jackpot $0 | Bingo $0 | Fortune $0 | Tax $0
Board [Js 4c 2h 7c]
Seat 1: 2b56ac20 (button) won ($0.72)
Seat 2: 73869740 (small blind) folded before Flop
Seat 3: Hero (big blind) folded before Flop
Seat 4: c1c6f9fc folded before Flop (didn't bet)
Seat 5: e2ddd0b5 folded on the Turn
Seat 6: 84a6e006 folded before Flop (didn't bet)


Poker Hand #RC3795975669: Hold'em No Limit ($0.02/$0.05) - 2025/08/10 08:50:52
Table 'RushAndCash11070929' 6-max Seat #1 is the button
Seat 1: 60b0a03d ($12.76 in chips)
Seat 2: 14157496 ($14.24 in chips)
Seat 3: f1d249e2 ($7.31 in chips)
Seat 4: 2b56ac20 ($20 in chips)
Seat 5: d8b9a478 ($7.43 in chips)
Seat 6: Hero ($4.49 in chips)
14157496: posts small blind $0.02
f1d249e2: posts big blind $0.05
*** HOLE CARDS ***
Dealt to 60b0a03d 
Dealt to 14157496 
Dealt to f1d249e2 
Dealt to 2b56ac20 
Dealt to d8b9a478 
Dealt to Hero [Js 3d]
2b56ac20: folds
d8b9a478: folds
Hero: folds
60b0a03d: folds
14157496: folds
Uncalled bet ($0.03) returned to f1d249e2
*** SHOWDOWN ***
f1d249e2 collected $0.04 from pot
*** SUMMARY ***
Total pot $0.04 | Rake $0 | Jackpot $0 | Bingo $0 | Fortune $0 | Tax $0
Seat 1: 60b0a03d (button) folded before Flop (didn't bet)
Seat 2: 14157496 (small blind) folded before Flop
Seat 3: f1d249e2 (big blind) collected ($0.04)
Seat 4: 2b56ac20 folded before Flop (didn't bet)
Seat 5: d8b9a478 folded before Flop (didn't bet)
Seat 6: Hero folded before Flop (didn't bet)


Poker Hand #RC3795975648: Hold'em No Limit ($0.02/$0.05) - 2025/08/10 08:50:46
Table 'RushAndCash11070908' 6-max Seat #1 is the button
Seat 1: 1dafb1bc ($38.52 in chips)
Seat 2: Hero ($4.51 in chips)
Seat 3: 43f64b9b ($6.86 in chips)
Seat 4: f76279b5 ($5.27 in chips)
Seat 5: 7e9b978a ($7.69 in chips)
Seat 6: 69bc96d4 ($7.6 in chips)
Hero: posts small blind $0.02
43f64b9b: posts big blind $0.05
*** HOLE CARDS ***
Dealt to 1dafb1bc 
Dealt to Hero [Th 2c]
Dealt to 43f64b9b 
Dealt to f76279b5 
Dealt to 7e9b978a 
Dealt to 69bc96d4 
f76279b5: raises $0.05 to $0.1
7e9b978a: folds
69bc96d4: folds
1dafb1bc: folds
Hero: folds
43f64b9b: calls $0.05
*** FLOP *** [7h Ks 9h]
43f64b9b: checks
f76279b5: bets $0.08
43f64b9b: folds
Uncalled bet ($0.08) returned to f76279b5
*** SHOWDOWN ***
f76279b5 collected $0.21 from pot
*** SUMMARY ***
Total pot $0.22 | Rake $0.01 | Jackpot $0 | Bingo $0 | Fortune $0 | Tax $0
Board [7h Ks 9h]
Seat 1: 1dafb1bc (button) folded before Flop (didn't bet)
Seat 2: Hero (small blind) folded before Flop
Seat 3: 43f64b9b (big blind) folded on the Flop
Seat 4: f76279b5 won ($0.21)
Seat 5: 7e9b978a folded before Flop (didn't bet)
Seat 6: 69bc96d4 folded before Flop (didn't bet)


Poker Hand #RC3795975633: Hold'em No Limit ($0.02/$0.05) - 2025/08/10 08:50:43
Table 'RushAndCash11070893' 6-max Seat #1 is the button
Seat 1: 6487a64d ($10.1 in chips)
Seat 2: 4e8f2794 ($4.96 in chips)
Seat 3: c6ab3de5 ($5.21 in chips)
Seat 4: 41d49907 ($4.73 in chips)
Seat 5: Hero ($4.51 in chips)
Seat 6: d8b9a478 ($7.45 in chips)
4e8f2794: posts small blind $0.02
c6ab3de5: posts big blind $0.05
*** HOLE CARDS ***
Dealt to 6487a64d 
Dealt to 4e8f2794 
Dealt to c6ab3de5 
Dealt to 41d49907 
Dealt to Hero [4c Qd]
Dealt to d8b9a478 
41d49907: calls $0.05
Hero: folds
d8b9a478: folds
6487a64d: folds
4e8f2794: folds
c6ab3de5: checks
*** FLOP *** [8c 9d Jd]
c6ab3de5: checks
41d49907: bets $0.09
c6ab3de5: folds
Uncalled bet ($0.09) returned to 41d49907
*** SHOWDOWN ***
41d49907 collected $0.12 from pot
*** SUMMARY ***
Total pot $0.12 | Rake $0 | Jackpot $0 | Bingo $0 | Fortune $0 | Tax $0
Board [8c 9d Jd]
Seat 1: 6487a64d (button) folded before Flop (didn't bet)
Seat 2: 4e8f2794 (small blind) folded before Flop
Seat 3: c6ab3de5 (big blind) folded on the Flop
Seat 4: 41d49907 won ($0.12)
Seat 5: Hero folded before Flop (didn't bet)
Seat 6: d8b9a478 folded before Flop (didn't bet)


Poker Hand #RC3795975618: Hold'em No Limit ($0.02/$0.05) - 2025/08/10 08:50:39
Table 'RushAndCash11070878' 6-max Seat #1 is the button
Seat 1: 5a89161f ($2.93 in chips)
Seat 2: e3f802af ($5.78 in chips)
Seat 3: 3f5c4b90 ($7.41 in chips)
Seat 4: 2b5a7a1b ($12.43 in chips)
Seat 5: Hero ($4.51 in chips)
Seat 6: d2ef50f8 ($3.82 in chips)
e3f802af: posts small blind $0.02
3f5c4b90: posts big blind $0.05
*** HOLE CARDS ***
Dealt to 5a89161f 
Dealt to e3f802af 
Dealt to 3f5c4b90 
Dealt to 2b5a7a1b 
Dealt to Hero [5h 2d]
Dealt to d2ef50f8 
2b5a7a1b: folds
Hero: folds
d2ef50f8: folds
5a89161f: calls $0.05
e3f802af: raises $0.23 to $0.28
3f5c4b90: folds
5a89161f: calls $0.23
*** FLOP *** [Js Ad 3c]
e3f802af: checks
5a89161f: checks
*** TURN *** [Js Ad 3c] [Jh]
e3f802af: bets $0.41
5a89161f: calls $0.41
*** RIVER *** [Js Ad 3c Jh] [Td]
e3f802af: checks
5a89161f: checks
e3f802af: shows [4h Ah] (two pair, Aces and Jacks)
5a89161f: shows [6d Ts] (two pair, Jacks and Tens)
*** SHOWDOWN ***
e3f802af collected $1.36 from pot
*** SUMMARY ***
Total pot $1.43 | Rake $0.07 | Jackpot $0 | Bingo $0 | Fortune $0 | Tax $0
Board [Js Ad 3c Jh Td]
Seat 1: 5a89161f (button) showed [6d Ts] and lost with two pair, Jacks and Tens
Seat 2: e3f802af (small blind) showed [4h Ah] and won ($1.36) with two pair, Aces and Jacks
Seat 3: 3f5c4b90 (big blind) folded before Flop
Seat 4: 2b5a7a1b folded before Flop (didn't bet)
Seat 5: Hero folded before Flop (didn't bet)
Seat 6: d2ef50f8 folded before Flop (didn't bet)


Poker Hand #RC3795975604: Hold'em No Limit ($0.02/$0.05) - 2025/08/10 08:50:35
Table 'RushAndCash11070864' 6-max Seat #1 is the button
Seat 1: Hero ($4.51 in chips)
Seat 2: ccbf95f3 ($9.24 in chips)
Seat 3: 3880f0a ($4.9 in chips)
Seat 4: d2ef50f8 ($3.82 in chips)
Seat 5: 92509c17 ($5.09 in chips)
Seat 6: 12a544c1 ($5.98 in chips)
ccbf95f3: posts small blind $0.02
3880f0a: posts big blind $0.05
*** HOLE CARDS ***
Dealt to Hero [Ah 7c]
Dealt to ccbf95f3 
Dealt to 3880f0a 
Dealt to d2ef50f8 
Dealt to 92509c17 
Dealt to 12a544c1 
d2ef50f8: folds
92509c17: folds
12a544c1: folds
Hero: folds
ccbf95f3: folds
Uncalled bet ($0.03) returned to 3880f0a
*** SHOWDOWN ***
3880f0a collected $0.04 from pot
*** SUMMARY ***
Total pot $0.04 | Rake $0 | Jackpot $0 | Bingo $0 | Fortune $0 | Tax $0
Seat 1: Hero (button) folded before Flop (didn't bet)
Seat 2: ccbf95f3 (small blind) folded before Flop
Seat 3: 3880f0a (big blind) collected ($0.04)
Seat 4: d2ef50f8 folded before Flop (didn't bet)
Seat 5: 92509c17 folded before Flop (didn't bet)
Seat 6: 12a544c1 folded before Flop (didn't bet)


Poker Hand #RC3795975551: Hold'em No Limit ($0.02/$0.05) - 2025/08/10 08:50:22
Table 'RushAndCash11070811' 6-max Seat #1 is the button
Seat 1: bf4e2b6b ($21.78 in chips)
Seat 2: b1b3930a ($7.14 in chips)
Seat 3: Hero ($4.56 in chips)
Seat 4: 42c31e1a ($13.57 in chips)
Seat 5: 81dcd1a8 ($5.8 in chips)
Seat 6: 279a8e9f ($6.85 in chips)
b1b3930a: posts small blind $0.02
Hero: posts big blind $0.05
*** HOLE CARDS ***
Dealt to bf4e2b6b 
Dealt to b1b3930a 
Dealt to Hero [Jh 5h]
Dealt to 42c31e1a 
Dealt to 81dcd1a8 
Dealt to 279a8e9f 
42c31e1a: raises $0.07 to $0.12
81dcd1a8: calls $0.12
279a8e9f: folds
bf4e2b6b: folds
b1b3930a: folds
Hero: folds
*** FLOP *** [7d 4h 6s]
42c31e1a: checks
81dcd1a8: bets $0.16
42c31e1a: folds
Uncalled bet ($0.16) returned to 81dcd1a8
*** SHOWDOWN ***
81dcd1a8 collected $0.3 from pot
*** SUMMARY ***
Total pot $0.31 | Rake $0.01 | Jackpot $0 | Bingo $0 | Fortune $0 | Tax $0
Board [7d 4h 6s]
Seat 1: bf4e2b6b (button) folded before Flop (didn't bet)
Seat 2: b1b3930a (small blind) folded before Flop
Seat 3: Hero (big blind) folded before Flop
Seat 4: 42c31e1a folded on the Flop
Seat 5: 81dcd1a8 won ($0.3)
Seat 6: 279a8e9f folded before Flop (didn't bet)


Poker Hand #RC3795975537: Hold'em No Limit ($0.02/$0.05) - 2025/08/10 08:50:18
Table 'RushAndCash11070797' 6-max Seat #1 is the button
Seat 1: 46b95d1e ($5.05 in chips)
Seat 2: 349517c8 ($5.75 in chips)
Seat 3: 7b419a6a ($4.86 in chips)
Seat 4: Hero ($4.56 in chips)
Seat 5: fd4b11f ($5.28 in chips)
Seat 6: b1b3930a ($7.14 in chips)
349517c8: posts small blind $0.02
7b419a6a: posts big blind $0.05
*** HOLE CARDS ***
Dealt to 46b95d1e 
Dealt to 349517c8 
Dealt to 7b419a6a 
Dealt to Hero [5h 9c]
Dealt to fd4b11f 
Dealt to b1b3930a 
Hero: folds
fd4b11f: folds
b1b3930a: folds
46b95d1e: folds
349517c8: folds
Uncalled bet ($0.03) returned to 7b419a6a
*** SHOWDOWN ***
7b419a6a collected $0.04 from pot
*** SUMMARY ***
Total pot $0.04 | Rake $0 | Jackpot $0 | Bingo $0 | Fortune $0 | Tax $0
Seat 1: 46b95d1e (button) folded before Flop (didn't bet)
Seat 2: 349517c8 (small blind) folded before Flop
Seat 3: 7b419a6a (big blind) collected ($0.04)
Seat 4: Hero folded before Flop (didn't bet)
Seat 5: fd4b11f folded before Flop (didn't bet)
Seat 6: b1b3930a folded before Flop (didn't bet)


Poker Hand #RC3795975522: Hold'em No Limit ($0.02/$0.05) - 2025/08/10 08:50:15
Table 'RushAndCash11070782' 6-max Seat #1 is the button
Seat 1: fbc6e1f4 ($10.5 in chips)
Seat 2: ede202e3 ($6.62 in chips)
Seat 3: c870b5d7 ($5 in chips)
Seat 4: c4cbb3ef ($8.38 in chips)
Seat 5: e11b584d ($5 in chips)
Seat 6: Hero ($4.56 in chips)
ede202e3: posts small blind $0.02
c870b5d7: posts big blind $0.05
*** HOLE CARDS ***
Dealt to fbc6e1f4 
Dealt to ede202e3 
Dealt to c870b5d7 
Dealt to c4cbb3ef 
Dealt to e11b584d 
Dealt to Hero [9s 2s]
c4cbb3ef: raises $0.08 to $0.13
e11b584d: folds
Hero: folds
fbc6e1f4: folds
ede202e3: calls $0.11
c870b5d7: folds
*** FLOP *** [7h Kc 7c]
ede202e3: checks
c4cbb3ef: checks
*** TURN *** [7h Kc 7c] [Ad]
ede202e3: checks
c4cbb3ef: bets $0.16
ede202e3: calls $0.16
*** RIVER *** [7h Kc 7c Ad] [Qd]
ede202e3: checks
c4cbb3ef: checks
ede202e3: shows [9c Jc] (a pair of Sevens)
c4cbb3ef: shows [Ac 3c] (two pair, Aces and Sevens)
*** SHOWDOWN ***
c4cbb3ef collected $0.6 from pot
*** SUMMARY ***
Total pot $0.63 | Rake $0.03 | Jackpot $0 | Bingo $0 | Fortune $0 | Tax $0
Board [7h Kc 7c Ad Qd]
Seat 1: fbc6e1f4 (button) folded before Flop (didn't bet)
Seat 2: ede202e3 (small blind) showed [9c Jc] and lost with a pair of Sevens
Seat 3: c870b5d7 (big blind) folded before Flop
Seat 4: c4cbb3ef showed [Ac 3c] and won ($0.6) with two pair, Aces and Sevens
Seat 5: e11b584d folded before Flop (didn't bet)
Seat 6: Hero folded before Flop (didn't bet)


Poker Hand #RC3795975508: Hold'em No Limit ($0.02/$0.05) - 2025/08/10 08:50:11
Table 'RushAndCash11070768' 6-max Seat #1 is the button
Seat 1: 12a544c1 ($5.98 in chips)
Seat 2: 8c26694f ($4.53 in chips)
Seat 3: 808de8ec ($2.17 in chips)
Seat 4: 7165cda2 ($5.79 in chips)
Seat 5: bf4e2b6b ($21.78 in chips)
Seat 6: Hero ($4.56 in chips)
8c26694f: posts small blind $0.02
808de8ec: posts big blind $0.05
*** HOLE CARDS ***
Dealt to 12a544c1 
Dealt to 8c26694f 
Dealt to 808de8ec 
Dealt to 7165cda2 
Dealt to bf4e2b6b 
Dealt to Hero [Ks 8d]
7165cda2: raises $0.05 to $0.1
bf4e2b6b: folds
Hero: folds
12a544c1: folds
8c26694f: calls $0.08
808de8ec: calls $0.05
*** FLOP *** [2h 2c Ac]
8c26694f: checks
808de8ec: checks
7165cda2: checks
*** TURN *** [2h 2c Ac] [9s]
8c26694f: bets $0.15
808de8ec: folds
7165cda2: folds
Uncalled bet ($0.15) returned to 8c26694f
*** SHOWDOWN ***
8c26694f collected $0.29 from pot
*** SUMMARY ***
Total pot $0.3 | Rake $0.01 | Jackpot $0 | Bingo $0 | Fortune $0 | Tax $0
Board [2h 2c Ac 9s]
Seat 1: 12a544c1 (button) folded before Flop (didn't bet)
Seat 2: 8c26694f (small blind) won ($0.29)
Seat 3: 808de8ec (big blind) folded on the Turn
Seat 4: 7165cda2 folded on the Turn
Seat 5: bf4e2b6b folded before Flop (didn't bet)
Seat 6: Hero folded before Flop (didn't bet)


Poker Hand #RC3795975305: Hold'em No Limit ($0.02/$0.05) - 2025/08/10 08:49:19
Table 'RushAndCash11070565' 6-max Seat #1 is the button
Seat 1: 9e9f7171 ($6.14 in chips)
Seat 2: 808de8ec ($2.27 in chips)
Seat 3: cef92baa ($7.27 in chips)
Seat 4: 62cfb04e ($5 in chips)
Seat 5: e612f091 ($7.41 in chips)
Seat 6: Hero ($4.42 in chips)
808de8ec: posts small blind $0.02
cef92baa: posts big blind $0.05
*** HOLE CARDS ***
Dealt to 9e9f7171 
Dealt to 808de8ec 
Dealt to cef92baa 
Dealt to 62cfb04e 
Dealt to e612f091 
Dealt to Hero [9d Qd]
62cfb04e: folds
e612f091: folds
Hero: raises $0.05 to $0.1
9e9f7171: folds
808de8ec: calls $0.08
cef92baa: folds
*** FLOP *** [Kd 9h 9c]
808de8ec: checks
Hero: bets $0.07
808de8ec: folds
Uncalled bet ($0.07) returned to Hero
*** SHOWDOWN ***
Hero collected $0.24 from pot
*** SUMMARY ***
Total pot $0.25 | Rake $0.01 | Jackpot $0 | Bingo $0 | Fortune $0 | Tax $0
Board [Kd 9h 9c]
Seat 1: 9e9f7171 (button) folded before Flop (didn't bet)
Seat 2: 808de8ec (small blind) folded on the Flop
Seat 3: cef92baa (big blind) folded before Flop
Seat 4: 62cfb04e folded before Flop (didn't bet)
Seat 5: e612f091 folded before Flop (didn't bet)
Seat 6: Hero won ($0.24)


Poker Hand #RC3795975292: Hold'em No Limit ($0.02/$0.05) - 2025/08/10 08:49:16
Table 'RushAndCash11070552' 6-max Seat #1 is the button
Seat 1: 7165cda2 ($5.76 in chips)
Seat 2: aa95eeae ($7.69 in chips)
Seat 3: bc911417 ($10.52 in chips)
Seat 4: Hero ($4.42 in chips)
Seat 5: b4877733 ($5.05 in chips)
Seat 6: 6545cc7a ($5.07 in chips)
aa95eeae: posts small blind $0.02
bc911417: posts big blind $0.05
*** HOLE CARDS ***
Dealt to 7165cda2 
Dealt to aa95eeae 
Dealt to bc911417 
Dealt to Hero [9s Kd]
Dealt to b4877733 
Dealt to 6545cc7a 
Hero: folds
b4877733: folds
6545cc7a: folds
7165cda2: folds
aa95eeae: folds
Uncalled bet ($0.03) returned to bc911417
*** SHOWDOWN ***
bc911417 collected $0.04 from pot
*** SUMMARY ***
Total pot $0.04 | Rake $0 | Jackpot $0 | Bingo $0 | Fortune $0 | Tax $0
Seat 1: 7165cda2 (button) folded before Flop (didn't bet)
Seat 2: aa95eeae (small blind) folded before Flop
Seat 3: bc911417 (big blind) collected ($0.04)
Seat 4: Hero folded before Flop (didn't bet)
Seat 5: b4877733 folded before Flop (didn't bet)
Seat 6: 6545cc7a folded before Flop (didn't bet)


Poker Hand #RC3795975275: Hold'em No Limit ($0.02/$0.05) - 2025/08/10 08:49:11
Table 'RushAndCash11070535' 6-max Seat #1 is the button
Seat 1: 22b1f4df ($7.43 in chips)
Seat 2: c1c6f9fc ($5.02 in chips)
Seat 3: Hero ($4.47 in chips)
Seat 4: 6a3842ba ($7.15 in chips)
Seat 5: 210c8e9b ($12.38 in chips)
Seat 6: 65914450 ($18.92 in chips)
c1c6f9fc: posts small blind $0.02
Hero: posts big blind $0.05
*** HOLE CARDS ***
Dealt to 22b1f4df 
Dealt to c1c6f9fc 
Dealt to Hero [3d 4h]
Dealt to 6a3842ba 
Dealt to 210c8e9b 
Dealt to 65914450 
6a3842ba: folds
210c8e9b: folds
65914450: raises $0.1 to $0.15
22b1f4df: folds
c1c6f9fc: folds
Hero: folds
Uncalled bet ($0.1) returned to 65914450
*** SHOWDOWN ***
65914450 collected $0.12 from pot
*** SUMMARY ***
Total pot $0.12 | Rake $0 | Jackpot $0 | Bingo $0 | Fortune $0 | Tax $0
Seat 1: 22b1f4df (button) folded before Flop (didn't bet)
Seat 2: c1c6f9fc (small blind) folded before Flop
Seat 3: Hero (big blind) folded before Flop
Seat 4: 6a3842ba folded before Flop (didn't bet)
Seat 5: 210c8e9b folded before Flop (didn't bet)
Seat 6: 65914450 collected ($0.12)


Poker Hand #RC3795975255: Hold'em No Limit ($0.02/$0.05) - 2025/08/10 08:49:06
Table 'RushAndCash11070515' 6-max Seat #1 is the button
Seat 1: 7c5efd3b ($4.64 in chips)
Seat 2: Hero ($4.49 in chips)
Seat 3: 6dc54533 ($43.87 in chips)
Seat 4: 2b56ac20 ($19.72 in chips)
Seat 5: 6521a0bf ($4.76 in chips)
Seat 6: 6df06218 ($6.71 in chips)
Hero: posts small blind $0.02
6dc54533: posts big blind $0.05
*** HOLE CARDS ***
Dealt to 7c5efd3b 
Dealt to Hero [3d 5s]
Dealt to 6dc54533 
Dealt to 2b56ac20 
Dealt to 6521a0bf 
Dealt to 6df06218 
2b56ac20: folds
6521a0bf: folds
6df06218: folds
7c5efd3b: folds
Hero: folds
Uncalled bet ($0.03) returned to 6dc54533
*** SHOWDOWN ***
6dc54533 collected $0.04 from pot
*** SUMMARY ***
Total pot $0.04 | Rake $0 | Jackpot $0 | Bingo $0 | Fortune $0 | Tax $0
Seat 1: 7c5efd3b (button) folded before Flop (didn't bet)
Seat 2: Hero (small blind) folded before Flop
Seat 3: 6dc54533 (big blind) collected ($0.04)
Seat 4: 2b56ac20 folded before Flop (didn't bet)
Seat 5: 6521a0bf folded before Flop (didn't bet)
Seat 6: 6df06218 folded before Flop (didn't bet)


Poker Hand #RC3795975240: Hold'em No Limit ($0.02/$0.05) - 2025/08/10 08:49:01
Table 'RushAndCash11070500' 6-max Seat #1 is the button
Seat 1: Hero ($4.49 in chips)
Seat 2: 86d57974 ($5 in chips)
Seat 3: 2ae3e290 ($7.68 in chips)
Seat 4: 2b56ac20 ($19.72 in chips)
Seat 5: 6e10dab3 ($13.07 in chips)
Seat 6: f76279b5 ($5.58 in chips)
86d57974: posts small blind $0.02
2ae3e290: posts big blind $0.05
*** HOLE CARDS ***
Dealt to Hero [Qh 6h]
Dealt to 86d57974 
Dealt to 2ae3e290 
Dealt to 2b56ac20 
Dealt to 6e10dab3 
Dealt to f76279b5 
2b56ac20: folds
6e10dab3: raises $0.1 to $0.15
f76279b5: folds
Hero: folds
86d57974: raises $0.2 to $0.35
2ae3e290: folds
6e10dab3: calls $0.2
*** FLOP *** [As 5s 7h]
86d57974: bets $0.05
6e10dab3: calls $0.05
*** TURN *** [As 5s 7h] [7s]
86d57974: bets $0.49
6e10dab3: folds
Uncalled bet ($0.49) returned to 86d57974
*** SHOWDOWN ***
86d57974 collected $0.81 from pot
*** SUMMARY ***
Total pot $0.85 | Rake $0.04 | Jackpot $0 | Bingo $0 | Fortune $0 | Tax $0
Board [As 5s 7h 7s]
Seat 1: Hero (button) folded before Flop (didn't bet)
Seat 2: 86d57974 (small blind) won ($0.81)
Seat 3: 2ae3e290 (big blind) folded before Flop
Seat 4: 2b56ac20 folded before Flop (didn't bet)
Seat 5: 6e10dab3 folded on the Turn
Seat 6: f76279b5 folded before Flop (didn't bet)


Poker Hand #RC3795975141: Hold'em No Limit ($0.02/$0.05) - 2025/08/10 08:48:34
Table 'RushAndCash11070401' 6-max Seat #1 is the button
Seat 1: 6a823878 ($14.28 in chips)
Seat 2: f3a1d090 ($22.28 in chips)
Seat 3: 2b5a7a1b ($12.43 in chips)
Seat 4: Hero ($4.33 in chips)
Seat 5: 9ae53275 ($5.65 in chips)
Seat 6: 6e10dab3 ($13.17 in chips)
f3a1d090: posts small blind $0.02
2b5a7a1b: posts big blind $0.05
*** HOLE CARDS ***
Dealt to 6a823878 
Dealt to f3a1d090 
Dealt to 2b5a7a1b 
Dealt to Hero [Tc Jc]
Dealt to 9ae53275 
Dealt to 6e10dab3 
Hero: raises $0.05 to $0.1
9ae53275: folds
6e10dab3: calls $0.1
6a823878: folds
f3a1d090: folds
2b5a7a1b: folds
*** FLOP *** [9c 2h 9s]
Hero: checks
6e10dab3: checks
*** TURN *** [9c 2h 9s] [Qd]
Hero: bets $0.22
6e10dab3: folds
Uncalled bet ($0.22) returned to Hero
*** SHOWDOWN ***
Hero collected $0.26 from pot
*** SUMMARY ***
Total pot $0.27 | Rake $0.01 | Jackpot $0 | Bingo $0 | Fortune $0 | Tax $0
Board [9c 2h 9s Qd]
Seat 1: 6a823878 (button) folded before Flop (didn't bet)
Seat 2: f3a1d090 (small blind) folded before Flop
Seat 3: 2b5a7a1b (big blind) folded before Flop
Seat 4: Hero won ($0.26)
Seat 5: 9ae53275 folded before Flop (didn't bet)
Seat 6: 6e10dab3 folded on the Turn


Poker Hand #RC3795975119: Hold'em No Limit ($0.02/$0.05) - 2025/08/10 08:48:28
Table 'RushAndCash11070379' 6-max Seat #1 is the button
Seat 1: Hero ($4.33 in chips)
Seat 2: bc8475a8 ($5.19 in chips)
Seat 3: 453d8970 ($5.56 in chips)
Seat 4: 22b1f4df ($7.34 in chips)
Seat 5: d97bce4f ($17.08 in chips)
Seat 6: 14ed52c2 ($1.92 in chips)
bc8475a8: posts small blind $0.02
453d8970: posts big blind $0.05
*** HOLE CARDS ***
Dealt to Hero [5c Kd]
Dealt to bc8475a8 
Dealt to 453d8970 
Dealt to 22b1f4df 
Dealt to d97bce4f 
Dealt to 14ed52c2 
22b1f4df: raises $0.05 to $0.1
d97bce4f: folds
14ed52c2: folds
Hero: folds
bc8475a8: calls $0.08
453d8970: folds
*** FLOP *** [4c 9d 7h]
bc8475a8: checks
22b1f4df: checks
*** TURN *** [4c 9d 7h] [7c]
bc8475a8: checks
22b1f4df: checks
*** RIVER *** [4c 9d 7h 7c] [Ah]
bc8475a8: checks
22b1f4df: checks
bc8475a8: shows [Jc Kh] (a pair of Sevens)
22b1f4df: shows [Ks Qc] (a pair of Sevens)
*** SHOWDOWN ***
22b1f4df collected $0.24 from pot
*** SUMMARY ***
Total pot $0.25 | Rake $0.01 | Jackpot $0 | Bingo $0 | Fortune $0 | Tax $0
Board [4c 9d 7h 7c Ah]
Seat 1: Hero (button) folded before Flop (didn't bet)
Seat 2: bc8475a8 (small blind) showed [Jc Kh] and lost with a pair of Sevens
Seat 3: 453d8970 (big blind) folded before Flop
Seat 4: 22b1f4df showed [Ks Qc] and won ($0.24) with a pair of Sevens
Seat 5: d97bce4f folded before Flop (didn't bet)
Seat 6: 14ed52c2 folded before Flop (didn't bet)


Poker Hand #RC3795975095: Hold'em No Limit ($0.02/$0.05) - 2025/08/10 08:48:21
Table 'RushAndCash11070355' 6-max Seat #1 is the button
Seat 1: 62cfb04e ($5.11 in chips)
Seat 2: Hero ($4.35 in chips)
Seat 3: bf4e2b6b ($22.13 in chips)
Seat 4: e557ac81 ($5.1 in chips)
Seat 5: 98c7e0e9 ($4.39 in chips)
Seat 6: 80630135 ($7.2 in chips)
Hero: posts small blind $0.02
bf4e2b6b: posts big blind $0.05
*** HOLE CARDS ***
Dealt to 62cfb04e 
Dealt to Hero [2h 6c]
Dealt to bf4e2b6b 
Dealt to e557ac81 
Dealt to 98c7e0e9 
Dealt to 80630135 
e557ac81: raises $0.05 to $0.1
98c7e0e9: folds
80630135: folds
62cfb04e: folds
Hero: folds
bf4e2b6b: folds
Uncalled bet ($0.05) returned to e557ac81
*** SHOWDOWN ***
e557ac81 collected $0.12 from pot
*** SUMMARY ***
Total pot $0.12 | Rake $0 | Jackpot $0 | Bingo $0 | Fortune $0 | Tax $0
Seat 1: 62cfb04e (button) folded before Flop (didn't bet)
Seat 2: Hero (small blind) folded before Flop
Seat 3: bf4e2b6b (big blind) folded before Flop
Seat 4: e557ac81 collected ($0.12)
Seat 5: 98c7e0e9 folded before Flop (didn't bet)
Seat 6: 80630135 folded before Flop (didn't bet)


Poker Hand #RC3795975083: Hold'em No Limit ($0.02/$0.05) - 2025/08/10 08:48:18
Table 'RushAndCash11070343' 6-max Seat #1 is the button
Seat 1: 1a36daf0 ($5 in chips)
Seat 2: d4249213 ($4.81 in chips)
Seat 3: d466ce85 ($7.45 in chips)
Seat 4: Hero ($4.35 in chips)
Seat 5: 12c12804 ($16.59 in chips)
Seat 6: 6487a64d ($10.83 in chips)
d4249213: posts small blind $0.02
d466ce85: posts big blind $0.05
*** HOLE CARDS ***
Dealt to 1a36daf0 
Dealt to d4249213 
Dealt to d466ce85 
Dealt to Hero [4s 9d]
Dealt to 12c12804 
Dealt to 6487a64d 
Hero: folds
12c12804: folds
6487a64d: folds
1a36daf0: folds
d4249213: folds
Uncalled bet ($0.03) returned to d466ce85
*** SHOWDOWN ***
d466ce85 collected $0.04 from pot
*** SUMMARY ***
Total pot $0.04 | Rake $0 | Jackpot $0 | Bingo $0 | Fortune $0 | Tax $0
Seat 1: 1a36daf0 (button) folded before Flop (didn't bet)
Seat 2: d4249213 (small blind) folded before Flop
Seat 3: d466ce85 (big blind) collected ($0.04)
Seat 4: Hero folded before Flop (didn't bet)
Seat 5: 12c12804 folded before Flop (didn't bet)
Seat 6: 6487a64d folded before Flop (didn't bet)


Poker Hand #RC3795974999: Hold'em No Limit ($0.02/$0.05) - 2025/08/10 08:47:55
Table 'RushAndCash11070259' 6-max Seat #1 is the button
Seat 1: d4249213 ($4.93 in chips)
Seat 2: d6441c19 ($5.21 in chips)
Seat 3: Hero ($4.22 in chips)
Seat 4: 97f832bf ($12.38 in chips)
Seat 5: ac3a4080 ($5 in chips)
Seat 6: efc0d07f ($4.99 in chips)
d6441c19: posts small blind $0.02
Hero: posts big blind $0.05
*** HOLE CARDS ***
Dealt to d4249213 
Dealt to d6441c19 
Dealt to Hero [9d Ad]
Dealt to 97f832bf 
Dealt to ac3a4080 
Dealt to efc0d07f 
97f832bf: folds
ac3a4080: folds
efc0d07f: folds
d4249213: raises $0.07 to $0.12
d6441c19: folds
Hero: raises $0.28 to $0.4
d4249213: folds
Uncalled bet ($0.28) returned to Hero
*** SHOWDOWN ***
Hero collected $0.25 from pot
*** SUMMARY ***
Total pot $0.26 | Rake $0.01 | Jackpot $0 | Bingo $0 | Fortune $0 | Tax $0
Seat 1: d4249213 (button) folded before Flop
Seat 2: d6441c19 (small blind) folded before Flop
Seat 3: Hero (big blind) collected ($0.25)
Seat 4: 97f832bf folded before Flop (didn't bet)
Seat 5: ac3a4080 folded before Flop (didn't bet)
Seat 6: efc0d07f folded before Flop (didn't bet)


Poker Hand #RC3795974982: Hold'em No Limit ($0.02/$0.05) - 2025/08/10 08:47:51
Table 'RushAndCash11070242' 6-max Seat #1 is the button
Seat 1: 3d056bb0 ($10.18 in chips)
Seat 2: 41d49907 ($4.95 in chips)
Seat 3: 73869740 ($6.33 in chips)
Seat 4: c38047a5 ($5.64 in chips)
Seat 5: 953d580e ($5.25 in chips)
Seat 6: Hero ($4.22 in chips)
41d49907: posts small blind $0.02
73869740: posts big blind $0.05
*** HOLE CARDS ***
Dealt to 3d056bb0 
Dealt to 41d49907 
Dealt to 73869740 
Dealt to c38047a5 
Dealt to 953d580e 
Dealt to Hero [8s 5s]
c38047a5: folds
953d580e: folds
Hero: folds
3d056bb0: folds
41d49907: calls $0.03
73869740: checks
*** FLOP *** [8c 6d 3s]
41d49907: bets $0.05
73869740: calls $0.05
*** TURN *** [8c 6d 3s] [As]
41d49907: bets $0.1
73869740: folds
Uncalled bet ($0.1) returned to 41d49907
*** SHOWDOWN ***
41d49907 collected $0.19 from pot
*** SUMMARY ***
Total pot $0.2 | Rake $0.01 | Jackpot $0 | Bingo $0 | Fortune $0 | Tax $0
Board [8c 6d 3s As]
Seat 1: 3d056bb0 (button) folded before Flop (didn't bet)
Seat 2: 41d49907 (small blind) won ($0.19)
Seat 3: 73869740 (big blind) folded on the Turn
Seat 4: c38047a5 folded before Flop (didn't bet)
Seat 5: 953d580e folded before Flop (didn't bet)
Seat 6: Hero folded before Flop (didn't bet)


Poker Hand #RC3795974799: Hold'em No Limit ($0.02/$0.05) - 2025/08/10 08:47:05
Table 'RushAndCash11070059' 6-max Seat #1 is the button
Seat 1: 8cc1d162 ($5 in chips)
Seat 2: 1a36daf0 ($5.07 in chips)
Seat 3: 41ed372d ($5.58 in chips)
Seat 4: Hero ($4.92 in chips)
Seat 5: 93754e0d ($4.83 in chips)
Seat 6: 63124400 ($9.2 in chips)
1a36daf0: posts small blind $0.02
41ed372d: posts big blind $0.05
*** HOLE CARDS ***
Dealt to 8cc1d162 
Dealt to 1a36daf0 
Dealt to 41ed372d 
Dealt to Hero [Td 9d]
Dealt to 93754e0d 
Dealt to 63124400 
Hero: raises $0.05 to $0.1
93754e0d: folds
63124400: folds
8cc1d162: folds
1a36daf0: folds
41ed372d: calls $0.05
*** FLOP *** [Tc Kd Kc]
41ed372d: checks
Hero: checks
*** TURN *** [Tc Kd Kc] [5h]
41ed372d: bets $0.17
Hero: calls $0.17
*** RIVER *** [Tc Kd Kc 5h] [2h]
41ed372d: bets $0.43
Hero: calls $0.43
41ed372d: shows [5d 5s] (a full house, Fives full of Kings)
Hero: shows [Td 9d] (two pair, Kings and Tens)
*** SHOWDOWN ***
41ed372d collected $1.35 from pot
*** SUMMARY ***
Total pot $1.42 | Rake $0.07 | Jackpot $0 | Bingo $0 | Fortune $0 | Tax $0
Board [Tc Kd Kc 5h 2h]
Seat 1: 8cc1d162 (button) folded before Flop (didn't bet)
Seat 2: 1a36daf0 (small blind) folded before Flop
Seat 3: 41ed372d (big blind) showed [5d 5s] and won ($1.35) with a full house, Fives full of Kings
Seat 4: Hero showed [Td 9d] and lost with two pair, Kings and Tens
Seat 5: 93754e0d folded before Flop (didn't bet)
Seat 6: 63124400 folded before Flop (didn't bet)


Poker Hand #RC3795974783: Hold'em No Limit ($0.02/$0.05) - 2025/08/10 08:47:01
Table 'RushAndCash11070043' 6-max Seat #1 is the button
Seat 1: 697d1eaa ($5.3 in chips)
Seat 2: 63ea6254 ($4.59 in chips)
Seat 3: Hero ($4.97 in chips)
Seat 4: fd8ef7f7 ($5 in chips)
Seat 5: 66a574d1 ($5.64 in chips)
Seat 6: 1af7528e ($10.45 in chips)
63ea6254: posts small blind $0.02
Hero: posts big blind $0.05
*** HOLE CARDS ***
Dealt to 697d1eaa 
Dealt to 63ea6254 
Dealt to Hero [Jh 4d]
Dealt to fd8ef7f7 
Dealt to 66a574d1 
Dealt to 1af7528e 
fd8ef7f7: folds
66a574d1: folds
1af7528e: raises $0.1 to $0.15
697d1eaa: folds
63ea6254: calls $0.13
Hero: folds
*** FLOP *** [Qc 6d 2c]
63ea6254: bets $0.05
1af7528e: raises $0.15 to $0.2
63ea6254: raises $4.24 to $4.44 and is all-in
1af7528e: folds
Uncalled bet ($4.24) returned to 63ea6254
*** SHOWDOWN ***
63ea6254 collected $0.72 from pot
*** SUMMARY ***
Total pot $0.75 | Rake $0.03 | Jackpot $0 | Bingo $0 | Fortune $0 | Tax $0
Board [Qc 6d 2c]
Seat 1: 697d1eaa (button) folded before Flop (didn't bet)
Seat 2: 63ea6254 (small blind) won ($0.72)
Seat 3: Hero (big blind) folded before Flop
Seat 4: fd8ef7f7 folded before Flop (didn't bet)
Seat 5: 66a574d1 folded before Flop (didn't bet)
Seat 6: 1af7528e folded on the Flop


Poker Hand #RC3795934668: Hold'em No Limit ($0.02/$0.05) - 2025/08/10 08:46:31
Table 'RushAndCash11069928' 6-max Seat #1 is the button
Seat 1: 6df06218 ($7.35 in chips)
Seat 2: 55b6c449 ($6.48 in chips)
Seat 3: 8a484f1f ($13.81 in chips)
Seat 4: Hero ($4.86 in chips)
Seat 5: 50f9d2cc ($5 in chips)
Seat 6: 770bebf2 ($5.07 in chips)
55b6c449: posts small blind $0.02
8a484f1f: posts big blind $0.05
*** HOLE CARDS ***
Dealt to 6df06218 
Dealt to 55b6c449 
Dealt to 8a484f1f 
Dealt to Hero [Qd 9d]
Dealt to 50f9d2cc 
Dealt to 770bebf2 
Hero: raises $0.05 to $0.1
50f9d2cc: folds
770bebf2: folds
6df06218: folds
55b6c449: folds
8a484f1f: calls $0.05
*** FLOP *** [Kd 4c Qc]
8a484f1f: checks
Hero: bets $0.07
8a484f1f: folds
Uncalled bet ($0.07) returned to Hero
*** SHOWDOWN ***
Hero collected $0.21 from pot
*** SUMMARY ***
Total pot $0.22 | Rake $0.01 | Jackpot $0 | Bingo $0 | Fortune $0 | Tax $0
Board [Kd 4c Qc]
Seat 1: 6df06218 (button) folded before Flop (didn't bet)
Seat 2: 55b6c449 (small blind) folded before Flop
Seat 3: 8a484f1f (big blind) folded on the Flop
Seat 4: Hero won ($0.21)
Seat 5: 50f9d2cc folded before Flop (didn't bet)
Seat 6: 770bebf2 folded before Flop (didn't bet)


Poker Hand #RC3795934656: Hold'em No Limit ($0.02/$0.05) - 2025/08/10 08:46:27
Table 'RushAndCash11069916' 6-max Seat #1 is the button
Seat 1: 7fbe4590 ($5.08 in chips)
Seat 2: bbb8a565 ($5 in chips)
Seat 3: 14ed52c2 ($3.98 in chips)
Seat 4: f1d249e2 ($7.37 in chips)
Seat 5: 50f9d2cc ($5 in chips)
Seat 6: Hero ($4.86 in chips)
bbb8a565: posts small blind $0.02
14ed52c2: posts big blind $0.05
*** HOLE CARDS ***
Dealt to 7fbe4590 
Dealt to bbb8a565 
Dealt to 14ed52c2 
Dealt to f1d249e2 
Dealt to 50f9d2cc 
Dealt to Hero [Th 9s]
f1d249e2: raises $0.05 to $0.1
50f9d2cc: folds
Hero: folds
7fbe4590: calls $0.1
bbb8a565: raises $0.58 to $0.68
14ed52c2: folds
f1d249e2: folds
7fbe4590: folds
Uncalled bet ($0.58) returned to bbb8a565
*** SHOWDOWN ***
bbb8a565 collected $0.34 from pot
*** SUMMARY ***
Total pot $0.35 | Rake $0.01 | Jackpot $0 | Bingo $0 | Fortune $0 | Tax $0
Seat 1: 7fbe4590 (button) folded before Flop
Seat 2: bbb8a565 (small blind) collected ($0.34)
Seat 3: 14ed52c2 (big blind) folded before Flop
Seat 4: f1d249e2 folded before Flop
Seat 5: 50f9d2cc folded before Flop (didn't bet)
Seat 6: Hero folded before Flop (didn't bet)


Poker Hand #RC3795934615: Hold'em No Limit ($0.02/$0.05) - 2025/08/10 08:46:17
Table 'RushAndCash11069875' 6-max Seat #1 is the button
Seat 1: Hero ($4.86 in chips)
Seat 2: b741ffcb ($5 in chips)
Seat 3: 7b333922 ($3 in chips)
Seat 4: ddf6b2fd ($5.06 in chips)
Seat 5: db3d7016 ($5 in chips)
Seat 6: 43f64b9b ($5.71 in chips)
b741ffcb: posts small blind $0.02
7b333922: posts big blind $0.05
*** HOLE CARDS ***
Dealt to Hero [5h 8c]
Dealt to b741ffcb 
Dealt to 7b333922 
Dealt to ddf6b2fd 
Dealt to db3d7016 
Dealt to 43f64b9b 
ddf6b2fd: raises $0.05 to $0.1
db3d7016: folds
43f64b9b: folds
Hero: folds
b741ffcb: folds
7b333922: calls $0.05
*** FLOP *** [Td Ks 2c]
7b333922: checks
ddf6b2fd: bets $0.11
7b333922: folds
Uncalled bet ($0.11) returned to ddf6b2fd
*** SHOWDOWN ***
ddf6b2fd collected $0.21 from pot
*** SUMMARY ***
Total pot $0.22 | Rake $0.01 | Jackpot $0 | Bingo $0 | Fortune $0 | Tax $0
Board [Td Ks 2c]
Seat 1: Hero (button) folded before Flop (didn't bet)
Seat 2: b741ffcb (small blind) folded before Flop
Seat 3: 7b333922 (big blind) folded on the Flop
Seat 4: ddf6b2fd won ($0.21)
Seat 5: db3d7016 folded before Flop (didn't bet)
Seat 6: 43f64b9b folded before Flop (didn't bet)


Poker Hand #RC3795934579: Hold'em No Limit ($0.02/$0.05) - 2025/08/10 08:46:05
Table 'RushAndCash11069839' 6-max Seat #1 is the button
Seat 1: e416125e ($11.88 in chips)
Seat 2: Hero ($4.88 in chips)
Seat 3: a4b58f11 ($9.88 in chips)
Seat 4: 848c5954 ($5.55 in chips)
Seat 5: 85e4ce3a ($19.21 in chips)
Seat 6: 94ff3239 ($5.11 in chips)
Hero: posts small blind $0.02
a4b58f11: posts big blind $0.05
*** HOLE CARDS ***
Dealt to e416125e 
Dealt to Hero [Qh 6d]
Dealt to a4b58f11 
Dealt to 848c5954 
Dealt to 85e4ce3a 
Dealt to 94ff3239 
848c5954: raises $0.05 to $0.1
85e4ce3a: folds
94ff3239: folds
e416125e: folds
Hero: folds
a4b58f11: folds
Uncalled bet ($0.05) returned to 848c5954
*** SHOWDOWN ***
848c5954 collected $0.12 from pot
*** SUMMARY ***
Total pot $0.12 | Rake $0 | Jackpot $0 | Bingo $0 | Fortune $0 | Tax $0
Seat 1: e416125e (button) folded before Flop (didn't bet)
Seat 2: Hero (small blind) folded before Flop
Seat 3: a4b58f11 (big blind) folded before Flop
Seat 4: 848c5954 collected ($0.12)
Seat 5: 85e4ce3a folded before Flop (didn't bet)
Seat 6: 94ff3239 folded before Flop (didn't bet)


Poker Hand #RC3795934563: Hold'em No Limit ($0.02/$0.05) - 2025/08/10 08:46:00
Table 'RushAndCash11069823' 6-max Seat #1 is the button
Seat 1: 808de8ec ($2.8 in chips)
Seat 2: b741ffcb ($5 in chips)
Seat 3: e4727e9b ($5.17 in chips)
Seat 4: Hero ($4.88 in chips)
Seat 5: c832e941 ($10.68 in chips)
Seat 6: 52c49e29 ($23.41 in chips)
b741ffcb: posts small blind $0.02
e4727e9b: posts big blind $0.05
*** HOLE CARDS ***
Dealt to 808de8ec 
Dealt to b741ffcb 
Dealt to e4727e9b 
Dealt to Hero [Tc Ah]
Dealt to c832e941 
Dealt to 52c49e29 
Hero: folds
c832e941: folds
52c49e29: folds
808de8ec: folds
b741ffcb: folds
Uncalled bet ($0.03) returned to e4727e9b
*** SHOWDOWN ***
e4727e9b collected $0.04 from pot
*** SUMMARY ***
Total pot $0.04 | Rake $0 | Jackpot $0 | Bingo $0 | Fortune $0 | Tax $0
Seat 1: 808de8ec (button) folded before Flop (didn't bet)
Seat 2: b741ffcb (small blind) folded before Flop
Seat 3: e4727e9b (big blind) collected ($0.04)
Seat 4: Hero folded before Flop (didn't bet)
Seat 5: c832e941 folded before Flop (didn't bet)
Seat 6: 52c49e29 folded before Flop (didn't bet)


Poker Hand #RC3795934550: Hold'em No Limit ($0.02/$0.05) - 2025/08/10 08:45:56
Table 'RushAndCash11069810' 6-max Seat #1 is the button
Seat 1: e4727e9b ($5.17 in chips)
Seat 2: efc0d07f ($4.98 in chips)
Seat 3: 65914450 ($19.15 in chips)
Seat 4: 12a544c1 ($5.48 in chips)
Seat 5: Hero ($4.88 in chips)
Seat 6: ed99f05f ($7.1 in chips)
efc0d07f: posts small blind $0.02
65914450: posts big blind $0.05
*** HOLE CARDS ***
Dealt to e4727e9b 
Dealt to efc0d07f 
Dealt to 65914450 
Dealt to 12a544c1 
Dealt to Hero [Th 5d]
Dealt to ed99f05f 
12a544c1: raises $0.06 to $0.11
Hero: folds
ed99f05f: folds
e4727e9b: folds
efc0d07f: folds
65914450: raises $0.24 to $0.35
12a544c1: folds
Uncalled bet ($0.24) returned to 65914450
*** SHOWDOWN ***
65914450 collected $0.23 from pot
*** SUMMARY ***
Total pot $0.24 | Rake $0.01 | Jackpot $0 | Bingo $0 | Fortune $0 | Tax $0
Seat 1: e4727e9b (button) folded before Flop (didn't bet)
Seat 2: efc0d07f (small blind) folded before Flop
Seat 3: 65914450 (big blind) collected ($0.23)
Seat 4: 12a544c1 folded before Flop
Seat 5: Hero folded before Flop (didn't bet)
Seat 6: ed99f05f folded before Flop (didn't bet)


Poker Hand #RC3795934529: Hold'em No Limit ($0.02/$0.05) - 2025/08/10 08:45:51
Table 'RushAndCash11069789' 6-max Seat #1 is the button
Seat 1: 86d57974 ($5.02 in chips)
Seat 2: cd3b199 ($5.02 in chips)
Seat 3: ec2068d4 ($5.23 in chips)
Seat 4: 2c53d2c7 ($6.19 in chips)
Seat 5: f3b2c7e8 ($10.2 in chips)
Seat 6: Hero ($4.88 in chips)
cd3b199: posts small blind $0.02
ec2068d4: posts big blind $0.05
*** HOLE CARDS ***
Dealt to 86d57974 
Dealt to cd3b199 
Dealt to ec2068d4 
Dealt to 2c53d2c7 
Dealt to f3b2c7e8 
Dealt to Hero [Ks 9d]
2c53d2c7: raises $0.07 to $0.12
f3b2c7e8: folds
Hero: folds
86d57974: folds
cd3b199: folds
ec2068d4: folds
Uncalled bet ($0.07) returned to 2c53d2c7
*** SHOWDOWN ***
2c53d2c7 collected $0.12 from pot
*** SUMMARY ***
Total pot $0.12 | Rake $0 | Jackpot $0 | Bingo $0 | Fortune $0 | Tax $0
Seat 1: 86d57974 (button) folded before Flop (didn't bet)
Seat 2: cd3b199 (small blind) folded before Flop
Seat 3: ec2068d4 (big blind) folded before Flop
Seat 4: 2c53d2c7 collected ($0.12)
Seat 5: f3b2c7e8 folded before Flop (didn't bet)
Seat 6: Hero folded before Flop (didn't bet)


Poker Hand #RC3795934492: Hold'em No Limit ($0.02/$0.05) - 2025/08/10 08:45:40
Table 'RushAndCash11069752' 6-max Seat #1 is the button
Seat 1: 15c880d8 ($5 in chips)
Seat 2: Hero ($4.9 in chips)
Seat 3: 7bd4810f ($5 in chips)
Seat 4: 453d8970 ($6.18 in chips)
Seat 5: efc0d07f ($4.96 in chips)
Seat 6: 196a508f ($13.41 in chips)
Hero: posts small blind $0.02
7bd4810f: posts big blind $0.05
*** HOLE CARDS ***
Dealt to 15c880d8 
Dealt to Hero [9h 3c]
Dealt to 7bd4810f 
Dealt to 453d8970 
Dealt to efc0d07f 
Dealt to 196a508f 
453d8970: folds
efc0d07f: folds
196a508f: folds
15c880d8: folds
Hero: folds
Uncalled bet ($0.03) returned to 7bd4810f
*** SHOWDOWN ***
7bd4810f collected $0.04 from pot
*** SUMMARY ***
Total pot $0.04 | Rake $0 | Jackpot $0 | Bingo $0 | Fortune $0 | Tax $0
Seat 1: 15c880d8 (button) folded before Flop (didn't bet)
Seat 2: Hero (small blind) folded before Flop
Seat 3: 7bd4810f (big blind) collected ($0.04)
Seat 4: 453d8970 folded before Flop (didn't bet)
Seat 5: efc0d07f folded before Flop (didn't bet)
Seat 6: 196a508f folded before Flop (didn't bet)


Poker Hand #RC3795934334: Hold'em No Limit ($0.02/$0.05) - 2025/08/10 08:44:53
Table 'RushAndCash11069594' 6-max Seat #1 is the button
Seat 1: 14ed52c2 ($4.83 in chips)
Seat 2: 15c880d8 ($5 in chips)
Seat 3: 18b1ecd7 ($8.23 in chips)
Seat 4: 35c42e8c ($7.62 in chips)
Seat 5: Hero ($4.49 in chips)
Seat 6: a7ec82a1 ($5 in chips)
15c880d8: posts small blind $0.02
18b1ecd7: posts big blind $0.05
*** HOLE CARDS ***
Dealt to 14ed52c2 
Dealt to 15c880d8 
Dealt to 18b1ecd7 
Dealt to 35c42e8c 
Dealt to Hero [Qh 9h]
Dealt to a7ec82a1 
35c42e8c: folds
Hero: raises $0.05 to $0.1
a7ec82a1: folds
14ed52c2: folds
15c880d8: raises $0.3 to $0.4
18b1ecd7: folds
Hero: calls $0.3
*** FLOP *** [Kc Qd 2c]
15c880d8: checks
Hero: checks
*** TURN *** [Kc Qd 2c] [8s]
15c880d8: checks
Hero: checks
*** RIVER *** [Kc Qd 2c 8s] [8d]
15c880d8: checks
Hero: checks
15c880d8: shows [Jd Jc] (two pair, Jacks and Eights)
Hero: shows [Qh 9h] (two pair, Queens and Eights)
*** SHOWDOWN ***
Hero collected $0.81 from pot
*** SUMMARY ***
Total pot $0.85 | Rake $0.04 | Jackpot $0 | Bingo $0 | Fortune $0 | Tax $0
Board [Kc Qd 2c 8s 8d]
Seat 1: 14ed52c2 (button) folded before Flop (didn't bet)
Seat 2: 15c880d8 (small blind) showed [Jd Jc] and lost with two pair, Jacks and Eights
Seat 3: 18b1ecd7 (big blind) folded before Flop
Seat 4: 35c42e8c folded before Flop (didn't bet)
Seat 5: Hero showed [Qh 9h] and won ($0.81) with two pair, Queens and Eights
Seat 6: a7ec82a1 folded before Flop (didn't bet)


Poker Hand #RC3795934202: Hold'em No Limit ($0.02/$0.05) - 2025/08/10 08:44:13
Table 'RushAndCash11069462' 6-max Seat #1 is the button
Seat 1: b3eab32a ($5 in chips)
Seat 2: 902f8c64 ($7.45 in chips)
Seat 3: Hero ($4.61 in chips)
Seat 4: 35c42e8c ($7.49 in chips)
Seat 5: 630dda79 ($5.16 in chips)
Seat 6: 697d1eaa ($5.36 in chips)
902f8c64: posts small blind $0.02
Hero: posts big blind $0.05
*** HOLE CARDS ***
Dealt to b3eab32a 
Dealt to 902f8c64 
Dealt to Hero [Js Tc]
Dealt to 35c42e8c 
Dealt to 630dda79 
Dealt to 697d1eaa 
35c42e8c: raises $0.07 to $0.12
630dda79: folds
697d1eaa: folds
b3eab32a: folds
902f8c64: folds
Hero: calls $0.07
*** FLOP *** [5c Qd 3h]
Hero: checks
35c42e8c: bets $0.09
Hero: folds
Uncalled bet ($0.09) returned to 35c42e8c
*** SHOWDOWN ***
35c42e8c collected $0.25 from pot
*** SUMMARY ***
Total pot $0.26 | Rake $0.01 | Jackpot $0 | Bingo $0 | Fortune $0 | Tax $0
Board [5c Qd 3h]
Seat 1: b3eab32a (button) folded before Flop (didn't bet)
Seat 2: 902f8c64 (small blind) folded before Flop
Seat 3: Hero (big blind) folded on the Flop
Seat 4: 35c42e8c won ($0.25)
Seat 5: 630dda79 folded before Flop (didn't bet)
Seat 6: 697d1eaa folded before Flop (didn't bet)


Poker Hand #RC3795934118: Hold'em No Limit ($0.02/$0.05) - 2025/08/10 08:43:47
Table 'RushAndCash11069378' 6-max Seat #1 is the button
Seat 1: 18b1ecd7 ($8.35 in chips)
Seat 2: 54cd1b65 ($9.73 in chips)
Seat 3: 9daec63f ($4.38 in chips)
Seat 4: cf3b419d ($5 in chips)
Seat 5: 630dda79 ($5 in chips)
Seat 6: Hero ($4.71 in chips)
54cd1b65: posts small blind $0.02
9daec63f: posts big blind $0.05
*** HOLE CARDS ***
Dealt to 18b1ecd7 
Dealt to 54cd1b65 
Dealt to 9daec63f 
Dealt to cf3b419d 
Dealt to 630dda79 
Dealt to Hero [Ts Js]
cf3b419d: folds
630dda79: raises $0.05 to $0.1
Hero: calls $0.1
18b1ecd7: folds
54cd1b65: folds
9daec63f: folds
*** FLOP *** [Qh 2d 7h]
630dda79: bets $0.21
Hero: folds
Uncalled bet ($0.21) returned to 630dda79
*** SHOWDOWN ***
630dda79 collected $0.26 from pot
*** SUMMARY ***
Total pot $0.27 | Rake $0.01 | Jackpot $0 | Bingo $0 | Fortune $0 | Tax $0
Board [Qh 2d 7h]
Seat 1: 18b1ecd7 (button) folded before Flop (didn't bet)
Seat 2: 54cd1b65 (small blind) folded before Flop
Seat 3: 9daec63f (big blind) folded before Flop
Seat 4: cf3b419d folded before Flop (didn't bet)
Seat 5: 630dda79 won ($0.26)
Seat 6: Hero folded on the Flop


Poker Hand #RC3795934080: Hold'em No Limit ($0.02/$0.05) - 2025/08/10 08:43:36
Table 'RushAndCash11069340' 6-max Seat #1 is the button
Seat 1: Hero ($4.71 in chips)
Seat 2: b00a0b81 ($1.75 in chips)
Seat 3: e495c6b6 ($5.61 in chips)
Seat 4: 73869740 ($6.26 in chips)
Seat 5: a9ba79a ($1.27 in chips)
Seat 6: bcd5617c ($6.05 in chips)
b00a0b81: posts small blind $0.02
e495c6b6: posts big blind $0.05
*** HOLE CARDS ***
Dealt to Hero [Qs 2d]
Dealt to b00a0b81 
Dealt to e495c6b6 
Dealt to 73869740 
Dealt to a9ba79a 
Dealt to bcd5617c 
73869740: folds
a9ba79a: folds
bcd5617c: raises $0.05 to $0.1
Hero: folds
b00a0b81: folds
e495c6b6: calls $0.05
*** FLOP *** [8h 6d Jc]
e495c6b6: checks
bcd5617c: checks
*** TURN *** [8h 6d Jc] [Qd]
e495c6b6: checks
bcd5617c: checks
*** RIVER *** [8h 6d Jc Qd] [7d]
e495c6b6: bets $0.17
bcd5617c: folds
Uncalled bet ($0.17) returned to e495c6b6
*** SHOWDOWN ***
e495c6b6 collected $0.21 from pot
*** SUMMARY ***
Total pot $0.22 | Rake $0.01 | Jackpot $0 | Bingo $0 | Fortune $0 | Tax $0
Board [8h 6d Jc Qd 7d]
Seat 1: Hero (button) folded before Flop (didn't bet)
Seat 2: b00a0b81 (small blind) folded before Flop
Seat 3: e495c6b6 (big blind) won ($0.21)
Seat 4: 73869740 folded before Flop (didn't bet)
Seat 5: a9ba79a folded before Flop (didn't bet)
Seat 6: bcd5617c folded on the River


Poker Hand #RC3795933890: Hold'em No Limit ($0.02/$0.05) - 2025/08/10 08:42:40
Table 'RushAndCash11069150' 6-max Seat #1 is the button
Seat 1: bcd5617c ($5.5 in chips)
Seat 2: ab33e85c ($3.59 in chips)
Seat 3: b1b3930a ($5.6 in chips)
Seat 4: 9c4a9c5b ($6.5 in chips)
Seat 5: fccf4928 ($12.58 in chips)
Seat 6: Hero ($5.24 in chips)
ab33e85c: posts small blind $0.02
b1b3930a: posts big blind $0.05
*** HOLE CARDS ***
Dealt to bcd5617c 
Dealt to ab33e85c 
Dealt to b1b3930a 
Dealt to 9c4a9c5b 
Dealt to fccf4928 
Dealt to Hero [7d 7c]
9c4a9c5b: folds
fccf4928: folds
Hero: raises $0.05 to $0.1
bcd5617c: raises $0.21 to $0.31
ab33e85c: folds
b1b3930a: folds
Hero: calls $0.21
*** FLOP *** [5d 8d 2s]
Hero: checks
bcd5617c: checks
*** TURN *** [5d 8d 2s] [As]
Hero: bets $0.22
bcd5617c: raises $0.57 to $0.79
Hero: folds
Uncalled bet ($0.57) returned to bcd5617c
*** SHOWDOWN ***
bcd5617c collected $1.08 from pot
*** SUMMARY ***
Total pot $1.13 | Rake $0.05 | Jackpot $0 | Bingo $0 | Fortune $0 | Tax $0
Board [5d 8d 2s As]
Seat 1: bcd5617c (button) won ($1.08)
Seat 2: ab33e85c (small blind) folded before Flop
Seat 3: b1b3930a (big blind) folded before Flop
Seat 4: 9c4a9c5b folded before Flop (didn't bet)
Seat 5: fccf4928 folded before Flop (didn't bet)
Seat 6: Hero folded on the Turn


Poker Hand #RC3795933876: Hold'em No Limit ($0.02/$0.05) - 2025/08/10 08:42:37
Table 'RushAndCash11069136' 6-max Seat #1 is the button
Seat 1: 12c12804 ($16.11 in chips)
Seat 2: bc911417 ($11.56 in chips)
Seat 3: 560bbe0d ($13.75 in chips)
Seat 4: d6378e6 ($6.42 in chips)
Seat 5: 9095f6a6 ($5.09 in chips)
Seat 6: Hero ($5.24 in chips)
bc911417: posts small blind $0.02
560bbe0d: posts big blind $0.05
*** HOLE CARDS ***
Dealt to 12c12804 
Dealt to bc911417 
Dealt to 560bbe0d 
Dealt to d6378e6 
Dealt to 9095f6a6 
Dealt to Hero [5h Jh]
d6378e6: folds
9095f6a6: folds
Hero: folds
12c12804: folds
bc911417: raises $0.05 to $0.1
560bbe0d: folds
Uncalled bet ($0.05) returned to bc911417
*** SHOWDOWN ***
bc911417 collected $0.1 from pot
*** SUMMARY ***
Total pot $0.1 | Rake $0 | Jackpot $0 | Bingo $0 | Fortune $0 | Tax $0
Seat 1: 12c12804 (button) folded before Flop (didn't bet)
Seat 2: bc911417 (small blind) collected ($0.1)
Seat 3: 560bbe0d (big blind) folded before Flop
Seat 4: d6378e6 folded before Flop (didn't bet)
Seat 5: 9095f6a6 folded before Flop (didn't bet)
Seat 6: Hero folded before Flop (didn't bet)


Poker Hand #RC3795933774: Hold'em No Limit ($0.02/$0.05) - 2025/08/10 08:42:07
Table 'RushAndCash11069034' 6-max Seat #1 is the button
Seat 1: ccbf95f3 ($9.72 in chips)
Seat 2: 560bbe0d ($13.63 in chips)
Seat 3: Hero ($5.37 in chips)
Seat 4: d5bb3acb ($2.39 in chips)
Seat 5: f1d249e2 ($7.59 in chips)
Seat 6: 91b024bc ($10.79 in chips)
560bbe0d: posts small blind $0.02
Hero: posts big blind $0.05
*** HOLE CARDS ***
Dealt to ccbf95f3 
Dealt to 560bbe0d 
Dealt to Hero [6h Ac]
Dealt to d5bb3acb 
Dealt to f1d249e2 
Dealt to 91b024bc 
d5bb3acb: folds
f1d249e2: folds
91b024bc: folds
ccbf95f3: folds
560bbe0d: raises $0.08 to $0.13
Hero: calls $0.08
*** FLOP *** [Ks 7s Kh]
560bbe0d: checks
Hero: checks
*** TURN *** [Ks 7s Kh] [Js]
560bbe0d: bets $0.2
Hero: folds
Uncalled bet ($0.2) returned to 560bbe0d
*** SHOWDOWN ***
560bbe0d collected $0.25 from pot
*** SUMMARY ***
Total pot $0.26 | Rake $0.01 | Jackpot $0 | Bingo $0 | Fortune $0 | Tax $0
Board [Ks 7s Kh Js]
Seat 1: ccbf95f3 (button) folded before Flop (didn't bet)
Seat 2: 560bbe0d (small blind) won ($0.25)
Seat 3: Hero (big blind) folded on the Turn
Seat 4: d5bb3acb folded before Flop (didn't bet)
Seat 5: f1d249e2 folded before Flop (didn't bet)
Seat 6: 91b024bc folded before Flop (didn't bet)


Poker Hand #RC3795933739: Hold'em No Limit ($0.02/$0.05) - 2025/08/10 08:41:59
Table 'RushAndCash11068999' 6-max Seat #1 is the button
Seat 1: 9ae53275 ($5.49 in chips)
Seat 2: Hero ($5.39 in chips)
Seat 3: a62ee896 ($5.12 in chips)
Seat 4: c4ed83bc ($4.63 in chips)
Seat 5: d89f942b ($5.09 in chips)
Seat 6: 9d70d038 ($13.17 in chips)
Hero: posts small blind $0.02
a62ee896: posts big blind $0.05
*** HOLE CARDS ***
Dealt to 9ae53275 
Dealt to Hero [As 2c]
Dealt to a62ee896 
Dealt to c4ed83bc 
Dealt to d89f942b 
Dealt to 9d70d038 
c4ed83bc: raises $0.09 to $0.14
d89f942b: folds
9d70d038: folds
9ae53275: folds
Hero: folds
a62ee896: folds
Uncalled bet ($0.09) returned to c4ed83bc
*** SHOWDOWN ***
c4ed83bc collected $0.12 from pot
*** SUMMARY ***
Total pot $0.12 | Rake $0 | Jackpot $0 | Bingo $0 | Fortune $0 | Tax $0
Seat 1: 9ae53275 (button) folded before Flop (didn't bet)
Seat 2: Hero (small blind) folded before Flop
Seat 3: a62ee896 (big blind) folded before Flop
Seat 4: c4ed83bc collected ($0.12)
Seat 5: d89f942b folded before Flop (didn't bet)
Seat 6: 9d70d038 folded before Flop (didn't bet)


Poker Hand #RC3795933700: Hold'em No Limit ($0.02/$0.05) - 2025/08/10 08:41:49
Table 'RushAndCash11068960' 6-max Seat #1 is the button
Seat 1: 138096db ($5 in chips)
Seat 2: 9d70d038 ($13.19 in chips)
Seat 3: Hero ($5.44 in chips)
Seat 4: 8f2169c9 ($3.73 in chips)
Seat 5: ac25def9 ($6.03 in chips)
Seat 6: af0721f5 ($7.28 in chips)
9d70d038: posts small blind $0.02
Hero: posts big blind $0.05
*** HOLE CARDS ***
Dealt to 138096db 
Dealt to 9d70d038 
Dealt to Hero [Kd 9h]
Dealt to 8f2169c9 
Dealt to ac25def9 
Dealt to af0721f5 
8f2169c9: folds
ac25def9: folds
af0721f5: raises $0.08 to $0.13
138096db: folds
9d70d038: folds
Hero: folds
Uncalled bet ($0.08) returned to af0721f5
*** SHOWDOWN ***
af0721f5 collected $0.12 from pot
*** SUMMARY ***
Total pot $0.12 | Rake $0 | Jackpot $0 | Bingo $0 | Fortune $0 | Tax $0
Seat 1: 138096db (button) folded before Flop (didn't bet)
Seat 2: 9d70d038 (small blind) folded before Flop
Seat 3: Hero (big blind) folded before Flop
Seat 4: 8f2169c9 folded before Flop (didn't bet)
Seat 5: ac25def9 folded before Flop (didn't bet)
Seat 6: af0721f5 collected ($0.12)


Poker Hand #RC3795933689: Hold'em No Limit ($0.02/$0.05) - 2025/08/10 08:41:46
Table 'RushAndCash11068949' 6-max Seat #1 is the button
Seat 1: Hero ($5.44 in chips)
Seat 2: 97f832bf ($12.7 in chips)
Seat 3: cd7dffc4 ($5 in chips)
Seat 4: 4844e57f ($6.58 in chips)
Seat 5: 1d9a9697 ($5.69 in chips)
Seat 6: fd4f7f89 ($5.23 in chips)
97f832bf: posts small blind $0.02
cd7dffc4: posts big blind $0.05
*** HOLE CARDS ***
Dealt to Hero [3s 6h]
Dealt to 97f832bf 
Dealt to cd7dffc4 
Dealt to 4844e57f 
Dealt to 1d9a9697 
Dealt to fd4f7f89 
4844e57f: folds
1d9a9697: folds
fd4f7f89: folds
Hero: folds
97f832bf: folds
Uncalled bet ($0.03) returned to cd7dffc4
*** SHOWDOWN ***
cd7dffc4 collected $0.04 from pot
*** SUMMARY ***
Total pot $0.04 | Rake $0 | Jackpot $0 | Bingo $0 | Fortune $0 | Tax $0
Seat 1: Hero (button) folded before Flop (didn't bet)
Seat 2: 97f832bf (small blind) folded before Flop
Seat 3: cd7dffc4 (big blind) collected ($0.04)
Seat 4: 4844e57f folded before Flop (didn't bet)
Seat 5: 1d9a9697 folded before Flop (didn't bet)
Seat 6: fd4f7f89 folded before Flop (didn't bet)


Poker Hand #RC3795933668: Hold'em No Limit ($0.02/$0.05) - 2025/08/10 08:41:41
Table 'RushAndCash11068928' 6-max Seat #1 is the button
Seat 1: Hero ($5.44 in chips)
Seat 2: cd7dffc4 ($5 in chips)
Seat 3: 8a484f1f ($12.91 in chips)
Seat 4: 6bfc0170 ($5.02 in chips)
Seat 5: cb83453e ($14.28 in chips)
Seat 6: 86d57974 ($5.21 in chips)
cd7dffc4: posts small blind $0.02
8a484f1f: posts big blind $0.05
*** HOLE CARDS ***
Dealt to Hero [Kh 7d]
Dealt to cd7dffc4 
Dealt to 8a484f1f 
Dealt to 6bfc0170 
Dealt to cb83453e 
Dealt to 86d57974 
6bfc0170: raises $0.05 to $0.1
cb83453e: folds
86d57974: folds
Hero: folds
cd7dffc4: folds
8a484f1f: calls $0.05
*** FLOP *** [2d 6d 8s]
8a484f1f: checks
6bfc0170: bets $0.05
8a484f1f: calls $0.05
*** TURN *** [2d 6d 8s] [Qs]
8a484f1f: checks
6bfc0170: bets $0.08
8a484f1f: raises $0.24 to $0.32
6bfc0170: folds
Uncalled bet ($0.24) returned to 8a484f1f
*** SHOWDOWN ***
8a484f1f collected $0.46 from pot
*** SUMMARY ***
Total pot $0.48 | Rake $0.02 | Jackpot $0 | Bingo $0 | Fortune $0 | Tax $0
Board [2d 6d 8s Qs]
Seat 1: Hero (button) folded before Flop (didn't bet)
Seat 2: cd7dffc4 (small blind) folded before Flop
Seat 3: 8a484f1f (big blind) won ($0.46)
Seat 4: 6bfc0170 folded on the Turn
Seat 5: cb83453e folded before Flop (didn't bet)
Seat 6: 86d57974 folded before Flop (didn't bet)


Poker Hand #RC3795933655: Hold'em No Limit ($0.02/$0.05) - 2025/08/10 08:41:37
Table 'RushAndCash11068915' 6-max Seat #1 is the button
Seat 1: 33f8d3d1 ($5 in chips)
Seat 2: fd4f7f89 ($5.25 in chips)
Seat 3: 87737f86 ($5.19 in chips)
Seat 4: 6bfc0170 ($5.02 in chips)
Seat 5: cb83453e ($14.28 in chips)
Seat 6: Hero ($5.44 in chips)
fd4f7f89: posts small blind $0.02
87737f86: posts big blind $0.05
*** HOLE CARDS ***
Dealt to 33f8d3d1 
Dealt to fd4f7f89 
Dealt to 87737f86 
Dealt to 6bfc0170 
Dealt to cb83453e 
Dealt to Hero [9d Ks]
6bfc0170: folds
cb83453e: folds
Hero: folds
33f8d3d1: raises $0.05 to $0.1
fd4f7f89: folds
87737f86: raises $0.28 to $0.38
33f8d3d1: folds
Uncalled bet ($0.28) returned to 87737f86
*** SHOWDOWN ***
87737f86 collected $0.21 from pot
*** SUMMARY ***
Total pot $0.22 | Rake $0.01 | Jackpot $0 | Bingo $0 | Fortune $0 | Tax $0
Seat 1: 33f8d3d1 (button) folded before Flop
Seat 2: fd4f7f89 (small blind) folded before Flop
Seat 3: 87737f86 (big blind) collected ($0.21)
Seat 4: 6bfc0170 folded before Flop (didn't bet)
Seat 5: cb83453e folded before Flop (didn't bet)
Seat 6: Hero folded before Flop (didn't bet)


Poker Hand #RC3795933597: Hold'em No Limit ($0.02/$0.05) - 2025/08/10 08:41:20
Table 'RushAndCash11068857' 6-max Seat #1 is the button
Seat 1: Hero ($5.37 in chips)
Seat 2: 1ceb153 ($4.95 in chips)
Seat 3: ca103bdd ($4.37 in chips)
Seat 4: 4a025b26 ($5.07 in chips)
Seat 5: d27c038b ($2.58 in chips)
Seat 6: d32d3acf ($5 in chips)
1ceb153: posts small blind $0.02
ca103bdd: posts big blind $0.05
*** HOLE CARDS ***
Dealt to Hero [Tc Ah]
Dealt to 1ceb153 
Dealt to ca103bdd 
Dealt to 4a025b26 
Dealt to d27c038b 
Dealt to d32d3acf 
4a025b26: folds
d27c038b: folds
d32d3acf: folds
Hero: raises $0.05 to $0.1
1ceb153: folds
ca103bdd: folds
Uncalled bet ($0.05) returned to Hero
*** SHOWDOWN ***
Hero collected $0.12 from pot
*** SUMMARY ***
Total pot $0.12 | Rake $0 | Jackpot $0 | Bingo $0 | Fortune $0 | Tax $0
Seat 1: Hero (button) collected ($0.12)
Seat 2: 1ceb153 (small blind) folded before Flop
Seat 3: ca103bdd (big blind) folded before Flop
Seat 4: 4a025b26 folded before Flop (didn't bet)
Seat 5: d27c038b folded before Flop (didn't bet)
Seat 6: d32d3acf folded before Flop (didn't bet)


Poker Hand #RC3795933552: Hold'em No Limit ($0.02/$0.05) - 2025/08/10 08:41:07
Table 'RushAndCash11068812' 6-max Seat #1 is the button
Seat 1: a187372 ($5.7 in chips)
Seat 2: Hero ($5.39 in chips)
Seat 3: f6bf8dfb ($11.23 in chips)
Seat 4: 7244fd77 ($5.36 in chips)
Seat 5: 8a484f1f ($12.86 in chips)
Seat 6: 7a09703 ($5.46 in chips)
Hero: posts small blind $0.02
f6bf8dfb: posts big blind $0.05
*** HOLE CARDS ***
Dealt to a187372 
Dealt to Hero [8d 5c]
Dealt to f6bf8dfb 
Dealt to 7244fd77 
Dealt to 8a484f1f 
Dealt to 7a09703 
7244fd77: folds
8a484f1f: folds
7a09703: raises $0.05 to $0.1
a187372: folds
Hero: folds
f6bf8dfb: folds
Uncalled bet ($0.05) returned to 7a09703
*** SHOWDOWN ***
7a09703 collected $0.12 from pot
*** SUMMARY ***
Total pot $0.12 | Rake $0 | Jackpot $0 | Bingo $0 | Fortune $0 | Tax $0
Seat 1: a187372 (button) folded before Flop (didn't bet)
Seat 2: Hero (small blind) folded before Flop
Seat 3: f6bf8dfb (big blind) folded before Flop
Seat 4: 7244fd77 folded before Flop (didn't bet)
Seat 5: 8a484f1f folded before Flop (didn't bet)
Seat 6: 7a09703 collected ($0.12)


Poker Hand #RC3795933536: Hold'em No Limit ($0.02/$0.05) - 2025/08/10 08:41:02
Table 'RushAndCash11068796' 6-max Seat #1 is the button
Seat 1: db591cd3 ($4.26 in chips)
Seat 2: 9ae53275 ($5.65 in chips)
Seat 3: 9e0c2202 ($12.34 in chips)
Seat 4: d62070dc ($4.65 in chips)
Seat 5: b2532ba1 ($7.75 in chips)
Seat 6: Hero ($5.39 in chips)
9ae53275: posts small blind $0.02
9e0c2202: posts big blind $0.05
*** HOLE CARDS ***
Dealt to db591cd3 
Dealt to 9ae53275 
Dealt to 9e0c2202 
Dealt to d62070dc 
Dealt to b2532ba1 
Dealt to Hero [8h 6c]
d62070dc: raises $0.05 to $0.1
b2532ba1: raises $0.22 to $0.32
Hero: folds
db591cd3: folds
9ae53275: folds
9e0c2202: folds
d62070dc: folds
Uncalled bet ($0.22) returned to b2532ba1
*** SHOWDOWN ***
b2532ba1 collected $0.26 from pot
*** SUMMARY ***
Total pot $0.27 | Rake $0.01 | Jackpot $0 | Bingo $0 | Fortune $0 | Tax $0
Seat 1: db591cd3 (button) folded before Flop (didn't bet)
Seat 2: 9ae53275 (small blind) folded before Flop
Seat 3: 9e0c2202 (big blind) folded before Flop
Seat 4: d62070dc folded before Flop
Seat 5: b2532ba1 collected ($0.26)
Seat 6: Hero folded before Flop (didn't bet)


Poker Hand #RC3795933523: Hold'em No Limit ($0.02/$0.05) - 2025/08/10 08:40:59
Table 'RushAndCash11068783' 6-max Seat #1 is the button
Seat 1: 630dda79 ($5 in chips)
Seat 2: 94ff3239 ($3.84 in chips)
Seat 3: 87737f86 ($5.24 in chips)
Seat 4: e59624ff ($4.93 in chips)
Seat 5: Hero ($5.39 in chips)
Seat 6: f330932 ($2.23 in chips)
94ff3239: posts small blind $0.02
87737f86: posts big blind $0.05
*** HOLE CARDS ***
Dealt to 630dda79 
Dealt to 94ff3239 
Dealt to 87737f86 
Dealt to e59624ff 
Dealt to Hero [8s Ks]
Dealt to f330932 
e59624ff: raises $0.05 to $0.1
Hero: folds
f330932: folds
630dda79: raises $0.36 to $0.46
94ff3239: folds
87737f86: folds
e59624ff: calls $0.36
*** FLOP *** [Td 9d Kc]
e59624ff: checks
630dda79: checks
*** TURN *** [Td 9d Kc] [7c]
e59624ff: checks
630dda79: checks
*** RIVER *** [Td 9d Kc 7c] [9h]
e59624ff: bets $0.33
630dda79: folds
Uncalled bet ($0.33) returned to e59624ff
*** SHOWDOWN ***
e59624ff collected $0.94 from pot
*** SUMMARY ***
Total pot $0.99 | Rake $0.05 | Jackpot $0 | Bingo $0 | Fortune $0 | Tax $0
Board [Td 9d Kc 7c 9h]
Seat 1: 630dda79 (button) folded on the River
Seat 2: 94ff3239 (small blind) folded before Flop
Seat 3: 87737f86 (big blind) folded before Flop
Seat 4: e59624ff won ($0.94)
Seat 5: Hero folded before Flop (didn't bet)
Seat 6: f330932 folded before Flop (didn't bet)


Poker Hand #RC3795933489: Hold'em No Limit ($0.02/$0.05) - 2025/08/10 08:40:48
Table 'RushAndCash11068749' 6-max Seat #1 is the button
Seat 1: 7d7b2f21 ($5.22 in chips)
Seat 2: 97f832bf ($12.72 in chips)
Seat 3: 3f5c4b90 ($7.36 in chips)
Seat 4: 7a09703 ($5.53 in chips)
Seat 5: Hero ($5.32 in chips)
Seat 6: 196a508f ($12.76 in chips)
97f832bf: posts small blind $0.02
3f5c4b90: posts big blind $0.05
*** HOLE CARDS ***
Dealt to 7d7b2f21 
Dealt to 97f832bf 
Dealt to 3f5c4b90 
Dealt to 7a09703 
Dealt to Hero [9h Qh]
Dealt to 196a508f 
7a09703: folds
Hero: raises $0.05 to $0.1
196a508f: folds
7d7b2f21: folds
97f832bf: folds
3f5c4b90: folds
Uncalled bet ($0.05) returned to Hero
*** SHOWDOWN ***
Hero collected $0.12 from pot
*** SUMMARY ***
Total pot $0.12 | Rake $0 | Jackpot $0 | Bingo $0 | Fortune $0 | Tax $0
Seat 1: 7d7b2f21 (button) folded before Flop (didn't bet)
Seat 2: 97f832bf (small blind) folded before Flop
Seat 3: 3f5c4b90 (big blind) folded before Flop
Seat 4: 7a09703 folded before Flop (didn't bet)
Seat 5: Hero collected ($0.12)
Seat 6: 196a508f folded before Flop (didn't bet)


Poker Hand #RC3795933473: Hold'em No Limit ($0.02/$0.05) - 2025/08/10 08:40:42
Table 'RushAndCash11068733' 6-max Seat #1 is the button
Seat 1: cf24dfe4 ($12.03 in chips)
Seat 2: 41ed372d ($5.07 in chips)
Seat 3: c6b4a39c ($5.1 in chips)
Seat 4: 2c28207b ($7.83 in chips)
Seat 5: Hero ($5.32 in chips)
Seat 6: 18b1ecd7 ($7.88 in chips)
41ed372d: posts small blind $0.02
c6b4a39c: posts big blind $0.05
*** HOLE CARDS ***
Dealt to cf24dfe4 
Dealt to 41ed372d 
Dealt to c6b4a39c 
Dealt to 2c28207b 
Dealt to Hero [Ah 3s]
Dealt to 18b1ecd7 
2c28207b: folds
Hero: folds
18b1ecd7: raises $0.05 to $0.1
cf24dfe4: folds
41ed372d: folds
c6b4a39c: folds
Uncalled bet ($0.05) returned to 18b1ecd7
*** SHOWDOWN ***
18b1ecd7 collected $0.12 from pot
*** SUMMARY ***
Total pot $0.12 | Rake $0 | Jackpot $0 | Bingo $0 | Fortune $0 | Tax $0
Seat 1: cf24dfe4 (button) folded before Flop (didn't bet)
Seat 2: 41ed372d (small blind) folded before Flop
Seat 3: c6b4a39c (big blind) folded before Flop
Seat 4: 2c28207b folded before Flop (didn't bet)
Seat 5: Hero folded before Flop (didn't bet)
Seat 6: 18b1ecd7 collected ($0.12)


Poker Hand #RC3795933431: Hold'em No Limit ($0.02/$0.05) - 2025/08/10 08:40:29
Table 'RushAndCash11068691' 6-max Seat #1 is the button
Seat 1: 808de8ec ($2.67 in chips)
Seat 2: 22b1f4df ($10.53 in chips)
Seat 3: Hero ($5.37 in chips)
Seat 4: 7d7b2f21 ($5.29 in chips)
Seat 5: 4392275e ($5 in chips)
Seat 6: cef92baa ($6.65 in chips)
22b1f4df: posts small blind $0.02
Hero: posts big blind $0.05
*** HOLE CARDS ***
Dealt to 808de8ec 
Dealt to 22b1f4df 
Dealt to Hero [3d 5c]
Dealt to 7d7b2f21 
Dealt to 4392275e 
Dealt to cef92baa 
7d7b2f21: folds
4392275e: folds
cef92baa: raises $0.07 to $0.12
808de8ec: folds
22b1f4df: folds
Hero: folds
Uncalled bet ($0.07) returned to cef92baa
*** SHOWDOWN ***
cef92baa collected $0.12 from pot
*** SUMMARY ***
Total pot $0.12 | Rake $0 | Jackpot $0 | Bingo $0 | Fortune $0 | Tax $0
Seat 1: 808de8ec (button) folded before Flop (didn't bet)
Seat 2: 22b1f4df (small blind) folded before Flop
Seat 3: Hero (big blind) folded before Flop
Seat 4: 7d7b2f21 folded before Flop (didn't bet)
Seat 5: 4392275e folded before Flop (didn't bet)
Seat 6: cef92baa collected ($0.12)


Poker Hand #RC3795933421: Hold'em No Limit ($0.02/$0.05) - 2025/08/10 08:40:25
Table 'RushAndCash11068681' 6-max Seat #1 is the button
Seat 1: 138096db ($5 in chips)
Seat 2: c52fe98b ($5.27 in chips)
Seat 3: cf24dfe4 ($12.1 in chips)
Seat 4: 7fbe4590 ($4.66 in chips)
Seat 5: 4f4d4da3 ($4.09 in chips)
Seat 6: Hero ($5.37 in chips)
c52fe98b: posts small blind $0.02
cf24dfe4: posts big blind $0.05
*** HOLE CARDS ***
Dealt to 138096db 
Dealt to c52fe98b 
Dealt to cf24dfe4 
Dealt to 7fbe4590 
Dealt to 4f4d4da3 
Dealt to Hero [7s Ah]
7fbe4590: raises $0.08 to $0.13
4f4d4da3: calls $0.13
Hero: folds
138096db: calls $0.13
c52fe98b: folds
cf24dfe4: folds
*** FLOP *** [Qh 2d 3h]
7fbe4590: checks
4f4d4da3: checks
138096db: checks
*** TURN *** [Qh 2d 3h] [Th]
7fbe4590: bets $0.35
4f4d4da3: calls $0.35
138096db: folds
*** RIVER *** [Qh 2d 3h Th] [6s]
7fbe4590: checks
4f4d4da3: checks
7fbe4590: shows [Kh Js] (King high)
4f4d4da3: shows [Qc 3c] (two pair, Queens and Threes)
*** SHOWDOWN ***
4f4d4da3 collected $1.11 from pot
*** SUMMARY ***
Total pot $1.16 | Rake $0.05 | Jackpot $0 | Bingo $0 | Fortune $0 | Tax $0
Board [Qh 2d 3h Th 6s]
Seat 1: 138096db (button) folded on the Turn
Seat 2: c52fe98b (small blind) folded before Flop
Seat 3: cf24dfe4 (big blind) folded before Flop
Seat 4: 7fbe4590 showed [Kh Js] and lost with King high
Seat 5: 4f4d4da3 showed [Qc 3c] and won ($1.11) with two pair, Queens and Threes
Seat 6: Hero folded before Flop (didn't bet)


Poker Hand #RC3795933386: Hold'em No Limit ($0.02/$0.05) - 2025/08/10 08:40:15
Table 'RushAndCash11068646' 6-max Seat #1 is the button
Seat 1: 7fbe4590 ($4.66 in chips)
Seat 2: Hero ($5.39 in chips)
Seat 3: d27c038b ($2.68 in chips)
Seat 4: 971f8a92 ($5 in chips)
Seat 5: f330932 ($2.12 in chips)
Seat 6: 902f8c64 ($7.52 in chips)
Hero: posts small blind $0.02
d27c038b: posts big blind $0.05
*** HOLE CARDS ***
Dealt to 7fbe4590 
Dealt to Hero [2s Ah]
Dealt to d27c038b 
Dealt to 971f8a92 
Dealt to f330932 
Dealt to 902f8c64 
971f8a92: folds
f330932: raises $0.05 to $0.1
902f8c64: folds
7fbe4590: folds
Hero: folds
d27c038b: calls $0.05
*** FLOP *** [9s Js 8h]
d27c038b: checks
f330932: bets $0.22
d27c038b: folds
Uncalled bet ($0.22) returned to f330932
*** SHOWDOWN ***
f330932 collected $0.21 from pot
*** SUMMARY ***
Total pot $0.22 | Rake $0.01 | Jackpot $0 | Bingo $0 | Fortune $0 | Tax $0
Board [9s Js 8h]
Seat 1: 7fbe4590 (button) folded before Flop (didn't bet)
Seat 2: Hero (small blind) folded before Flop
Seat 3: d27c038b (big blind) folded on the Flop
Seat 4: 971f8a92 folded before Flop (didn't bet)
Seat 5: f330932 won ($0.21)
Seat 6: 902f8c64 folded before Flop (didn't bet)


Poker Hand #RC3795933374: Hold'em No Limit ($0.02/$0.05) - 2025/08/10 08:40:11
Table 'RushAndCash11068634' 6-max Seat #1 is the button
Seat 1: f330932 ($2.12 in chips)
Seat 2: d32d3acf ($5 in chips)
Seat 3: Hero ($5.44 in chips)
Seat 4: e495c6b6 ($5 in chips)
Seat 5: 1af7528e ($10.49 in chips)
Seat 6: c6b4a39c ($5.08 in chips)
d32d3acf: posts small blind $0.02
Hero: posts big blind $0.05
*** HOLE CARDS ***
Dealt to f330932 
Dealt to d32d3acf 
Dealt to Hero [2c 8d]
Dealt to e495c6b6 
Dealt to 1af7528e 
Dealt to c6b4a39c 
e495c6b6: folds
1af7528e: folds
c6b4a39c: raises $0.08 to $0.13
f330932: folds
d32d3acf: folds
Hero: folds
Uncalled bet ($0.08) returned to c6b4a39c
*** SHOWDOWN ***
c6b4a39c collected $0.12 from pot
*** SUMMARY ***
Total pot $0.12 | Rake $0 | Jackpot $0 | Bingo $0 | Fortune $0 | Tax $0
Seat 1: f330932 (button) folded before Flop (didn't bet)
Seat 2: d32d3acf (small blind) folded before Flop
Seat 3: Hero (big blind) folded before Flop
Seat 4: e495c6b6 folded before Flop (didn't bet)
Seat 5: 1af7528e folded before Flop (didn't bet)
Seat 6: c6b4a39c collected ($0.12)


Poker Hand #RC3795933242: Hold'em No Limit ($0.02/$0.05) - 2025/08/10 08:39:32
Table 'RushAndCash11068502' 6-max Seat #1 is the button
Seat 1: c6b4a39c ($5.18 in chips)
Seat 2: b527583c ($9.1 in chips)
Seat 3: f330932 ($3.09 in chips)
Seat 4: Hero ($4.52 in chips)
Seat 5: 66a574d1 ($5.16 in chips)
Seat 6: cf3b419d ($3.72 in chips)
b527583c: posts small blind $0.02
f330932: posts big blind $0.05
*** HOLE CARDS ***
Dealt to c6b4a39c 
Dealt to b527583c 
Dealt to f330932 
Dealt to Hero [Ad Ah]
Dealt to 66a574d1 
Dealt to cf3b419d 
Hero: raises $0.05 to $0.1
66a574d1: folds
cf3b419d: folds
c6b4a39c: calls $0.1
b527583c: folds
f330932: raises $0.24 to $0.34
Hero: raises $0.63 to $0.97
c6b4a39c: folds
f330932: calls $0.63
*** FLOP *** [Qs 5d 6s]
f330932: checks
Hero: bets $0.6
f330932: folds
Uncalled bet ($0.6) returned to Hero
*** SHOWDOWN ***
Hero collected $1.89 from pot
*** SUMMARY ***
Total pot $2.06 | Rake $0.1 | Jackpot $0.07 | Bingo $0 | Fortune $0 | Tax $0
Board [Qs 5d 6s]
Seat 1: c6b4a39c (button) folded before Flop
Seat 2: b527583c (small blind) folded before Flop
Seat 3: f330932 (big blind) folded on the Flop
Seat 4: Hero won ($1.89)
Seat 5: 66a574d1 folded before Flop (didn't bet)
Seat 6: cf3b419d folded before Flop (didn't bet)


Poker Hand #RC3795933223: Hold'em No Limit ($0.02/$0.05) - 2025/08/10 08:39:27
Table 'RushAndCash11068483' 6-max Seat #1 is the button
Seat 1: e9f334c0 ($11.08 in chips)
Seat 2: cf3b419d ($3.74 in chips)
Seat 3: 9e0c2202 ($12.06 in chips)
Seat 4: Hero ($4.52 in chips)
Seat 5: ccbf95f3 ($5 in chips)
Seat 6: 12269029 ($5.75 in chips)
cf3b419d: posts small blind $0.02
9e0c2202: posts big blind $0.05
*** HOLE CARDS ***
Dealt to e9f334c0 
Dealt to cf3b419d 
Dealt to 9e0c2202 
Dealt to Hero [5s Kd]
Dealt to ccbf95f3 
Dealt to 12269029 
Hero: folds
ccbf95f3: folds
12269029: folds
e9f334c0: folds
cf3b419d: folds
Uncalled bet ($0.03) returned to 9e0c2202
*** SHOWDOWN ***
9e0c2202 collected $0.04 from pot
*** SUMMARY ***
Total pot $0.04 | Rake $0 | Jackpot $0 | Bingo $0 | Fortune $0 | Tax $0
Seat 1: e9f334c0 (button) folded before Flop (didn't bet)
Seat 2: cf3b419d (small blind) folded before Flop
Seat 3: 9e0c2202 (big blind) collected ($0.04)
Seat 4: Hero folded before Flop (didn't bet)
Seat 5: ccbf95f3 folded before Flop (didn't bet)
Seat 6: 12269029 folded before Flop (didn't bet)


Poker Hand #RC3795933198: Hold'em No Limit ($0.02/$0.05) - 2025/08/10 08:39:19
Table 'RushAndCash11068458' 6-max Seat #1 is the button
Seat 1: b3cc8379 ($5 in chips)
Seat 2: Hero ($4.54 in chips)
Seat 3: 42c31e1a ($12.05 in chips)
Seat 4: 7a644870 ($9.16 in chips)
Seat 5: 70662feb ($5.39 in chips)
Seat 6: 38df6650 ($5.09 in chips)
Hero: posts small blind $0.02
42c31e1a: posts big blind $0.05
*** HOLE CARDS ***
Dealt to b3cc8379 
Dealt to Hero [Qc 2s]
Dealt to 42c31e1a 
Dealt to 7a644870 
Dealt to 70662feb 
Dealt to 38df6650 
7a644870: folds
70662feb: raises $0.05 to $0.1
38df6650: folds
b3cc8379: folds
Hero: folds
42c31e1a: folds
Uncalled bet ($0.05) returned to 70662feb
*** SHOWDOWN ***
70662feb collected $0.12 from pot
*** SUMMARY ***
Total pot $0.12 | Rake $0 | Jackpot $0 | Bingo $0 | Fortune $0 | Tax $0
Seat 1: b3cc8379 (button) folded before Flop (didn't bet)
Seat 2: Hero (small blind) folded before Flop
Seat 3: 42c31e1a (big blind) folded before Flop
Seat 4: 7a644870 folded before Flop (didn't bet)
Seat 5: 70662feb collected ($0.12)
Seat 6: 38df6650 folded before Flop (didn't bet)


Poker Hand #RC3795932823: Hold'em No Limit ($0.02/$0.05) - 2025/08/10 08:37:28
Table 'RushAndCash11068083' 6-max Seat #1 is the button
Seat 1: Hero ($5.83 in chips)
Seat 2: 70662feb ($5.29 in chips)
Seat 3: bbe9b1b1 ($14.26 in chips)
Seat 4: 3f5c4b90 ($7.37 in chips)
Seat 5: 79f65393 ($5.11 in chips)
Seat 6: 7a644870 ($7.99 in chips)
70662feb: posts small blind $0.02
bbe9b1b1: posts big blind $0.05
*** HOLE CARDS ***
Dealt to Hero [Kh Kc]
Dealt to 70662feb 
Dealt to bbe9b1b1 
Dealt to 3f5c4b90 
Dealt to 79f65393 
Dealt to 7a644870 
3f5c4b90: folds
79f65393: folds
7a644870: raises $0.08 to $0.13
Hero: raises $0.39 to $0.52
70662feb: folds
bbe9b1b1: folds
7a644870: calls $0.39
*** FLOP *** [9s 3d Tc]
7a644870: checks
Hero: checks
*** TURN *** [9s 3d Tc] [Th]
7a644870: bets $0.77
Hero: calls $0.77
*** RIVER *** [9s 3d Tc Th] [5d]
7a644870: bets $2.04
Hero: folds
Uncalled bet ($2.04) returned to 7a644870
*** SHOWDOWN ***
7a644870 collected $2.46 from pot
*** SUMMARY ***
Total pot $2.65 | Rake $0.12 | Jackpot $0.07 | Bingo $0 | Fortune $0 | Tax $0
Board [9s 3d Tc Th 5d]
Seat 1: Hero (button) folded on the River
Seat 2: 70662feb (small blind) folded before Flop
Seat 3: bbe9b1b1 (big blind) folded before Flop
Seat 4: 3f5c4b90 folded before Flop (didn't bet)
Seat 5: 79f65393 folded before Flop (didn't bet)
Seat 6: 7a644870 won ($2.46)


Poker Hand #RC3795932811: Hold'em No Limit ($0.02/$0.05) - 2025/08/10 08:37:24
Table 'RushAndCash11068071' 6-max Seat #1 is the button
Seat 1: 80630135 ($8.05 in chips)
Seat 2: 848c5954 ($5.78 in chips)
Seat 3: 2fd706a9 ($7.38 in chips)
Seat 4: Hero ($5.83 in chips)
Seat 5: a127404a ($6.38 in chips)
Seat 6: 560bbe0d ($13.79 in chips)
848c5954: posts small blind $0.02
2fd706a9: posts big blind $0.05
*** HOLE CARDS ***
Dealt to 80630135 
Dealt to 848c5954 
Dealt to 2fd706a9 
Dealt to Hero [Qs 2s]
Dealt to a127404a 
Dealt to 560bbe0d 
Hero: folds
a127404a: raises $0.05 to $0.1
560bbe0d: folds
80630135: folds
848c5954: raises $0.4 to $0.5
2fd706a9: folds
a127404a: folds
Uncalled bet ($0.4) returned to 848c5954
*** SHOWDOWN ***
848c5954 collected $0.24 from pot
*** SUMMARY ***
Total pot $0.25 | Rake $0.01 | Jackpot $0 | Bingo $0 | Fortune $0 | Tax $0
Seat 1: 80630135 (button) folded before Flop (didn't bet)
Seat 2: 848c5954 (small blind) collected ($0.24)
Seat 3: 2fd706a9 (big blind) folded before Flop
Seat 4: Hero folded before Flop (didn't bet)
Seat 5: a127404a folded before Flop
Seat 6: 560bbe0d folded before Flop (didn't bet)


Poker Hand #RC3795932800: Hold'em No Limit ($0.02/$0.05) - 2025/08/10 08:37:20
Table 'RushAndCash11068060' 6-max Seat #1 is the button
Seat 1: c832e941 ($4.66 in chips)
Seat 2: bcd5617c ($5.37 in chips)
Seat 3: 9a343d90 ($6.48 in chips)
Seat 4: Hero ($5.83 in chips)
Seat 5: 2fd706a9 ($7.38 in chips)
Seat 6: dde92c84 ($14.49 in chips)
bcd5617c: posts small blind $0.02
9a343d90: posts big blind $0.05
*** HOLE CARDS ***
Dealt to c832e941 
Dealt to bcd5617c 
Dealt to 9a343d90 
Dealt to Hero [9h Qs]
Dealt to 2fd706a9 
Dealt to dde92c84 
Hero: folds
2fd706a9: folds
dde92c84: raises $0.06 to $0.11
c832e941: folds
bcd5617c: folds
9a343d90: folds
Uncalled bet ($0.06) returned to dde92c84
*** SHOWDOWN ***
dde92c84 collected $0.12 from pot
*** SUMMARY ***
Total pot $0.12 | Rake $0 | Jackpot $0 | Bingo $0 | Fortune $0 | Tax $0
Seat 1: c832e941 (button) folded before Flop (didn't bet)
Seat 2: bcd5617c (small blind) folded before Flop
Seat 3: 9a343d90 (big blind) folded before Flop
Seat 4: Hero folded before Flop (didn't bet)
Seat 5: 2fd706a9 folded before Flop (didn't bet)
Seat 6: dde92c84 collected ($0.12)


Poker Hand #RC3795932752: Hold'em No Limit ($0.02/$0.05) - 2025/08/10 08:37:03
Table 'RushAndCash11068012' 6-max Seat #1 is the button
Seat 1: 8ec533ad ($5.04 in chips)
Seat 2: 513bb8fb ($5.26 in chips)
Seat 3: db3d7016 ($5.3 in chips)
Seat 4: Hero ($5.76 in chips)
Seat 5: af0721f5 ($8.32 in chips)
Seat 6: fd4b11f ($3.87 in chips)
513bb8fb: posts small blind $0.02
db3d7016: posts big blind $0.05
*** HOLE CARDS ***
Dealt to 8ec533ad 
Dealt to 513bb8fb 
Dealt to db3d7016 
Dealt to Hero [Kc Ac]
Dealt to af0721f5 
Dealt to fd4b11f 
Hero: raises $0.05 to $0.1
af0721f5: folds
fd4b11f: folds
8ec533ad: folds
513bb8fb: folds
db3d7016: folds
Uncalled bet ($0.05) returned to Hero
*** SHOWDOWN ***
Hero collected $0.12 from pot
*** SUMMARY ***
Total pot $0.12 | Rake $0 | Jackpot $0 | Bingo $0 | Fortune $0 | Tax $0
Seat 1: 8ec533ad (button) folded before Flop (didn't bet)
Seat 2: 513bb8fb (small blind) folded before Flop
Seat 3: db3d7016 (big blind) folded before Flop
Seat 4: Hero collected ($0.12)
Seat 5: af0721f5 folded before Flop (didn't bet)
Seat 6: fd4b11f folded before Flop (didn't bet)


Poker Hand #RC3795932739: Hold'em No Limit ($0.02/$0.05) - 2025/08/10 08:36:59
Table 'RushAndCash11067999' 6-max Seat #1 is the button
Seat 1: Hero ($5.76 in chips)
Seat 2: ffac256b ($5.14 in chips)
Seat 3: 6e10dab3 ($7.58 in chips)
Seat 4: 5b54e251 ($12.76 in chips)
Seat 5: fd4b11f ($3.87 in chips)
Seat 6: bc8475a8 ($7.04 in chips)
ffac256b: posts small blind $0.02
6e10dab3: posts big blind $0.05
*** HOLE CARDS ***
Dealt to Hero [2h 4c]
Dealt to ffac256b 
Dealt to 6e10dab3 
Dealt to 5b54e251 
Dealt to fd4b11f 
Dealt to bc8475a8 
5b54e251: folds
fd4b11f: folds
bc8475a8: folds
Hero: folds
ffac256b: folds
Uncalled bet ($0.03) returned to 6e10dab3
*** SHOWDOWN ***
6e10dab3 collected $0.04 from pot
*** SUMMARY ***
Total pot $0.04 | Rake $0 | Jackpot $0 | Bingo $0 | Fortune $0 | Tax $0
Seat 1: Hero (button) folded before Flop (didn't bet)
Seat 2: ffac256b (small blind) folded before Flop
Seat 3: 6e10dab3 (big blind) collected ($0.04)
Seat 4: 5b54e251 folded before Flop (didn't bet)
Seat 5: fd4b11f folded before Flop (didn't bet)
Seat 6: bc8475a8 folded before Flop (didn't bet)


Poker Hand #RC3795932531: Hold'em No Limit ($0.02/$0.05) - 2025/08/10 08:35:58
Table 'RushAndCash11067791' 6-max Seat #1 is the button
Seat 1: 902f8c64 ($6.35 in chips)
Seat 2: Hero ($5.29 in chips)
Seat 3: 89697fca ($5.11 in chips)
Seat 4: 2b56ac20 ($12.12 in chips)
Seat 5: c832e941 ($4.93 in chips)
Seat 6: 7a09703 ($6.49 in chips)
Hero: posts small blind $0.02
89697fca: posts big blind $0.05
*** HOLE CARDS ***
Dealt to 902f8c64 
Dealt to Hero [3c Ac]
Dealt to 89697fca 
Dealt to 2b56ac20 
Dealt to c832e941 
Dealt to 7a09703 
2b56ac20: raises $0.07 to $0.12
c832e941: calls $0.12
7a09703: folds
902f8c64: folds
Hero: calls $0.1
89697fca: calls $0.07
*** FLOP *** [3h 5s Kc]
Hero: bets $0.14
89697fca: folds
2b56ac20: calls $0.14
c832e941: folds
*** TURN *** [3h 5s Kc] [Kd]
Hero: checks
2b56ac20: checks
*** RIVER *** [3h 5s Kc Kd] [Tc]
Hero: checks
2b56ac20: checks
Hero: shows [3c Ac] (two pair, Kings and Threes)
2b56ac20: shows [Ad 2d] (a pair of Kings)
*** SHOWDOWN ***
Hero collected $0.73 from pot
*** SUMMARY ***
Total pot $0.76 | Rake $0.03 | Jackpot $0 | Bingo $0 | Fortune $0 | Tax $0
Board [3h 5s Kc Kd Tc]
Seat 1: 902f8c64 (button) folded before Flop (didn't bet)
Seat 2: Hero (small blind) showed [3c Ac] and won ($0.73) with two pair, Kings and Threes
Seat 3: 89697fca (big blind) folded on the Flop
Seat 4: 2b56ac20 showed [Ad 2d] and lost with a pair of Kings
Seat 5: c832e941 folded on the Flop
Seat 6: 7a09703 folded before Flop (didn't bet)


Poker Hand #RC3795932488: Hold'em No Limit ($0.02/$0.05) - 2025/08/10 08:35:45
Table 'RushAndCash11067748' 6-max Seat #1 is the button
Seat 1: ac25def9 ($6.34 in chips)
Seat 2: 38df6650 ($5 in chips)
Seat 3: Hero ($5.34 in chips)
Seat 4: ef16305 ($5.38 in chips)
Seat 5: afbe94ee ($6.73 in chips)
Seat 6: f38b69c2 ($5.31 in chips)
38df6650: posts small blind $0.02
Hero: posts big blind $0.05
*** HOLE CARDS ***
Dealt to ac25def9 
Dealt to 38df6650 
Dealt to Hero [8h 5d]
Dealt to ef16305 
Dealt to afbe94ee 
Dealt to f38b69c2 
ef16305: folds
afbe94ee: folds
f38b69c2: raises $0.05 to $0.1
ac25def9: folds
38df6650: folds
Hero: folds
Uncalled bet ($0.05) returned to f38b69c2
*** SHOWDOWN ***
f38b69c2 collected $0.12 from pot
*** SUMMARY ***
Total pot $0.12 | Rake $0 | Jackpot $0 | Bingo $0 | Fortune $0 | Tax $0
Seat 1: ac25def9 (button) folded before Flop (didn't bet)
Seat 2: 38df6650 (small blind) folded before Flop
Seat 3: Hero (big blind) folded before Flop
Seat 4: ef16305 folded before Flop (didn't bet)
Seat 5: afbe94ee folded before Flop (didn't bet)
Seat 6: f38b69c2 collected ($0.12)


Poker Hand #RC3795932476: Hold'em No Limit ($0.02/$0.05) - 2025/08/10 08:35:41
Table 'RushAndCash11067736' 6-max Seat #1 is the button
Seat 1: c832e941 ($4.93 in chips)
Seat 2: 1dafb1bc ($38.09 in chips)
Seat 3: 5fc6009a ($5.37 in chips)
Seat 4: ab33e85c ($4.39 in chips)
Seat 5: a4b58f11 ($10.1 in chips)
Seat 6: Hero ($5.34 in chips)
1dafb1bc: posts small blind $0.02
5fc6009a: posts big blind $0.05
*** HOLE CARDS ***
Dealt to c832e941 
Dealt to 1dafb1bc 
Dealt to 5fc6009a 
Dealt to ab33e85c 
Dealt to a4b58f11 
Dealt to Hero [3c Td]
ab33e85c: folds
a4b58f11: folds
Hero: folds
c832e941: folds
1dafb1bc: raises $0.1 to $0.15
5fc6009a: folds
Uncalled bet ($0.1) returned to 1dafb1bc
*** SHOWDOWN ***
1dafb1bc collected $0.1 from pot
*** SUMMARY ***
Total pot $0.1 | Rake $0 | Jackpot $0 | Bingo $0 | Fortune $0 | Tax $0
Seat 1: c832e941 (button) folded before Flop (didn't bet)
Seat 2: 1dafb1bc (small blind) collected ($0.1)
Seat 3: 5fc6009a (big blind) folded before Flop
Seat 4: ab33e85c folded before Flop (didn't bet)
Seat 5: a4b58f11 folded before Flop (didn't bet)
Seat 6: Hero folded before Flop (didn't bet)


Poker Hand #RC3795932465: Hold'em No Limit ($0.02/$0.05) - 2025/08/10 08:35:38
Table 'RushAndCash11067725' 6-max Seat #1 is the button
Seat 1: e9f334c0 ($9.59 in chips)
Seat 2: dd92de38 ($6.79 in chips)
Seat 3: aaee1c12 ($19.94 in chips)
Seat 4: Hero ($5.34 in chips)
Seat 5: 5fc6009a ($5.37 in chips)
Seat 6: 1dafb1bc ($38.09 in chips)
dd92de38: posts small blind $0.02
aaee1c12: posts big blind $0.05
*** HOLE CARDS ***
Dealt to e9f334c0 
Dealt to dd92de38 
Dealt to aaee1c12 
Dealt to Hero [8c 2c]
Dealt to 5fc6009a 
Dealt to 1dafb1bc 
Hero: folds
5fc6009a: folds
1dafb1bc: folds
e9f334c0: raises $0.08 to $0.13
dd92de38: folds
aaee1c12: calls $0.08
*** FLOP *** [8d 4d 5d]
aaee1c12: checks
e9f334c0: bets $0.18
aaee1c12: folds
Uncalled bet ($0.18) returned to e9f334c0
*** SHOWDOWN ***
e9f334c0 collected $0.27 from pot
*** SUMMARY ***
Total pot $0.28 | Rake $0.01 | Jackpot $0 | Bingo $0 | Fortune $0 | Tax $0
Board [8d 4d 5d]
Seat 1: e9f334c0 (button) won ($0.27)
Seat 2: dd92de38 (small blind) folded before Flop
Seat 3: aaee1c12 (big blind) folded on the Flop
Seat 4: Hero folded before Flop (didn't bet)
Seat 5: 5fc6009a folded before Flop (didn't bet)
Seat 6: 1dafb1bc folded before Flop (didn't bet)


Poker Hand #RC3795932453: Hold'em No Limit ($0.02/$0.05) - 2025/08/10 08:35:34
Table 'RushAndCash11067713' 6-max Seat #1 is the button
Seat 1: 54cd1b65 ($12.83 in chips)
Seat 2: d4249213 ($5 in chips)
Seat 3: 848c5954 ($5.81 in chips)
Seat 4: Hero ($5.34 in chips)
Seat 5: 7244fd77 ($5.09 in chips)
Seat 6: 67671ee6 ($5.09 in chips)
d4249213: posts small blind $0.02
848c5954: posts big blind $0.05
*** HOLE CARDS ***
Dealt to 54cd1b65 
Dealt to d4249213 
Dealt to 848c5954 
Dealt to Hero [8s 2s]
Dealt to 7244fd77 
Dealt to 67671ee6 
Hero: folds
7244fd77: folds
67671ee6: folds
54cd1b65: raises $0.07 to $0.12
d4249213: folds
848c5954: folds
Uncalled bet ($0.07) returned to 54cd1b65
*** SHOWDOWN ***
54cd1b65 collected $0.12 from pot
*** SUMMARY ***
Total pot $0.12 | Rake $0 | Jackpot $0 | Bingo $0 | Fortune $0 | Tax $0
Seat 1: 54cd1b65 (button) collected ($0.12)
Seat 2: d4249213 (small blind) folded before Flop
Seat 3: 848c5954 (big blind) folded before Flop
Seat 4: Hero folded before Flop (didn't bet)
Seat 5: 7244fd77 folded before Flop (didn't bet)
Seat 6: 67671ee6 folded before Flop (didn't bet)


Poker Hand #RC3795932442: Hold'em No Limit ($0.02/$0.05) - 2025/08/10 08:35:30
Table 'RushAndCash11067702' 6-max Seat #1 is the button
Seat 1: b8581dce ($5 in chips)
Seat 2: 2b5a7a1b ($12.3 in chips)
Seat 3: 86d57974 ($5 in chips)
Seat 4: 7529396e ($5.02 in chips)
Seat 5: 4844e57f ($6.63 in chips)
Seat 6: Hero ($5.34 in chips)
2b5a7a1b: posts small blind $0.02
86d57974: posts big blind $0.05
*** HOLE CARDS ***
Dealt to b8581dce 
Dealt to 2b5a7a1b 
Dealt to 86d57974 
Dealt to 7529396e 
Dealt to 4844e57f 
Dealt to Hero [6c 9h]
7529396e: raises $0.15 to $0.2
4844e57f: folds
Hero: folds
b8581dce: folds
2b5a7a1b: folds
86d57974: folds
Uncalled bet ($0.15) returned to 7529396e
*** SHOWDOWN ***
7529396e collected $0.12 from pot
*** SUMMARY ***
Total pot $0.12 | Rake $0 | Jackpot $0 | Bingo $0 | Fortune $0 | Tax $0
Seat 1: b8581dce (button) folded before Flop (didn't bet)
Seat 2: 2b5a7a1b (small blind) folded before Flop
Seat 3: 86d57974 (big blind) folded before Flop
Seat 4: 7529396e collected ($0.12)
Seat 5: 4844e57f folded before Flop (didn't bet)
Seat 6: Hero folded before Flop (didn't bet)


Poker Hand #RC3795932396: Hold'em No Limit ($0.02/$0.05) - 2025/08/10 08:35:15
Table 'RushAndCash11067656' 6-max Seat #1 is the button
Seat 1: e90b1294 ($5.02 in chips)
Seat 2: 2b56ac20 ($11.86 in chips)
Seat 3: Hero ($5.39 in chips)
Seat 4: 89697fca ($5.34 in chips)
Seat 5: 55b6c449 ($6.11 in chips)
Seat 6: 97b1f31 ($5 in chips)
2b56ac20: posts small blind $0.02
Hero: posts big blind $0.05
*** HOLE CARDS ***
Dealt to e90b1294 
Dealt to 2b56ac20 
Dealt to Hero [4h Js]
Dealt to 89697fca 
Dealt to 55b6c449 
Dealt to 97b1f31 
89697fca: raises $0.05 to $0.1
55b6c449: folds
97b1f31: folds
e90b1294: folds
2b56ac20: calls $0.08
Hero: folds
*** FLOP *** [7c 8c Th]
2b56ac20: bets $0.13
89697fca: calls $0.13
*** TURN *** [7c 8c Th] [Ah]
2b56ac20: checks
89697fca: checks
*** RIVER *** [7c 8c Th Ah] [5s]
2b56ac20: checks
89697fca: checks
2b56ac20: shows [Jc Jd] (a pair of Jacks)
89697fca: shows [Qc Tc] (a pair of Tens)
*** SHOWDOWN ***
2b56ac20 collected $0.49 from pot
*** SUMMARY ***
Total pot $0.51 | Rake $0.02 | Jackpot $0 | Bingo $0 | Fortune $0 | Tax $0
Board [7c 8c Th Ah 5s]
Seat 1: e90b1294 (button) folded before Flop (didn't bet)
Seat 2: 2b56ac20 (small blind) showed [Jc Jd] and won ($0.49) with a pair of Jacks
Seat 3: Hero (big blind) folded before Flop
Seat 4: 89697fca showed [Qc Tc] and lost with a pair of Tens
Seat 5: 55b6c449 folded before Flop (didn't bet)
Seat 6: 97b1f31 folded before Flop (didn't bet)


Poker Hand #RC3795932376: Hold'em No Limit ($0.02/$0.05) - 2025/08/10 08:35:09
Table 'RushAndCash11067636' 6-max Seat #1 is the button
Seat 1: bf35d9d7 ($5 in chips)
Seat 2: Hero ($5.41 in chips)
Seat 3: 4844e57f ($6.61 in chips)
Seat 4: b1b3930a ($5.11 in chips)
Seat 5: e5d47869 ($6.31 in chips)
Seat 6: e9f334c0 ($9.59 in chips)
Hero: posts small blind $0.02
4844e57f: posts big blind $0.05
*** HOLE CARDS ***
Dealt to bf35d9d7 
Dealt to Hero [5c Js]
Dealt to 4844e57f 
Dealt to b1b3930a 
Dealt to e5d47869 
Dealt to e9f334c0 
b1b3930a: folds
e5d47869: raises $0.05 to $0.1
e9f334c0: folds
bf35d9d7: folds
Hero: folds
4844e57f: folds
Uncalled bet ($0.05) returned to e5d47869
*** SHOWDOWN ***
e5d47869 collected $0.12 from pot
*** SUMMARY ***
Total pot $0.12 | Rake $0 | Jackpot $0 | Bingo $0 | Fortune $0 | Tax $0
Seat 1: bf35d9d7 (button) folded before Flop (didn't bet)
Seat 2: Hero (small blind) folded before Flop
Seat 3: 4844e57f (big blind) folded before Flop
Seat 4: b1b3930a folded before Flop (didn't bet)
Seat 5: e5d47869 collected ($0.12)
Seat 6: e9f334c0 folded before Flop (didn't bet)


Poker Hand #RC3795932351: Hold'em No Limit ($0.02/$0.05) - 2025/08/10 08:35:00
Table 'RushAndCash11067611' 6-max Seat #1 is the button
Seat 1: Hero ($5.41 in chips)
Seat 2: 7244fd77 ($5.09 in chips)
Seat 3: 9a343d90 ($6.37 in chips)
Seat 4: 41ed372d ($5.16 in chips)
Seat 5: d97bce4f ($5.34 in chips)
Seat 6: d2ef50f8 ($1.48 in chips)
7244fd77: posts small blind $0.02
9a343d90: posts big blind $0.05
*** HOLE CARDS ***
Dealt to Hero [Ac 9s]
Dealt to 7244fd77 
Dealt to 9a343d90 
Dealt to 41ed372d 
Dealt to d97bce4f 
Dealt to d2ef50f8 
41ed372d: raises $0.08 to $0.13
d97bce4f: folds
d2ef50f8: folds
Hero: folds
7244fd77: folds
9a343d90: folds
Uncalled bet ($0.08) returned to 41ed372d
*** SHOWDOWN ***
41ed372d collected $0.12 from pot
*** SUMMARY ***
Total pot $0.12 | Rake $0 | Jackpot $0 | Bingo $0 | Fortune $0 | Tax $0
Seat 1: Hero (button) folded before Flop (didn't bet)
Seat 2: 7244fd77 (small blind) folded before Flop
Seat 3: 9a343d90 (big blind) folded before Flop
Seat 4: 41ed372d collected ($0.12)
Seat 5: d97bce4f folded before Flop (didn't bet)
Seat 6: d2ef50f8 folded before Flop (didn't bet)


Poker Hand #RC3795932334: Hold'em No Limit ($0.02/$0.05) - 2025/08/10 08:34:55
Table 'RushAndCash11067594' 6-max Seat #1 is the button
Seat 1: Hero ($5.41 in chips)
Seat 2: 81fae1fb ($5.22 in chips)
Seat 3: ccbf95f3 ($5.07 in chips)
Seat 4: 4844e57f ($6.63 in chips)
Seat 5: 18b1ecd7 ($8.2 in chips)
Seat 6: 6dc54533 ($43.31 in chips)
81fae1fb: posts small blind $0.02
ccbf95f3: posts big blind $0.05
*** HOLE CARDS ***
Dealt to Hero [4s Qs]
Dealt to 81fae1fb 
Dealt to ccbf95f3 
Dealt to 4844e57f 
Dealt to 18b1ecd7 
Dealt to 6dc54533 
4844e57f: folds
18b1ecd7: folds
6dc54533: folds
Hero: folds
81fae1fb: raises $0.1 to $0.15
ccbf95f3: folds
Uncalled bet ($0.1) returned to 81fae1fb
*** SHOWDOWN ***
81fae1fb collected $0.1 from pot
*** SUMMARY ***
Total pot $0.1 | Rake $0 | Jackpot $0 | Bingo $0 | Fortune $0 | Tax $0
Seat 1: Hero (button) folded before Flop (didn't bet)
Seat 2: 81fae1fb (small blind) collected ($0.1)
Seat 3: ccbf95f3 (big blind) folded before Flop
Seat 4: 4844e57f folded before Flop (didn't bet)
Seat 5: 18b1ecd7 folded before Flop (didn't bet)
Seat 6: 6dc54533 folded before Flop (didn't bet)


Poker Hand #RC3795932310: Hold'em No Limit ($0.02/$0.05) - 2025/08/10 08:34:47
Table 'RushAndCash11067570' 6-max Seat #1 is the button
Seat 1: c6b4a39c ($5.05 in chips)
Seat 2: Hero ($5.43 in chips)
Seat 3: 73869740 ($5.09 in chips)
Seat 4: 999a0f96 ($10.16 in chips)
Seat 5: 2c53d2c7 ($6.22 in chips)
Seat 6: 35c42e8c ($6.62 in chips)
Hero: posts small blind $0.02
73869740: posts big blind $0.05
*** HOLE CARDS ***
Dealt to c6b4a39c 
Dealt to Hero [7d 4s]
Dealt to 73869740 
Dealt to 999a0f96 
Dealt to 2c53d2c7 
Dealt to 35c42e8c 
999a0f96: folds
2c53d2c7: folds
35c42e8c: folds
c6b4a39c: folds
Hero: folds
Uncalled bet ($0.03) returned to 73869740
*** SHOWDOWN ***
73869740 collected $0.04 from pot
*** SUMMARY ***
Total pot $0.04 | Rake $0 | Jackpot $0 | Bingo $0 | Fortune $0 | Tax $0
Seat 1: c6b4a39c (button) folded before Flop (didn't bet)
Seat 2: Hero (small blind) folded before Flop
Seat 3: 73869740 (big blind) collected ($0.04)
Seat 4: 999a0f96 folded before Flop (didn't bet)
Seat 5: 2c53d2c7 folded before Flop (didn't bet)
Seat 6: 35c42e8c folded before Flop (didn't bet)


Poker Hand #RC3795932299: Hold'em No Limit ($0.02/$0.05) - 2025/08/10 08:34:44
Table 'RushAndCash11067559' 6-max Seat #1 is the button
Seat 1: 85e4ce3a ($16.71 in chips)
Seat 2: e7757e1d ($6.21 in chips)
Seat 3: c1d96785 ($15.29 in chips)
Seat 4: 3f5c4b90 ($6.85 in chips)
Seat 5: 770bebf2 ($5.7 in chips)
Seat 6: Hero ($5.43 in chips)
e7757e1d: posts small blind $0.02
c1d96785: posts big blind $0.05
*** HOLE CARDS ***
Dealt to 85e4ce3a 
Dealt to e7757e1d 
Dealt to c1d96785 
Dealt to 3f5c4b90 
Dealt to 770bebf2 
Dealt to Hero [7s Qd]
3f5c4b90: folds
770bebf2: folds
Hero: folds
85e4ce3a: raises $0.06 to $0.11
e7757e1d: folds
c1d96785: folds
Uncalled bet ($0.06) returned to 85e4ce3a
*** SHOWDOWN ***
85e4ce3a collected $0.12 from pot
*** SUMMARY ***
Total pot $0.12 | Rake $0 | Jackpot $0 | Bingo $0 | Fortune $0 | Tax $0
Seat 1: 85e4ce3a (button) collected ($0.12)
Seat 2: e7757e1d (small blind) folded before Flop
Seat 3: c1d96785 (big blind) folded before Flop
Seat 4: 3f5c4b90 folded before Flop (didn't bet)
Seat 5: 770bebf2 folded before Flop (didn't bet)
Seat 6: Hero folded before Flop (didn't bet)


Poker Hand #RC3795932160: Hold'em No Limit ($0.02/$0.05) - 2025/08/10 08:33:58
Table 'RushAndCash11067420' 6-max Seat #1 is the button
Seat 1: 65914450 ($23.41 in chips)
Seat 2: 38df6650 ($5 in chips)
Seat 3: Hero ($5.55 in chips)
Seat 4: 848c5954 ($5.89 in chips)
Seat 5: b1b3930a ($5.38 in chips)
Seat 6: c1d96785 ($15.16 in chips)
38df6650: posts small blind $0.02
Hero: posts big blind $0.05
*** HOLE CARDS ***
Dealt to 65914450 
Dealt to 38df6650 
Dealt to Hero [5s 5c]
Dealt to 848c5954 
Dealt to b1b3930a 
Dealt to c1d96785 
848c5954: folds
b1b3930a: folds
c1d96785: raises $0.07 to $0.12
65914450: folds
38df6650: folds
Hero: calls $0.07
*** FLOP *** [4c Jd 7d]
Hero: checks
c1d96785: bets $0.09
Hero: folds
Uncalled bet ($0.09) returned to c1d96785
*** SHOWDOWN ***
c1d96785 collected $0.25 from pot
*** SUMMARY ***
Total pot $0.26 | Rake $0.01 | Jackpot $0 | Bingo $0 | Fortune $0 | Tax $0
Board [4c Jd 7d]
Seat 1: 65914450 (button) folded before Flop (didn't bet)
Seat 2: 38df6650 (small blind) folded before Flop
Seat 3: Hero (big blind) folded on the Flop
Seat 4: 848c5954 folded before Flop (didn't bet)
Seat 5: b1b3930a folded before Flop (didn't bet)
Seat 6: c1d96785 won ($0.25)


Poker Hand #RC3795932148: Hold'em No Limit ($0.02/$0.05) - 2025/08/10 08:33:55
Table 'RushAndCash11067408' 6-max Seat #1 is the button
Seat 1: fd4b11f ($5.23 in chips)
Seat 2: cf791d0b ($5.16 in chips)
Seat 3: c6b4a39c ($5.02 in chips)
Seat 4: Hero ($5.55 in chips)
Seat 5: c1d96785 ($15.16 in chips)
Seat 6: 6780a6cb ($5 in chips)
cf791d0b: posts small blind $0.02
c6b4a39c: posts big blind $0.05
*** HOLE CARDS ***
Dealt to fd4b11f 
Dealt to cf791d0b 
Dealt to c6b4a39c 
Dealt to Hero [2h Ts]
Dealt to c1d96785 
Dealt to 6780a6cb 
Hero: folds
c1d96785: folds
6780a6cb: folds
fd4b11f: folds
cf791d0b: folds
Uncalled bet ($0.03) returned to c6b4a39c
*** SHOWDOWN ***
c6b4a39c collected $0.04 from pot
*** SUMMARY ***
Total pot $0.04 | Rake $0 | Jackpot $0 | Bingo $0 | Fortune $0 | Tax $0
Seat 1: fd4b11f (button) folded before Flop (didn't bet)
Seat 2: cf791d0b (small blind) folded before Flop
Seat 3: c6b4a39c (big blind) collected ($0.04)
Seat 4: Hero folded before Flop (didn't bet)
Seat 5: c1d96785 folded before Flop (didn't bet)
Seat 6: 6780a6cb folded before Flop (didn't bet)


Poker Hand #RC3795932132: Hold'em No Limit ($0.02/$0.05) - 2025/08/10 08:33:50
Table 'RushAndCash11067392' 6-max Seat #1 is the button
Seat 1: 9095f6a6 ($5.05 in chips)
Seat 2: e416125e ($5.18 in chips)
Seat 3: cbf461b9 ($5.61 in chips)
Seat 4: ffac256b ($4.68 in chips)
Seat 5: Hero ($5.55 in chips)
Seat 6: 2b56ac20 ($12.13 in chips)
e416125e: posts small blind $0.02
cbf461b9: posts big blind $0.05
*** HOLE CARDS ***
Dealt to 9095f6a6 
Dealt to e416125e 
Dealt to cbf461b9 
Dealt to ffac256b 
Dealt to Hero [Td 9h]
Dealt to 2b56ac20 
ffac256b: folds
Hero: folds
2b56ac20: folds
9095f6a6: folds
e416125e: folds
Uncalled bet ($0.03) returned to cbf461b9
*** SHOWDOWN ***
cbf461b9 collected $0.04 from pot
*** SUMMARY ***
Total pot $0.04 | Rake $0 | Jackpot $0 | Bingo $0 | Fortune $0 | Tax $0
Seat 1: 9095f6a6 (button) folded before Flop (didn't bet)
Seat 2: e416125e (small blind) folded before Flop
Seat 3: cbf461b9 (big blind) collected ($0.04)
Seat 4: ffac256b folded before Flop (didn't bet)
Seat 5: Hero folded before Flop (didn't bet)
Seat 6: 2b56ac20 folded before Flop (didn't bet)


Poker Hand #RC3795932121: Hold'em No Limit ($0.02/$0.05) - 2025/08/10 08:33:47
Table 'RushAndCash11067381' 6-max Seat #1 is the button
Seat 1: cd7dffc4 ($5 in chips)
Seat 2: 801ebb9f ($5 in chips)
Seat 3: a57b331d ($21.43 in chips)
Seat 4: cbf461b9 ($5.61 in chips)
Seat 5: Hero ($5.55 in chips)
Seat 6: 453d8970 ($4.71 in chips)
801ebb9f: posts small blind $0.02
a57b331d: posts big blind $0.05
*** HOLE CARDS ***
Dealt to cd7dffc4 
Dealt to 801ebb9f 
Dealt to a57b331d 
Dealt to cbf461b9 
Dealt to Hero [7s 4h]
Dealt to 453d8970 
cbf461b9: folds
Hero: folds
453d8970: folds
cd7dffc4: raises $0.08 to $0.13
801ebb9f: calls $0.11
a57b331d: folds
*** FLOP *** [Th 8h 6d]
801ebb9f: checks
cd7dffc4: checks
*** TURN *** [Th 8h 6d] [7d]
801ebb9f: bets $0.22
cd7dffc4: folds
Uncalled bet ($0.22) returned to 801ebb9f
*** SHOWDOWN ***
801ebb9f collected $0.3 from pot
*** SUMMARY ***
Total pot $0.31 | Rake $0.01 | Jackpot $0 | Bingo $0 | Fortune $0 | Tax $0
Board [Th 8h 6d 7d]
Seat 1: cd7dffc4 (button) folded on the Turn
Seat 2: 801ebb9f (small blind) won ($0.3)
Seat 3: a57b331d (big blind) folded before Flop
Seat 4: cbf461b9 folded before Flop (didn't bet)
Seat 5: Hero folded before Flop (didn't bet)
Seat 6: 453d8970 folded before Flop (didn't bet)


Poker Hand #RC3795932087: Hold'em No Limit ($0.02/$0.05) - 2025/08/10 08:33:36
Table 'RushAndCash11067347' 6-max Seat #1 is the button
Seat 1: Hero ($5.55 in chips)
Seat 2: 6bfc0170 ($5.18 in chips)
Seat 3: 8b390e1e ($5.09 in chips)
Seat 4: 6dc54533 ($42.69 in chips)
Seat 5: d27c038b ($2.57 in chips)
Seat 6: c52fe98b ($5.19 in chips)
6bfc0170: posts small blind $0.02
8b390e1e: posts big blind $0.05
*** HOLE CARDS ***
Dealt to Hero [5h 5s]
Dealt to 6bfc0170 
Dealt to 8b390e1e 
Dealt to 6dc54533 
Dealt to d27c038b 
Dealt to c52fe98b 
6dc54533: raises $0.07 to $0.12
d27c038b: folds
c52fe98b: raises $0.24 to $0.36
Hero: folds
6bfc0170: folds
8b390e1e: folds
6dc54533: calls $0.24
*** FLOP *** [Jh 7s 2c]
6dc54533: checks
c52fe98b: bets $0.27
6dc54533: calls $0.27
*** TURN *** [Jh 7s 2c] [Tc]
6dc54533: checks
c52fe98b: checks
*** RIVER *** [Jh 7s 2c Tc] [8h]
6dc54533: bets $0.44
c52fe98b: folds
Uncalled bet ($0.44) returned to 6dc54533
*** SHOWDOWN ***
6dc54533 collected $1.27 from pot
*** SUMMARY ***
Total pot $1.33 | Rake $0.06 | Jackpot $0 | Bingo $0 | Fortune $0 | Tax $0
Board [Jh 7s 2c Tc 8h]
Seat 1: Hero (button) folded before Flop (didn't bet)
Seat 2: 6bfc0170 (small blind) folded before Flop
Seat 3: 8b390e1e (big blind) folded before Flop
Seat 4: 6dc54533 won ($1.27)
Seat 5: d27c038b folded before Flop (didn't bet)
Seat 6: c52fe98b folded on the River


Poker Hand #RC3795932065: Hold'em No Limit ($0.02/$0.05) - 2025/08/10 08:33:29
Table 'RushAndCash11067325' 6-max Seat #1 is the button
Seat 1: 7a644870 ($7.78 in chips)
Seat 2: Hero ($5.57 in chips)
Seat 3: 67671ee6 ($5 in chips)
Seat 4: 6bfc0170 ($5.18 in chips)
Seat 5: 2b56ac20 ($12.18 in chips)
Seat 6: d27c038b ($2.57 in chips)
Hero: posts small blind $0.02
67671ee6: posts big blind $0.05
*** HOLE CARDS ***
Dealt to 7a644870 
Dealt to Hero [3c Tc]
Dealt to 67671ee6 
Dealt to 6bfc0170 
Dealt to 2b56ac20 
Dealt to d27c038b 
6bfc0170: folds
2b56ac20: folds
d27c038b: folds
7a644870: folds
Hero: folds
Uncalled bet ($0.03) returned to 67671ee6
*** SHOWDOWN ***
67671ee6 collected $0.04 from pot
*** SUMMARY ***
Total pot $0.04 | Rake $0 | Jackpot $0 | Bingo $0 | Fortune $0 | Tax $0
Seat 1: 7a644870 (button) folded before Flop (didn't bet)
Seat 2: Hero (small blind) folded before Flop
Seat 3: 67671ee6 (big blind) collected ($0.04)
Seat 4: 6bfc0170 folded before Flop (didn't bet)
Seat 5: 2b56ac20 folded before Flop (didn't bet)
Seat 6: d27c038b folded before Flop (didn't bet)


Poker Hand #RC3795932048: Hold'em No Limit ($0.02/$0.05) - 2025/08/10 08:33:24
Table 'RushAndCash11067308' 6-max Seat #1 is the button
Seat 1: 848c5954 ($5.87 in chips)
Seat 2: 35c42e8c ($5.91 in chips)
Seat 3: Hero ($5.62 in chips)
Seat 4: 5fc6009a ($5.07 in chips)
Seat 5: 68db1858 ($4.77 in chips)
Seat 6: b2532ba1 ($6.99 in chips)
35c42e8c: posts small blind $0.02
Hero: posts big blind $0.05
*** HOLE CARDS ***
Dealt to 848c5954 
Dealt to 35c42e8c 
Dealt to Hero [Ks 9d]
Dealt to 5fc6009a 
Dealt to 68db1858 
Dealt to b2532ba1 
5fc6009a: folds
68db1858: folds
b2532ba1: folds
848c5954: folds
35c42e8c: raises $0.13 to $0.18
Hero: folds
Uncalled bet ($0.13) returned to 35c42e8c
*** SHOWDOWN ***
35c42e8c collected $0.1 from pot
*** SUMMARY ***
Total pot $0.1 | Rake $0 | Jackpot $0 | Bingo $0 | Fortune $0 | Tax $0
Seat 1: 848c5954 (button) folded before Flop (didn't bet)
Seat 2: 35c42e8c (small blind) collected ($0.1)
Seat 3: Hero (big blind) folded before Flop
Seat 4: 5fc6009a folded before Flop (didn't bet)
Seat 5: 68db1858 folded before Flop (didn't bet)
Seat 6: b2532ba1 folded before Flop (didn't bet)


Poker Hand #RC3795931838: Hold'em No Limit ($0.02/$0.05) - 2025/08/10 08:32:23
Table 'RushAndCash11067098' 6-max Seat #1 is the button
Seat 1: d466ce85 ($5.21 in chips)
Seat 2: 1145fc6a ($5 in chips)
Seat 3: b2532ba1 ($7.09 in chips)
Seat 4: Hero ($5.51 in chips)
Seat 5: 81fae1fb ($5.21 in chips)
Seat 6: 848c5954 ($5.82 in chips)
1145fc6a: posts small blind $0.02
b2532ba1: posts big blind $0.05
*** HOLE CARDS ***
Dealt to d466ce85 
Dealt to 1145fc6a 
Dealt to b2532ba1 
Dealt to Hero [9c Kc]
Dealt to 81fae1fb 
Dealt to 848c5954 
Hero: raises $0.05 to $0.1
81fae1fb: folds
848c5954: folds
d466ce85: folds
1145fc6a: folds
b2532ba1: calls $0.05
*** FLOP *** [8d 9d 5s]
b2532ba1: checks
Hero: checks
*** TURN *** [8d 9d 5s] [5d]
b2532ba1: checks
Hero: checks
*** RIVER *** [8d 9d 5s 5d] [9s]
b2532ba1: checks
Hero: bets $0.32
b2532ba1: folds
Uncalled bet ($0.32) returned to Hero
*** SHOWDOWN ***
Hero collected $0.21 from pot
*** SUMMARY ***
Total pot $0.22 | Rake $0.01 | Jackpot $0 | Bingo $0 | Fortune $0 | Tax $0
Board [8d 9d 5s 5d 9s]
Seat 1: d466ce85 (button) folded before Flop (didn't bet)
Seat 2: 1145fc6a (small blind) folded before Flop
Seat 3: b2532ba1 (big blind) folded on the River
Seat 4: Hero won ($0.21)
Seat 5: 81fae1fb folded before Flop (didn't bet)
Seat 6: 848c5954 folded before Flop (didn't bet)


Poker Hand #RC3795931767: Hold'em No Limit ($0.02/$0.05) - 2025/08/10 08:32:00
Table 'RushAndCash11067027' 6-max Seat #1 is the button
Seat 1: d8b9a478 ($4.95 in chips)
Seat 2: a1651cdc ($8.05 in chips)
Seat 3: 2c28207b ($8.54 in chips)
Seat 4: Hero ($5.44 in chips)
Seat 5: 66a574d1 ($5.07 in chips)
Seat 6: 38df6650 ($5.09 in chips)
a1651cdc: posts small blind $0.02
2c28207b: posts big blind $0.05
*** HOLE CARDS ***
Dealt to d8b9a478 
Dealt to a1651cdc 
Dealt to 2c28207b 
Dealt to Hero [Jh Th]
Dealt to 66a574d1 
Dealt to 38df6650 
Hero: raises $0.05 to $0.1
66a574d1: folds
38df6650: folds
d8b9a478: folds
a1651cdc: folds
2c28207b: folds
Uncalled bet ($0.05) returned to Hero
*** SHOWDOWN ***
Hero collected $0.12 from pot
*** SUMMARY ***
Total pot $0.12 | Rake $0 | Jackpot $0 | Bingo $0 | Fortune $0 | Tax $0
Seat 1: d8b9a478 (button) folded before Flop (didn't bet)
Seat 2: a1651cdc (small blind) folded before Flop
Seat 3: 2c28207b (big blind) folded before Flop
Seat 4: Hero collected ($0.12)
Seat 5: 66a574d1 folded before Flop (didn't bet)
Seat 6: 38df6650 folded before Flop (didn't bet)


Poker Hand #RC3795931754: Hold'em No Limit ($0.02/$0.05) - 2025/08/10 08:31:56
Table 'RushAndCash11067014' 6-max Seat #1 is the button
Seat 1: 4b9df3fe ($8.1 in chips)
Seat 2: 560bbe0d ($14.62 in chips)
Seat 3: f6bf8dfb ($11.3 in chips)
Seat 4: Hero ($5.44 in chips)
Seat 5: cb83453e ($11.79 in chips)
Seat 6: 84c84dd4 ($7.66 in chips)
560bbe0d: posts small blind $0.02
f6bf8dfb: posts big blind $0.05
*** HOLE CARDS ***
Dealt to 4b9df3fe 
Dealt to 560bbe0d 
Dealt to f6bf8dfb 
Dealt to Hero [3c 2c]
Dealt to cb83453e 
Dealt to 84c84dd4 
Hero: folds
cb83453e: folds
84c84dd4: raises $0.05 to $0.1
4b9df3fe: folds
560bbe0d: folds
f6bf8dfb: folds
Uncalled bet ($0.05) returned to 84c84dd4
*** SHOWDOWN ***
84c84dd4 collected $0.12 from pot
*** SUMMARY ***
Total pot $0.12 | Rake $0 | Jackpot $0 | Bingo $0 | Fortune $0 | Tax $0
Seat 1: 4b9df3fe (button) folded before Flop (didn't bet)
Seat 2: 560bbe0d (small blind) folded before Flop
Seat 3: f6bf8dfb (big blind) folded before Flop
Seat 4: Hero folded before Flop (didn't bet)
Seat 5: cb83453e folded before Flop (didn't bet)
Seat 6: 84c84dd4 collected ($0.12)


Poker Hand #RC3795931723: Hold'em No Limit ($0.02/$0.05) - 2025/08/10 08:31:46
Table 'RushAndCash11066983' 6-max Seat #1 is the button
Seat 1: Hero ($5.44 in chips)
Seat 2: d62070dc ($7.55 in chips)
Seat 3: 90724e8b ($9.86 in chips)
Seat 4: ec2068d4 ($5.14 in chips)
Seat 5: 4b9df3fe ($8.15 in chips)
Seat 6: 8e04bbd3 ($7.8 in chips)
d62070dc: posts small blind $0.02
90724e8b: posts big blind $0.05
*** HOLE CARDS ***
Dealt to Hero [9d 8s]
Dealt to d62070dc 
Dealt to 90724e8b 
Dealt to ec2068d4 
Dealt to 4b9df3fe 
Dealt to 8e04bbd3 
ec2068d4: folds
4b9df3fe: folds
8e04bbd3: folds
Hero: folds
d62070dc: calls $0.03
90724e8b: checks
*** FLOP *** [5h Qd 3s]
d62070dc: bets $0.05
90724e8b: calls $0.05
*** TURN *** [5h Qd 3s] [2d]
d62070dc: bets $0.05
90724e8b: raises $0.15 to $0.2
d62070dc: folds
Uncalled bet ($0.15) returned to 90724e8b
*** SHOWDOWN ***
90724e8b collected $0.29 from pot
*** SUMMARY ***
Total pot $0.3 | Rake $0.01 | Jackpot $0 | Bingo $0 | Fortune $0 | Tax $0
Board [5h Qd 3s 2d]
Seat 1: Hero (button) folded before Flop (didn't bet)
Seat 2: d62070dc (small blind) folded on the Turn
Seat 3: 90724e8b (big blind) won ($0.29)
Seat 4: ec2068d4 folded before Flop (didn't bet)
Seat 5: 4b9df3fe folded before Flop (didn't bet)
Seat 6: 8e04bbd3 folded before Flop (didn't bet)


Poker Hand #RC3795931708: Hold'em No Limit ($0.02/$0.05) - 2025/08/10 08:31:42
Table 'RushAndCash11066968' 6-max Seat #1 is the button
Seat 1: d6378e6 ($6.36 in chips)
Seat 2: Hero ($5.46 in chips)
Seat 3: 4cd607b4 ($8.39 in chips)
Seat 4: fe6e4f5c ($5.19 in chips)
Seat 5: 8b390e1e ($5.1 in chips)
Seat 6: 9b73cb59 ($5.66 in chips)
Hero: posts small blind $0.02
4cd607b4: posts big blind $0.05
*** HOLE CARDS ***
Dealt to d6378e6 
Dealt to Hero [Jc 4c]
Dealt to 4cd607b4 
Dealt to fe6e4f5c 
Dealt to 8b390e1e 
Dealt to 9b73cb59 
fe6e4f5c: folds
8b390e1e: folds
9b73cb59: folds
d6378e6: folds
Hero: folds
Uncalled bet ($0.03) returned to 4cd607b4
*** SHOWDOWN ***
4cd607b4 collected $0.04 from pot
*** SUMMARY ***
Total pot $0.04 | Rake $0 | Jackpot $0 | Bingo $0 | Fortune $0 | Tax $0
Seat 1: d6378e6 (button) folded before Flop (didn't bet)
Seat 2: Hero (small blind) folded before Flop
Seat 3: 4cd607b4 (big blind) collected ($0.04)
Seat 4: fe6e4f5c folded before Flop (didn't bet)
Seat 5: 8b390e1e folded before Flop (didn't bet)
Seat 6: 9b73cb59 folded before Flop (didn't bet)


Poker Hand #RC3795931586: Hold'em No Limit ($0.02/$0.05) - 2025/08/10 08:31:07
Table 'RushAndCash11066846' 6-max Seat #1 is the button
Seat 1: 8e04bbd3 ($7.87 in chips)
Seat 2: 9b73cb59 ($5.52 in chips)
Seat 3: afbe94ee ($5.77 in chips)
Seat 4: a57b331d ($25.12 in chips)
Seat 5: Hero ($5.56 in chips)
Seat 6: f0e15475 ($8.07 in chips)
9b73cb59: posts small blind $0.02
afbe94ee: posts big blind $0.05
*** HOLE CARDS ***
Dealt to 8e04bbd3 
Dealt to 9b73cb59 
Dealt to afbe94ee 
Dealt to a57b331d 
Dealt to Hero [Jc Ks]
Dealt to f0e15475 
a57b331d: folds
Hero: raises $0.05 to $0.1
f0e15475: folds
8e04bbd3: folds
9b73cb59: raises $0.4 to $0.5
afbe94ee: folds
Hero: folds
Uncalled bet ($0.4) returned to 9b73cb59
*** SHOWDOWN ***
9b73cb59 collected $0.24 from pot
*** SUMMARY ***
Total pot $0.25 | Rake $0.01 | Jackpot $0 | Bingo $0 | Fortune $0 | Tax $0
Seat 1: 8e04bbd3 (button) folded before Flop (didn't bet)
Seat 2: 9b73cb59 (small blind) collected ($0.24)
Seat 3: afbe94ee (big blind) folded before Flop
Seat 4: a57b331d folded before Flop (didn't bet)
Seat 5: Hero folded before Flop
Seat 6: f0e15475 folded before Flop (didn't bet)


Poker Hand #RC3795931530: Hold'em No Limit ($0.02/$0.05) - 2025/08/10 08:30:51
Table 'RushAndCash11066790' 6-max Seat #1 is the button
Seat 1: 2b56ac20 ($12 in chips)
Seat 2: 59da8582 ($13.1 in chips)
Seat 3: Hero ($5.61 in chips)
Seat 4: 28c1300c ($5.37 in chips)
Seat 5: 7a644870 ($5.95 in chips)
Seat 6: f76279b5 ($13.71 in chips)
59da8582: posts small blind $0.02
Hero: posts big blind $0.05
*** HOLE CARDS ***
Dealt to 2b56ac20 
Dealt to 59da8582 
Dealt to Hero [8c 5d]
Dealt to 28c1300c 
Dealt to 7a644870 
Dealt to f76279b5 
28c1300c: folds
7a644870: raises $0.08 to $0.13
f76279b5: folds
2b56ac20: folds
59da8582: folds
Hero: folds
Uncalled bet ($0.08) returned to 7a644870
*** SHOWDOWN ***
7a644870 collected $0.12 from pot
*** SUMMARY ***
Total pot $0.12 | Rake $0 | Jackpot $0 | Bingo $0 | Fortune $0 | Tax $0
Seat 1: 2b56ac20 (button) folded before Flop (didn't bet)
Seat 2: 59da8582 (small blind) folded before Flop
Seat 3: Hero (big blind) folded before Flop
Seat 4: 28c1300c folded before Flop (didn't bet)
Seat 5: 7a644870 collected ($0.12)
Seat 6: f76279b5 folded before Flop (didn't bet)


Poker Hand #RC3795931515: Hold'em No Limit ($0.02/$0.05) - 2025/08/10 08:30:47
Table 'RushAndCash11066775' 6-max Seat #1 is the button
Seat 1: cbd251ea ($6.44 in chips)
Seat 2: ddd082ae ($4.83 in chips)
Seat 3: 560bbe0d ($14.67 in chips)
Seat 4: 9095f6a6 ($5 in chips)
Seat 5: Hero ($5.61 in chips)
Seat 6: cf791d0b ($5.04 in chips)
ddd082ae: posts small blind $0.02
560bbe0d: posts big blind $0.05
*** HOLE CARDS ***
Dealt to cbd251ea 
Dealt to ddd082ae 
Dealt to 560bbe0d 
Dealt to 9095f6a6 
Dealt to Hero [7h 8c]
Dealt to cf791d0b 
9095f6a6: folds
Hero: folds
cf791d0b: folds
cbd251ea: raises $0.05 to $0.1
ddd082ae: raises $0.35 to $0.45
560bbe0d: folds
cbd251ea: folds
Uncalled bet ($0.35) returned to ddd082ae
*** SHOWDOWN ***
ddd082ae collected $0.24 from pot
*** SUMMARY ***
Total pot $0.25 | Rake $0.01 | Jackpot $0 | Bingo $0 | Fortune $0 | Tax $0
Seat 1: cbd251ea (button) folded before Flop
Seat 2: ddd082ae (small blind) collected ($0.24)
Seat 3: 560bbe0d (big blind) folded before Flop
Seat 4: 9095f6a6 folded before Flop (didn't bet)
Seat 5: Hero folded before Flop (didn't bet)
Seat 6: cf791d0b folded before Flop (didn't bet)


Poker Hand #RC3795931497: Hold'em No Limit ($0.02/$0.05) - 2025/08/10 08:30:42
Table 'RushAndCash11066757' 6-max Seat #1 is the button
Seat 1: d62070dc ($8.02 in chips)
Seat 2: 97f832bf ($12.91 in chips)
Seat 3: 3a68afa9 ($5.43 in chips)
Seat 4: 848c5954 ($6.08 in chips)
Seat 5: 63124400 ($14.07 in chips)
Seat 6: Hero ($5.61 in chips)
97f832bf: posts small blind $0.02
3a68afa9: posts big blind $0.05
*** HOLE CARDS ***
Dealt to d62070dc 
Dealt to 97f832bf 
Dealt to 3a68afa9 
Dealt to 848c5954 
Dealt to 63124400 
Dealt to Hero [Kd 8s]
848c5954: folds
63124400: folds
Hero: folds
d62070dc: folds
97f832bf: calls $0.03
3a68afa9: checks
*** FLOP *** [3c Qh 3h]
97f832bf: bets $0.05
3a68afa9: folds
Uncalled bet ($0.05) returned to 97f832bf
*** SHOWDOWN ***
97f832bf collected $0.1 from pot
*** SUMMARY ***
Total pot $0.1 | Rake $0 | Jackpot $0 | Bingo $0 | Fortune $0 | Tax $0
Board [3c Qh 3h]
Seat 1: d62070dc (button) folded before Flop (didn't bet)
Seat 2: 97f832bf (small blind) won ($0.1)
Seat 3: 3a68afa9 (big blind) folded on the Flop
Seat 4: 848c5954 folded before Flop (didn't bet)
Seat 5: 63124400 folded before Flop (didn't bet)
Seat 6: Hero folded before Flop (didn't bet)


Poker Hand #RC3795931485: Hold'em No Limit ($0.02/$0.05) - 2025/08/10 08:30:38
Table 'RushAndCash11066745' 6-max Seat #1 is the button
Seat 1: d6622c4a ($5.85 in chips)
Seat 2: 41ed372d ($5.86 in chips)
Seat 3: 5d71c963 ($8.33 in chips)
Seat 4: Hero ($5.61 in chips)
Seat 5: 22e09f8 ($10.24 in chips)
Seat 6: e7757e1d ($6.21 in chips)
41ed372d: posts small blind $0.02
5d71c963: posts big blind $0.05
*** HOLE CARDS ***
Dealt to d6622c4a 
Dealt to 41ed372d 
Dealt to 5d71c963 
Dealt to Hero [Td 7s]
Dealt to 22e09f8 
Dealt to e7757e1d 
Hero: folds
22e09f8: folds
e7757e1d: folds
d6622c4a: folds
41ed372d: raises $0.11 to $0.16
5d71c963: folds
Uncalled bet ($0.11) returned to 41ed372d
*** SHOWDOWN ***
41ed372d collected $0.1 from pot
*** SUMMARY ***
Total pot $0.1 | Rake $0 | Jackpot $0 | Bingo $0 | Fortune $0 | Tax $0
Seat 1: d6622c4a (button) folded before Flop (didn't bet)
Seat 2: 41ed372d (small blind) collected ($0.1)
Seat 3: 5d71c963 (big blind) folded before Flop
Seat 4: Hero folded before Flop (didn't bet)
Seat 5: 22e09f8 folded before Flop (didn't bet)
Seat 6: e7757e1d folded before Flop (didn't bet)


Poker Hand #RC3795931414: Hold'em No Limit ($0.02/$0.05) - 2025/08/10 08:30:18
Table 'RushAndCash11066674' 6-max Seat #1 is the button
Seat 1: 98e1d0ba ($5.09 in chips)
Seat 2: 1eef3559 ($11.16 in chips)
Seat 3: Hero ($5.59 in chips)
Seat 4: 2c53d2c7 ($6.55 in chips)
Seat 5: 42c31e1a ($12.38 in chips)
Seat 6: 7a644870 ($5.95 in chips)
1eef3559: posts small blind $0.02
Hero: posts big blind $0.05
*** HOLE CARDS ***
Dealt to 98e1d0ba 
Dealt to 1eef3559 
Dealt to Hero [Ac 8d]
Dealt to 2c53d2c7 
Dealt to 42c31e1a 
Dealt to 7a644870 
2c53d2c7: folds
42c31e1a: folds
7a644870: folds
98e1d0ba: folds
1eef3559: folds
Uncalled bet ($0.03) returned to Hero
*** SHOWDOWN ***
Hero collected $0.04 from pot
*** SUMMARY ***
Total pot $0.04 | Rake $0 | Jackpot $0 | Bingo $0 | Fortune $0 | Tax $0
Seat 1: 98e1d0ba (button) folded before Flop (didn't bet)
Seat 2: 1eef3559 (small blind) folded before Flop
Seat 3: Hero (big blind) collected ($0.04)
Seat 4: 2c53d2c7 folded before Flop (didn't bet)
Seat 5: 42c31e1a folded before Flop (didn't bet)
Seat 6: 7a644870 folded before Flop (didn't bet)


Poker Hand #RC3795931337: Hold'em No Limit ($0.02/$0.05) - 2025/08/10 08:29:57
Table 'RushAndCash11066597' 6-max Seat #1 is the button
Seat 1: fccf4928 ($11.02 in chips)
Seat 2: Hero ($5.54 in chips)
Seat 3: 34f17b0d ($8.67 in chips)
Seat 4: cd7dffc4 ($5.04 in chips)
Seat 5: fab46f2c ($12.04 in chips)
Seat 6: 92d348ff ($13.47 in chips)
Hero: posts small blind $0.02
34f17b0d: posts big blind $0.05
*** HOLE CARDS ***
Dealt to fccf4928 
Dealt to Hero [2c Kc]
Dealt to 34f17b0d 
Dealt to cd7dffc4 
Dealt to fab46f2c 
Dealt to 92d348ff 
cd7dffc4: folds
fab46f2c: folds
92d348ff: folds
fccf4928: folds
Hero: calls $0.03
34f17b0d: checks
*** FLOP *** [3c As 6c]
Hero: bets $0.05
34f17b0d: folds
Uncalled bet ($0.05) returned to Hero
*** SHOWDOWN ***
Hero collected $0.1 from pot
*** SUMMARY ***
Total pot $0.1 | Rake $0 | Jackpot $0 | Bingo $0 | Fortune $0 | Tax $0
Board [3c As 6c]
Seat 1: fccf4928 (button) folded before Flop (didn't bet)
Seat 2: Hero (small blind) won ($0.1)
Seat 3: 34f17b0d (big blind) folded on the Flop
Seat 4: cd7dffc4 folded before Flop (didn't bet)
Seat 5: fab46f2c folded before Flop (didn't bet)
Seat 6: 92d348ff folded before Flop (didn't bet)


Poker Hand #RC3795931326: Hold'em No Limit ($0.02/$0.05) - 2025/08/10 08:29:53
Table 'RushAndCash11066586' 6-max Seat #1 is the button
Seat 1: ac25def9 ($5 in chips)
Seat 2: fa60e706 ($10.25 in chips)
Seat 3: 4844e57f ($8.96 in chips)
Seat 4: Hero ($5.54 in chips)
Seat 5: 7244fd77 ($5 in chips)
Seat 6: c70d3b17 ($10.16 in chips)
fa60e706: posts small blind $0.02
4844e57f: posts big blind $0.05
*** HOLE CARDS ***
Dealt to ac25def9 
Dealt to fa60e706 
Dealt to 4844e57f 
Dealt to Hero [Th 5s]
Dealt to 7244fd77 
Dealt to c70d3b17 
Hero: folds
7244fd77: folds
c70d3b17: raises $0.1 to $0.15
ac25def9: folds
fa60e706: folds
4844e57f: folds
Uncalled bet ($0.1) returned to c70d3b17
*** SHOWDOWN ***
c70d3b17 collected $0.12 from pot
*** SUMMARY ***
Total pot $0.12 | Rake $0 | Jackpot $0 | Bingo $0 | Fortune $0 | Tax $0
Seat 1: ac25def9 (button) folded before Flop (didn't bet)
Seat 2: fa60e706 (small blind) folded before Flop
Seat 3: 4844e57f (big blind) folded before Flop
Seat 4: Hero folded before Flop (didn't bet)
Seat 5: 7244fd77 folded before Flop (didn't bet)
Seat 6: c70d3b17 collected ($0.12)


Poker Hand #RC3795931298: Hold'em No Limit ($0.02/$0.05) - 2025/08/10 08:29:46
Table 'RushAndCash11066558' 6-max Seat #1 is the button
Seat 1: Hero ($5.54 in chips)
Seat 2: 5b54e251 ($12.08 in chips)
Seat 3: d27c038b ($3.35 in chips)
Seat 4: 9d70d038 ($17.15 in chips)
Seat 5: 89697fca ($5.35 in chips)
Seat 6: 2b56ac20 ($12.05 in chips)
5b54e251: posts small blind $0.02
d27c038b: posts big blind $0.05
*** HOLE CARDS ***
Dealt to Hero [4c 3s]
Dealt to 5b54e251 
Dealt to d27c038b 
Dealt to 9d70d038 
Dealt to 89697fca 
Dealt to 2b56ac20 
9d70d038: folds
89697fca: folds
2b56ac20: folds
Hero: folds
5b54e251: raises $0.07 to $0.12
d27c038b: folds
Uncalled bet ($0.07) returned to 5b54e251
*** SHOWDOWN ***
5b54e251 collected $0.1 from pot
*** SUMMARY ***
Total pot $0.1 | Rake $0 | Jackpot $0 | Bingo $0 | Fortune $0 | Tax $0
Seat 1: Hero (button) folded before Flop (didn't bet)
Seat 2: 5b54e251 (small blind) collected ($0.1)
Seat 3: d27c038b (big blind) folded before Flop
Seat 4: 9d70d038 folded before Flop (didn't bet)
Seat 5: 89697fca folded before Flop (didn't bet)
Seat 6: 2b56ac20 folded before Flop (didn't bet)


Poker Hand #RC3795931126: Hold'em No Limit ($0.02/$0.05) - 2025/08/10 08:28:56
Table 'RushAndCash11066386' 6-max Seat #1 is the button
Seat 1: 7244fd77 ($5.05 in chips)
Seat 2: db3b59eb ($8.61 in chips)
Seat 3: 949b5efc ($5.26 in chips)
Seat 4: c47898d9 ($5 in chips)
Seat 5: a57b331d ($25.76 in chips)
Seat 6: Hero ($5.64 in chips)
db3b59eb: posts small blind $0.02
949b5efc: posts big blind $0.05
*** HOLE CARDS ***
Dealt to 7244fd77 
Dealt to db3b59eb 
Dealt to 949b5efc 
Dealt to c47898d9 
Dealt to a57b331d 
Dealt to Hero [8d 8c]
c47898d9: raises $0.05 to $0.1
a57b331d: folds
Hero: calls $0.1
7244fd77: folds
db3b59eb: folds
949b5efc: calls $0.05
*** FLOP *** [6c Ad Ks]
949b5efc: checks
c47898d9: checks
Hero: checks
*** TURN *** [6c Ad Ks] [6h]
949b5efc: bets $0.16
c47898d9: folds
Hero: folds
Uncalled bet ($0.16) returned to 949b5efc
*** SHOWDOWN ***
949b5efc collected $0.31 from pot
*** SUMMARY ***
Total pot $0.32 | Rake $0.01 | Jackpot $0 | Bingo $0 | Fortune $0 | Tax $0
Board [6c Ad Ks 6h]
Seat 1: 7244fd77 (button) folded before Flop (didn't bet)
Seat 2: db3b59eb (small blind) folded before Flop
Seat 3: 949b5efc (big blind) won ($0.31)
Seat 4: c47898d9 folded on the Turn
Seat 5: a57b331d folded before Flop (didn't bet)
Seat 6: Hero folded on the Turn


Poker Hand #RC3795931111: Hold'em No Limit ($0.02/$0.05) - 2025/08/10 08:28:52
Table 'RushAndCash11066371' 6-max Seat #1 is the button
Seat 1: a63176ef ($3.78 in chips)
Seat 2: c060ff0e ($6.01 in chips)
Seat 3: b3cc8379 ($5.01 in chips)
Seat 4: Hero ($5.64 in chips)
Seat 5: dd92de38 ($5.71 in chips)
Seat 6: f3a1d090 ($23.28 in chips)
c060ff0e: posts small blind $0.02
b3cc8379: posts big blind $0.05
*** HOLE CARDS ***
Dealt to a63176ef 
Dealt to c060ff0e 
Dealt to b3cc8379 
Dealt to Hero [3c 9c]
Dealt to dd92de38 
Dealt to f3a1d090 
Hero: folds
dd92de38: folds
f3a1d090: folds
a63176ef: folds
c060ff0e: calls $0.03
b3cc8379: checks
*** FLOP *** [6h 3h Kd]
c060ff0e: bets $0.05
b3cc8379: folds
Uncalled bet ($0.05) returned to c060ff0e
*** SHOWDOWN ***
c060ff0e collected $0.1 from pot
*** SUMMARY ***
Total pot $0.1 | Rake $0 | Jackpot $0 | Bingo $0 | Fortune $0 | Tax $0
Board [6h 3h Kd]
Seat 1: a63176ef (button) folded before Flop (didn't bet)
Seat 2: c060ff0e (small blind) won ($0.1)
Seat 3: b3cc8379 (big blind) folded on the Flop
Seat 4: Hero folded before Flop (didn't bet)
Seat 5: dd92de38 folded before Flop (didn't bet)
Seat 6: f3a1d090 folded before Flop (didn't bet)


Poker Hand #RC3795930950: Hold'em No Limit ($0.02/$0.05) - 2025/08/10 08:28:09
Table 'RushAndCash11066210' 6-max Seat #1 is the button
Seat 1: 22b1f4df ($10.04 in chips)
Seat 2: dd92de38 ($5.81 in chips)
Seat 3: Hero ($5.55 in chips)
Seat 4: e400ddd3 ($6 in chips)
Seat 5: cbd251ea ($6.28 in chips)
Seat 6: 6dc54533 ($42.72 in chips)
dd92de38: posts small blind $0.02
Hero: posts big blind $0.05
*** HOLE CARDS ***
Dealt to 22b1f4df 
Dealt to dd92de38 
Dealt to Hero [7h Kh]
Dealt to e400ddd3 
Dealt to cbd251ea 
Dealt to 6dc54533 
e400ddd3: folds
cbd251ea: folds
6dc54533: folds
22b1f4df: folds
dd92de38: raises $0.05 to $0.1
Hero: calls $0.05
*** FLOP *** [Jh 6s 9d]
dd92de38: checks
Hero: checks
*** TURN *** [Jh 6s 9d] [8h]
dd92de38: checks
Hero: bets $0.16
dd92de38: folds
Uncalled bet ($0.16) returned to Hero
*** SHOWDOWN ***
Hero collected $0.19 from pot
*** SUMMARY ***
Total pot $0.2 | Rake $0.01 | Jackpot $0 | Bingo $0 | Fortune $0 | Tax $0
Board [Jh 6s 9d 8h]
Seat 1: 22b1f4df (button) folded before Flop (didn't bet)
Seat 2: dd92de38 (small blind) folded on the Turn
Seat 3: Hero (big blind) won ($0.19)
Seat 4: e400ddd3 folded before Flop (didn't bet)
Seat 5: cbd251ea folded before Flop (didn't bet)
Seat 6: 6dc54533 folded before Flop (didn't bet)


Poker Hand #RC3795930840: Hold'em No Limit ($0.02/$0.05) - 2025/08/10 08:27:37
Table 'RushAndCash11066100' 6-max Seat #1 is the button
Seat 1: Hero ($5.65 in chips)
Seat 2: 6fb6dc41 ($7.76 in chips)
Seat 3: e39c6e6a ($5.03 in chips)
Seat 4: ac25def9 ($5 in chips)
Seat 5: 2b5a7a1b ($10.93 in chips)
Seat 6: 6369b6bc ($5 in chips)
6fb6dc41: posts small blind $0.02
e39c6e6a: posts big blind $0.05
*** HOLE CARDS ***
Dealt to Hero [Ks Jh]
Dealt to 6fb6dc41 
Dealt to e39c6e6a 
Dealt to ac25def9 
Dealt to 2b5a7a1b 
Dealt to 6369b6bc 
ac25def9: folds
2b5a7a1b: folds
6369b6bc: raises $0.05 to $0.1
Hero: calls $0.1
6fb6dc41: folds
e39c6e6a: folds
*** FLOP *** [2s Ah 3c]
6369b6bc: bets $0.08
Hero: folds
Uncalled bet ($0.08) returned to 6369b6bc
*** SHOWDOWN ***
6369b6bc collected $0.26 from pot
*** SUMMARY ***
Total pot $0.27 | Rake $0.01 | Jackpot $0 | Bingo $0 | Fortune $0 | Tax $0
Board [2s Ah 3c]
Seat 1: Hero (button) folded on the Flop
Seat 2: 6fb6dc41 (small blind) folded before Flop
Seat 3: e39c6e6a (big blind) folded before Flop
Seat 4: ac25def9 folded before Flop (didn't bet)
Seat 5: 2b5a7a1b folded before Flop (didn't bet)
Seat 6: 6369b6bc won ($0.26)


Poker Hand #RC3795930822: Hold'em No Limit ($0.02/$0.05) - 2025/08/10 08:27:33
Table 'RushAndCash11066082' 6-max Seat #1 is the button
Seat 1: 210c8e9b ($15.17 in chips)
Seat 2: 7a09703 ($7.08 in chips)
Seat 3: dd92de38 ($5.88 in chips)
Seat 4: 63124400 ($14.39 in chips)
Seat 5: 3f43d5e9 ($3.6 in chips)
Seat 6: Hero ($5.65 in chips)
7a09703: posts small blind $0.02
dd92de38: posts big blind $0.05
*** HOLE CARDS ***
Dealt to 210c8e9b 
Dealt to 7a09703 
Dealt to dd92de38 
Dealt to 63124400 
Dealt to 3f43d5e9 
Dealt to Hero [2c 3d]
63124400: folds
3f43d5e9: raises $0.05 to $0.1
Hero: folds
210c8e9b: raises $0.21 to $0.31
7a09703: folds
dd92de38: folds
3f43d5e9: folds
Uncalled bet ($0.21) returned to 210c8e9b
*** SHOWDOWN ***
210c8e9b collected $0.26 from pot
*** SUMMARY ***
Total pot $0.27 | Rake $0.01 | Jackpot $0 | Bingo $0 | Fortune $0 | Tax $0
Seat 1: 210c8e9b (button) collected ($0.26)
Seat 2: 7a09703 (small blind) folded before Flop
Seat 3: dd92de38 (big blind) folded before Flop
Seat 4: 63124400 folded before Flop (didn't bet)
Seat 5: 3f43d5e9 folded before Flop
Seat 6: Hero folded before Flop (didn't bet)


Poker Hand #RC3795930703: Hold'em No Limit ($0.02/$0.05) - 2025/08/10 08:26:59
Table 'RushAndCash11065963' 6-max Seat #1 is the button
Seat 1: 59da8582 ($13.54 in chips)
Seat 2: Hero ($5.51 in chips)
Seat 3: 210c8e9b ($15.32 in chips)
Seat 4: ccbf95f3 ($6.53 in chips)
Seat 5: d8b9a478 ($5.89 in chips)
Seat 6: 73869740 ($5.12 in chips)
Hero: posts small blind $0.02
210c8e9b: posts big blind $0.05
*** HOLE CARDS ***
Dealt to 59da8582 
Dealt to Hero [Kh As]
Dealt to 210c8e9b 
Dealt to ccbf95f3 
Dealt to d8b9a478 
Dealt to 73869740 
ccbf95f3: folds
d8b9a478: folds
73869740: folds
59da8582: folds
Hero: raises $0.1 to $0.15
210c8e9b: calls $0.1
*** FLOP *** [8h Qh Tc]
Hero: bets $0.15
210c8e9b: folds
Uncalled bet ($0.15) returned to Hero
*** SHOWDOWN ***
Hero collected $0.29 from pot
*** SUMMARY ***
Total pot $0.3 | Rake $0.01 | Jackpot $0 | Bingo $0 | Fortune $0 | Tax $0
Board [8h Qh Tc]
Seat 1: 59da8582 (button) folded before Flop (didn't bet)
Seat 2: Hero (small blind) won ($0.29)
Seat 3: 210c8e9b (big blind) folded on the Flop
Seat 4: ccbf95f3 folded before Flop (didn't bet)
Seat 5: d8b9a478 folded before Flop (didn't bet)
Seat 6: 73869740 folded before Flop (didn't bet)


Poker Hand #RC3795930666: Hold'em No Limit ($0.02/$0.05) - 2025/08/10 08:26:49
Table 'RushAndCash11065926' 6-max Seat #1 is the button
Seat 1: Hero ($5.51 in chips)
Seat 2: 5e046aad ($5.02 in chips)
Seat 3: e90b1294 ($5 in chips)
Seat 4: ac25def9 ($5 in chips)
Seat 5: b3da168 ($10.17 in chips)
Seat 6: 483f17c3 ($16.16 in chips)
5e046aad: posts small blind $0.02
e90b1294: posts big blind $0.05
*** HOLE CARDS ***
Dealt to Hero [7s 6c]
Dealt to 5e046aad 
Dealt to e90b1294 
Dealt to ac25def9 
Dealt to b3da168 
Dealt to 483f17c3 
ac25def9: folds
b3da168: raises $0.08 to $0.13
483f17c3: folds
Hero: folds
5e046aad: folds
e90b1294: calls $0.08
*** FLOP *** [3c 8d Qc]
e90b1294: checks
b3da168: bets $0.08
e90b1294: folds
Uncalled bet ($0.08) returned to b3da168
*** SHOWDOWN ***
b3da168 collected $0.27 from pot
*** SUMMARY ***
Total pot $0.28 | Rake $0.01 | Jackpot $0 | Bingo $0 | Fortune $0 | Tax $0
Board [3c 8d Qc]
Seat 1: Hero (button) folded before Flop (didn't bet)
Seat 2: 5e046aad (small blind) folded before Flop
Seat 3: e90b1294 (big blind) folded on the Flop
Seat 4: ac25def9 folded before Flop (didn't bet)
Seat 5: b3da168 won ($0.27)
Seat 6: 483f17c3 folded before Flop (didn't bet)


Poker Hand #RC3795930652: Hold'em No Limit ($0.02/$0.05) - 2025/08/10 08:26:46
Table 'RushAndCash11065912' 6-max Seat #1 is the button
Seat 1: 43f64b9b ($7.23 in chips)
Seat 2: 17b790ab ($7.23 in chips)
Seat 3: d62070dc ($8.02 in chips)
Seat 4: Hero ($5.51 in chips)
Seat 5: 41b0f5c2 ($5.58 in chips)
Seat 6: 2d1b3dec ($9.08 in chips)
17b790ab: posts small blind $0.02
d62070dc: posts big blind $0.05
*** HOLE CARDS ***
Dealt to 43f64b9b 
Dealt to 17b790ab 
Dealt to d62070dc 
Dealt to Hero [9d 2c]
Dealt to 41b0f5c2 
Dealt to 2d1b3dec 
Hero: folds
41b0f5c2: raises $0.1 to $0.15
2d1b3dec: raises $0.28 to $0.43
43f64b9b: folds
17b790ab: folds
d62070dc: folds
41b0f5c2: raises $5.07 to $5.5
2d1b3dec: folds
Uncalled bet ($5.07) returned to 41b0f5c2
*** SHOWDOWN ***
41b0f5c2 collected $0.89 from pot
*** SUMMARY ***
Total pot $0.93 | Rake $0.04 | Jackpot $0 | Bingo $0 | Fortune $0 | Tax $0
Seat 1: 43f64b9b (button) folded before Flop (didn't bet)
Seat 2: 17b790ab (small blind) folded before Flop
Seat 3: d62070dc (big blind) folded before Flop
Seat 4: Hero folded before Flop (didn't bet)
Seat 5: 41b0f5c2 collected ($0.89)
Seat 6: 2d1b3dec folded before Flop


Poker Hand #RC3795930408: Hold'em No Limit ($0.02/$0.05) - 2025/08/10 08:25:40
Table 'RushAndCash11065668' 6-max Seat #1 is the button
Seat 1: 3f5c4b90 ($8.48 in chips)
Seat 2: Hero ($5.18 in chips)
Seat 3: aa95eeae ($5 in chips)
Seat 4: a9536656 ($6.06 in chips)
Seat 5: 7e9b978a ($5.76 in chips)
Seat 6: 9e0c2202 ($6.31 in chips)
Hero: posts small blind $0.02
aa95eeae: posts big blind $0.05
*** HOLE CARDS ***
Dealt to 3f5c4b90 
Dealt to Hero [8h Qh]
Dealt to aa95eeae 
Dealt to a9536656 
Dealt to 7e9b978a 
Dealt to 9e0c2202 
a9536656: folds
7e9b978a: folds
9e0c2202: folds
3f5c4b90: folds
Hero: calls $0.03
aa95eeae: raises $0.13 to $0.18
Hero: calls $0.13
*** FLOP *** [5s Qd 9c]
Hero: checks
aa95eeae: checks
*** TURN *** [5s Qd 9c] [Kc]
Hero: checks
aa95eeae: bets $0.18
Hero: calls $0.18
*** RIVER *** [5s Qd 9c Kc] [3s]
Hero: checks
aa95eeae: checks
Hero: shows [8h Qh] (a pair of Queens)
aa95eeae: shows [As Jd] (Ace high)
*** SHOWDOWN ***
Hero collected $0.69 from pot
*** SUMMARY ***
Total pot $0.72 | Rake $0.03 | Jackpot $0 | Bingo $0 | Fortune $0 | Tax $0
Board [5s Qd 9c Kc 3s]
Seat 1: 3f5c4b90 (button) folded before Flop (didn't bet)
Seat 2: Hero (small blind) showed [8h Qh] and won ($0.69) with a pair of Queens
Seat 3: aa95eeae (big blind) showed [As Jd] and lost with Ace high
Seat 4: a9536656 folded before Flop (didn't bet)
Seat 5: 7e9b978a folded before Flop (didn't bet)
Seat 6: 9e0c2202 folded before Flop (didn't bet)


Poker Hand #RC3795930385: Hold'em No Limit ($0.02/$0.05) - 2025/08/10 08:25:34
Table 'RushAndCash11065645' 6-max Seat #1 is the button
Seat 1: 60b0a03d ($11.74 in chips)
Seat 2: 38df6650 ($5.61 in chips)
Seat 3: Hero ($5.23 in chips)
Seat 4: aba6f339 ($9.55 in chips)
Seat 5: 10602e70 ($0.84 in chips)
Seat 6: 41ed372d ($6.11 in chips)
38df6650: posts small blind $0.02
Hero: posts big blind $0.05
*** HOLE CARDS ***
Dealt to 60b0a03d 
Dealt to 38df6650 
Dealt to Hero [2c 9d]
Dealt to aba6f339 
Dealt to 10602e70 
Dealt to 41ed372d 
aba6f339: folds
10602e70: raises $0.1 to $0.15
41ed372d: folds
60b0a03d: calls $0.15
38df6650: folds
Hero: folds
*** FLOP *** [7d Ts 8d]
10602e70: bets $0.69 and is all-in
60b0a03d: calls $0.69
10602e70: shows [Kd Jd] (King high)
60b0a03d: shows [Ac Ah] (a pair of Aces)
*** TURN *** [7d Ts 8d] [Js]
*** RIVER *** [7d Ts 8d Js] [3d]
*** SHOWDOWN ***
10602e70 collected $1.6 from pot
*** SUMMARY ***
Total pot $1.75 | Rake $0.08 | Jackpot $0.07 | Bingo $0 | Fortune $0 | Tax $0
Board [7d Ts 8d Js 3d]
Seat 1: 60b0a03d (button) showed [Ac Ah] and lost with a pair of Aces
Seat 2: 38df6650 (small blind) folded before Flop
Seat 3: Hero (big blind) folded before Flop
Seat 4: aba6f339 folded before Flop (didn't bet)
Seat 5: 10602e70 showed [Kd Jd] and won ($1.6) with a flush King high
Seat 6: 41ed372d folded before Flop (didn't bet)


Poker Hand #RC3795930318: Hold'em No Limit ($0.02/$0.05) - 2025/08/10 08:25:19
Table 'RushAndCash11065578' 6-max Seat #1 is the button
Seat 1: 483f17c3 ($16.13 in chips)
Seat 2: dca1c3af ($7.36 in chips)
Seat 3: fdfc54bf ($14.37 in chips)
Seat 4: 4844e57f ($10.77 in chips)
Seat 5: d3b2bf87 ($7.05 in chips)
Seat 6: Hero ($5.16 in chips)
dca1c3af: posts small blind $0.02
fdfc54bf: posts big blind $0.05
*** HOLE CARDS ***
Dealt to 483f17c3 
Dealt to dca1c3af 
Dealt to fdfc54bf 
Dealt to 4844e57f 
Dealt to d3b2bf87 
Dealt to Hero [Js Ac]
4844e57f: folds
d3b2bf87: folds
Hero: raises $0.05 to $0.1
483f17c3: folds
dca1c3af: folds
fdfc54bf: folds
Uncalled bet ($0.05) returned to Hero
*** SHOWDOWN ***
Hero collected $0.12 from pot
*** SUMMARY ***
Total pot $0.12 | Rake $0 | Jackpot $0 | Bingo $0 | Fortune $0 | Tax $0
Seat 1: 483f17c3 (button) folded before Flop (didn't bet)
Seat 2: dca1c3af (small blind) folded before Flop
Seat 3: fdfc54bf (big blind) folded before Flop
Seat 4: 4844e57f folded before Flop (didn't bet)
Seat 5: d3b2bf87 folded before Flop (didn't bet)
Seat 6: Hero collected ($0.12)


Poker Hand #RC3795930303: Hold'em No Limit ($0.02/$0.05) - 2025/08/10 08:25:15
Table 'RushAndCash11065563' 6-max Seat #1 is the button
Seat 1: fd4f7f89 ($5.85 in chips)
Seat 2: 5b54e251 ($12.19 in chips)
Seat 3: b20ee94e ($12.84 in chips)
Seat 4: Hero ($5.16 in chips)
Seat 5: 2c28207b ($7.35 in chips)
Seat 6: 880ef146 ($8.9 in chips)
5b54e251: posts small blind $0.02
b20ee94e: posts big blind $0.05
*** HOLE CARDS ***
Dealt to fd4f7f89 
Dealt to 5b54e251 
Dealt to b20ee94e 
Dealt to Hero [7c 4s]
Dealt to 2c28207b 
Dealt to 880ef146 
Hero: folds
2c28207b: folds
880ef146: raises $0.06 to $0.11
fd4f7f89: folds
5b54e251: folds
b20ee94e: folds
Uncalled bet ($0.06) returned to 880ef146
*** SHOWDOWN ***
880ef146 collected $0.12 from pot
*** SUMMARY ***
Total pot $0.12 | Rake $0 | Jackpot $0 | Bingo $0 | Fortune $0 | Tax $0
Seat 1: fd4f7f89 (button) folded before Flop (didn't bet)
Seat 2: 5b54e251 (small blind) folded before Flop
Seat 3: b20ee94e (big blind) folded before Flop
Seat 4: Hero folded before Flop (didn't bet)
Seat 5: 2c28207b folded before Flop (didn't bet)
Seat 6: 880ef146 collected ($0.12)


Poker Hand #RC3795930291: Hold'em No Limit ($0.02/$0.05) - 2025/08/10 08:25:11
Table 'RushAndCash11065551' 6-max Seat #1 is the button
Seat 1: 3f43d5e9 ($3.95 in chips)
Seat 2: be93df25 ($5.05 in chips)
Seat 3: 6e6d6019 ($7.18 in chips)
Seat 4: Hero ($5.16 in chips)
Seat 5: 9923ba8d ($5 in chips)
Seat 6: 8551ad1a ($1.93 in chips)
be93df25: posts small blind $0.02
6e6d6019: posts big blind $0.05
*** HOLE CARDS ***
Dealt to 3f43d5e9 
Dealt to be93df25 
Dealt to 6e6d6019 
Dealt to Hero [Jc 3c]
Dealt to 9923ba8d 
Dealt to 8551ad1a 
Hero: folds
9923ba8d: folds
8551ad1a: raises $0.1 to $0.15
3f43d5e9: folds
be93df25: folds
6e6d6019: folds
Uncalled bet ($0.1) returned to 8551ad1a
*** SHOWDOWN ***
8551ad1a collected $0.12 from pot
*** SUMMARY ***
Total pot $0.12 | Rake $0 | Jackpot $0 | Bingo $0 | Fortune $0 | Tax $0
Seat 1: 3f43d5e9 (button) folded before Flop (didn't bet)
Seat 2: be93df25 (small blind) folded before Flop
Seat 3: 6e6d6019 (big blind) folded before Flop
Seat 4: Hero folded before Flop (didn't bet)
Seat 5: 9923ba8d folded before Flop (didn't bet)
Seat 6: 8551ad1a collected ($0.12)


Poker Hand #RC3795930279: Hold'em No Limit ($0.02/$0.05) - 2025/08/10 08:25:07
Table 'RushAndCash11065539' 6-max Seat #1 is the button
Seat 1: cb83453e ($9.52 in chips)
Seat 2: cef92baa ($6.71 in chips)
Seat 3: 6bfa288d ($5.93 in chips)
Seat 4: Hero ($5.16 in chips)
Seat 5: cb7dd5c ($10.3 in chips)
Seat 6: ccbf95f3 ($6.48 in chips)
cef92baa: posts small blind $0.02
6bfa288d: posts big blind $0.05
*** HOLE CARDS ***
Dealt to cb83453e 
Dealt to cef92baa 
Dealt to 6bfa288d 
Dealt to Hero [Ac 8d]
Dealt to cb7dd5c 
Dealt to ccbf95f3 
Hero: folds
cb7dd5c: folds
ccbf95f3: folds
cb83453e: folds
cef92baa: folds
Uncalled bet ($0.03) returned to 6bfa288d
*** SHOWDOWN ***
6bfa288d collected $0.04 from pot
*** SUMMARY ***
Total pot $0.04 | Rake $0 | Jackpot $0 | Bingo $0 | Fortune $0 | Tax $0
Seat 1: cb83453e (button) folded before Flop (didn't bet)
Seat 2: cef92baa (small blind) folded before Flop
Seat 3: 6bfa288d (big blind) collected ($0.04)
Seat 4: Hero folded before Flop (didn't bet)
Seat 5: cb7dd5c folded before Flop (didn't bet)
Seat 6: ccbf95f3 folded before Flop (didn't bet)


Poker Hand #RC3795930253: Hold'em No Limit ($0.02/$0.05) - 2025/08/10 08:25:01
Table 'RushAndCash11065513' 6-max Seat #1 is the button
Seat 1: Hero ($5.16 in chips)
Seat 2: d3b2bf87 ($7.07 in chips)
Seat 3: 2b5a7a1b ($10.66 in chips)
Seat 4: 63124400 ($14.5 in chips)
Seat 5: a127404a ($6 in chips)
Seat 6: ccbf95f3 ($6.48 in chips)
d3b2bf87: posts small blind $0.02
2b5a7a1b: posts big blind $0.05
*** HOLE CARDS ***
Dealt to Hero [Ks Kd]
Dealt to d3b2bf87 
Dealt to 2b5a7a1b 
Dealt to 63124400 
Dealt to a127404a 
Dealt to ccbf95f3 
63124400: folds
a127404a: raises $0.05 to $0.1
ccbf95f3: folds
Hero: folds
d3b2bf87: folds
2b5a7a1b: folds
Uncalled bet ($0.05) returned to a127404a
*** SHOWDOWN ***
a127404a collected $0.12 from pot
*** SUMMARY ***
Total pot $0.12 | Rake $0 | Jackpot $0 | Bingo $0 | Fortune $0 | Tax $0
Seat 1: Hero (button) folded before Flop (didn't bet)
Seat 2: d3b2bf87 (small blind) folded before Flop
Seat 3: 2b5a7a1b (big blind) folded before Flop
Seat 4: 63124400 folded before Flop (didn't bet)
Seat 5: a127404a collected ($0.12)
Seat 6: ccbf95f3 folded before Flop (didn't bet)


Poker Hand #RC3795930234: Hold'em No Limit ($0.02/$0.05) - 2025/08/10 08:24:55
Table 'RushAndCash11065494' 6-max Seat #1 is the button
Seat 1: 117c5240 ($12.12 in chips)
Seat 2: Hero ($5.11 in chips)
Seat 3: 6bc386a7 ($5.14 in chips)
Seat 4: 12c12804 ($15.92 in chips)
Seat 5: 5e046aad ($5 in chips)
Seat 6: dd92de38 ($6.02 in chips)
Hero: posts small blind $0.02
6bc386a7: posts big blind $0.05
*** HOLE CARDS ***
Dealt to 117c5240 
Dealt to Hero [Tc 8s]
Dealt to 6bc386a7 
Dealt to 12c12804 
Dealt to 5e046aad 
Dealt to dd92de38 
12c12804: folds
5e046aad: folds
dd92de38: folds
117c5240: folds
Hero: folds
Uncalled bet ($0.03) returned to 6bc386a7
*** SHOWDOWN ***
6bc386a7 collected $0.04 from pot
*** SUMMARY ***
Total pot $0.04 | Rake $0 | Jackpot $0 | Bingo $0 | Fortune $0 | Tax $0
Seat 1: 117c5240 (button) folded before Flop (didn't bet)
Seat 2: Hero (small blind) folded before Flop
Seat 3: 6bc386a7 (big blind) collected ($0.04)
Seat 4: 12c12804 folded before Flop (didn't bet)
Seat 5: 5e046aad folded before Flop (didn't bet)
Seat 6: dd92de38 folded before Flop (didn't bet)


Poker Hand #RC3795930209: Hold'em No Limit ($0.02/$0.05) - 2025/08/10 08:24:48
Table 'RushAndCash11065469' 6-max Seat #1 is the button
Seat 1: 6a3842ba ($5.17 in chips)
Seat 2: afbe94ee ($6.13 in chips)
Seat 3: Hero ($5.16 in chips)
Seat 4: fe6e4f5c ($5 in chips)
Seat 5: 8e04bbd3 ($5.21 in chips)
Seat 6: f01023d5 ($5.66 in chips)
afbe94ee: posts small blind $0.02
Hero: posts big blind $0.05
*** HOLE CARDS ***
Dealt to 6a3842ba 
Dealt to afbe94ee 
Dealt to Hero [3h Ad]
Dealt to fe6e4f5c 
Dealt to 8e04bbd3 
Dealt to f01023d5 
fe6e4f5c: folds
8e04bbd3: folds
f01023d5: folds
6a3842ba: folds
afbe94ee: folds
Uncalled bet ($0.03) returned to Hero
*** SHOWDOWN ***
Hero collected $0.04 from pot
*** SUMMARY ***
Total pot $0.04 | Rake $0 | Jackpot $0 | Bingo $0 | Fortune $0 | Tax $0
Seat 1: 6a3842ba (button) folded before Flop (didn't bet)
Seat 2: afbe94ee (small blind) folded before Flop
Seat 3: Hero (big blind) collected ($0.04)
Seat 4: fe6e4f5c folded before Flop (didn't bet)
Seat 5: 8e04bbd3 folded before Flop (didn't bet)
Seat 6: f01023d5 folded before Flop (didn't bet)


Poker Hand #RC3795930114: Hold'em No Limit ($0.02/$0.05) - 2025/08/10 08:24:23
Table 'RushAndCash11065374' 6-max Seat #1 is the button
Seat 1: f0e15475 ($7.71 in chips)
Seat 2: f394f7bb ($8.78 in chips)
Seat 3: 9c4a9c5b ($5 in chips)
Seat 4: Hero ($5.09 in chips)
Seat 5: f6bf8dfb ($11.43 in chips)
Seat 6: 6bc386a7 ($5.19 in chips)
f394f7bb: posts small blind $0.02
9c4a9c5b: posts big blind $0.05
*** HOLE CARDS ***
Dealt to f0e15475 
Dealt to f394f7bb 
Dealt to 9c4a9c5b 
Dealt to Hero [Qc Tc]
Dealt to f6bf8dfb 
Dealt to 6bc386a7 
Hero: raises $0.05 to $0.1
f6bf8dfb: folds
6bc386a7: folds
f0e15475: folds
f394f7bb: folds
9c4a9c5b: folds
Uncalled bet ($0.05) returned to Hero
*** SHOWDOWN ***
Hero collected $0.12 from pot
*** SUMMARY ***
Total pot $0.12 | Rake $0 | Jackpot $0 | Bingo $0 | Fortune $0 | Tax $0
Seat 1: f0e15475 (button) folded before Flop (didn't bet)
Seat 2: f394f7bb (small blind) folded before Flop
Seat 3: 9c4a9c5b (big blind) folded before Flop
Seat 4: Hero collected ($0.12)
Seat 5: f6bf8dfb folded before Flop (didn't bet)
Seat 6: 6bc386a7 folded before Flop (didn't bet)


Poker Hand #RC3795930077: Hold'em No Limit ($0.02/$0.05) - 2025/08/10 08:24:11
Table 'RushAndCash11065337' 6-max Seat #1 is the button
Seat 1: 391d0c67 ($6.07 in chips)
Seat 2: Hero ($5.11 in chips)
Seat 3: 46dd31db ($5.99 in chips)
Seat 4: e792c630 ($4.98 in chips)
Seat 5: fccf4928 ($11.14 in chips)
Seat 6: 18ca1e6b ($7.75 in chips)
Hero: posts small blind $0.02
46dd31db: posts big blind $0.05
*** HOLE CARDS ***
Dealt to 391d0c67 
Dealt to Hero [2h 9c]
Dealt to 46dd31db 
Dealt to e792c630 
Dealt to fccf4928 
Dealt to 18ca1e6b 
e792c630: folds
fccf4928: folds
18ca1e6b: folds
391d0c67: folds
Hero: folds
Uncalled bet ($0.03) returned to 46dd31db
*** SHOWDOWN ***
46dd31db collected $0.04 from pot
*** SUMMARY ***
Total pot $0.04 | Rake $0 | Jackpot $0 | Bingo $0 | Fortune $0 | Tax $0
Seat 1: 391d0c67 (button) folded before Flop (didn't bet)
Seat 2: Hero (small blind) folded before Flop
Seat 3: 46dd31db (big blind) collected ($0.04)
Seat 4: e792c630 folded before Flop (didn't bet)
Seat 5: fccf4928 folded before Flop (didn't bet)
Seat 6: 18ca1e6b folded before Flop (didn't bet)


Poker Hand #RC3795930058: Hold'em No Limit ($0.02/$0.05) - 2025/08/10 08:24:06
Table 'RushAndCash11065318' 6-max Seat #1 is the button
Seat 1: f6c47f47 ($5.86 in chips)
Seat 2: f4f933a2 ($5.52 in chips)
Seat 3: Hero ($5.16 in chips)
Seat 4: a8d350f7 ($5.56 in chips)
Seat 5: 7a953fd0 ($5.61 in chips)
Seat 6: 59da8582 ($12.74 in chips)
f4f933a2: posts small blind $0.02
Hero: posts big blind $0.05
*** HOLE CARDS ***
Dealt to f6c47f47 
Dealt to f4f933a2 
Dealt to Hero [4c Jd]
Dealt to a8d350f7 
Dealt to 7a953fd0 
Dealt to 59da8582 
a8d350f7: folds
7a953fd0: folds
59da8582: raises $0.07 to $0.12
f6c47f47: raises $0.24 to $0.36
f4f933a2: folds
Hero: folds
59da8582: raises $0.6 to $0.96
f6c47f47: calls $0.6
*** FLOP *** [2c 3s Jc]
59da8582: bets $1.2
f6c47f47: folds
Uncalled bet ($1.2) returned to 59da8582
*** SHOWDOWN ***
59da8582 collected $1.83 from pot
*** SUMMARY ***
Total pot $1.99 | Rake $0.09 | Jackpot $0.07 | Bingo $0 | Fortune $0 | Tax $0
Board [2c 3s Jc]
Seat 1: f6c47f47 (button) folded on the Flop
Seat 2: f4f933a2 (small blind) folded before Flop
Seat 3: Hero (big blind) folded before Flop
Seat 4: a8d350f7 folded before Flop (didn't bet)
Seat 5: 7a953fd0 folded before Flop (didn't bet)
Seat 6: 59da8582 won ($1.83)


Poker Hand #RC3795930045: Hold'em No Limit ($0.02/$0.05) - 2025/08/10 08:24:02
Table 'RushAndCash11065305' 6-max Seat #1 is the button
Seat 1: 2b5a7a1b ($10.57 in chips)
Seat 2: 7c3a91fe ($7.58 in chips)
Seat 3: 18b1ecd7 ($5.07 in chips)
Seat 4: e018ba04 ($5 in chips)
Seat 5: Hero ($5.16 in chips)
Seat 6: 84c84dd4 ($8.26 in chips)
7c3a91fe: posts small blind $0.02
18b1ecd7: posts big blind $0.05
*** HOLE CARDS ***
Dealt to 2b5a7a1b 
Dealt to 7c3a91fe 
Dealt to 18b1ecd7 
Dealt to e018ba04 
Dealt to Hero [Jh 7d]
Dealt to 84c84dd4 
e018ba04: folds
Hero: folds
84c84dd4: folds
2b5a7a1b: folds
7c3a91fe: raises $0.08 to $0.13
18b1ecd7: folds
Uncalled bet ($0.08) returned to 7c3a91fe
*** SHOWDOWN ***
7c3a91fe collected $0.1 from pot
*** SUMMARY ***
Total pot $0.1 | Rake $0 | Jackpot $0 | Bingo $0 | Fortune $0 | Tax $0
Seat 1: 2b5a7a1b (button) folded before Flop (didn't bet)
Seat 2: 7c3a91fe (small blind) collected ($0.1)
Seat 3: 18b1ecd7 (big blind) folded before Flop
Seat 4: e018ba04 folded before Flop (didn't bet)
Seat 5: Hero folded before Flop (didn't bet)
Seat 6: 84c84dd4 folded before Flop (didn't bet)


Poker Hand #RC3795929989: Hold'em No Limit ($0.02/$0.05) - 2025/08/10 08:23:49
Table 'RushAndCash11065249' 6-max Seat #1 is the button
Seat 1: 3f43d5e9 ($4.12 in chips)
Seat 2: 38df6650 ($6.21 in chips)
Seat 3: 69bc96d4 ($5.07 in chips)
Seat 4: Hero ($5.09 in chips)
Seat 5: f6c47f47 ($5.91 in chips)
Seat 6: 63124400 ($14.62 in chips)
38df6650: posts small blind $0.02
69bc96d4: posts big blind $0.05
*** HOLE CARDS ***
Dealt to 3f43d5e9 
Dealt to 38df6650 
Dealt to 69bc96d4 
Dealt to Hero [9h 9s]
Dealt to f6c47f47 
Dealt to 63124400 
Hero: raises $0.05 to $0.1
f6c47f47: folds
63124400: folds
3f43d5e9: folds
38df6650: folds
69bc96d4: folds
Uncalled bet ($0.05) returned to Hero
*** SHOWDOWN ***
Hero collected $0.12 from pot
*** SUMMARY ***
Total pot $0.12 | Rake $0 | Jackpot $0 | Bingo $0 | Fortune $0 | Tax $0
Seat 1: 3f43d5e9 (button) folded before Flop (didn't bet)
Seat 2: 38df6650 (small blind) folded before Flop
Seat 3: 69bc96d4 (big blind) folded before Flop
Seat 4: Hero collected ($0.12)
Seat 5: f6c47f47 folded before Flop (didn't bet)
Seat 6: 63124400 folded before Flop (didn't bet)


Poker Hand #RC3795929847: Hold'em No Limit ($0.02/$0.05) - 2025/08/10 08:23:08
Table 'RushAndCash11065107' 6-max Seat #1 is the button
Seat 1: Hero ($5.19 in chips)
Seat 2: cbd251ea ($5.13 in chips)
Seat 3: f6c47f47 ($6.01 in chips)
Seat 4: fe89f771 ($5.05 in chips)
Seat 5: 38df6650 ($6 in chips)
Seat 6: c1a29539 ($7.08 in chips)
cbd251ea: posts small blind $0.02
f6c47f47: posts big blind $0.05
*** HOLE CARDS ***
Dealt to Hero [5h 8c]
Dealt to cbd251ea 
Dealt to f6c47f47 
Dealt to fe89f771 
Dealt to 38df6650 
Dealt to c1a29539 
fe89f771: folds
38df6650: raises $0.05 to $0.1
c1a29539: folds
Hero: calls $0.1
cbd251ea: folds
f6c47f47: calls $0.05
*** FLOP *** [Kd Kc Qc]
f6c47f47: checks
38df6650: bets $0.24
Hero: folds
f6c47f47: folds
Uncalled bet ($0.24) returned to 38df6650
*** SHOWDOWN ***
38df6650 collected $0.31 from pot
*** SUMMARY ***
Total pot $0.32 | Rake $0.01 | Jackpot $0 | Bingo $0 | Fortune $0 | Tax $0
Board [Kd Kc Qc]
Seat 1: Hero (button) folded on the Flop
Seat 2: cbd251ea (small blind) folded before Flop
Seat 3: f6c47f47 (big blind) folded on the Flop
Seat 4: fe89f771 folded before Flop (didn't bet)
Seat 5: 38df6650 won ($0.31)
Seat 6: c1a29539 folded before Flop (didn't bet)


Poker Hand #RC3795929619: Hold'em No Limit ($0.02/$0.05) - 2025/08/10 08:22:00
Table 'RushAndCash11064879' 6-max Seat #1 is the button
Seat 1: c1a29539 ($7.18 in chips)
Seat 2: f6c47f47 ($6.11 in chips)
Seat 3: 3f5c4b90 ($9.31 in chips)
Seat 4: Hero ($4.95 in chips)
Seat 5: cf24dfe4 ($5.78 in chips)
Seat 6: 509dbe09 ($8.49 in chips)
f6c47f47: posts small blind $0.02
3f5c4b90: posts big blind $0.05
*** HOLE CARDS ***
Dealt to c1a29539 
Dealt to f6c47f47 
Dealt to 3f5c4b90 
Dealt to Hero [Td Ac]
Dealt to cf24dfe4 
Dealt to 509dbe09 
Hero: raises $0.05 to $0.1
cf24dfe4: folds
509dbe09: folds
c1a29539: calls $0.1
f6c47f47: calls $0.08
3f5c4b90: folds
*** FLOP *** [4h 2d 8d]
f6c47f47: checks
Hero: checks
c1a29539: checks
*** TURN *** [4h 2d 8d] [4c]
f6c47f47: checks
Hero: checks
c1a29539: checks
*** RIVER *** [4h 2d 8d 4c] [6c]
f6c47f47: checks
Hero: checks
c1a29539: checks
f6c47f47: shows [9d Js] (a pair of Fours)
Hero: shows [Td Ac] (a pair of Fours)
c1a29539: shows [As 9c] (a pair of Fours)
*** SHOWDOWN ***
Hero collected $0.34 from pot
*** SUMMARY ***
Total pot $0.35 | Rake $0.01 | Jackpot $0 | Bingo $0 | Fortune $0 | Tax $0
Board [4h 2d 8d 4c 6c]
Seat 1: c1a29539 (button) showed [As 9c] and lost with a pair of Fours
Seat 2: f6c47f47 (small blind) showed [9d Js] and lost with a pair of Fours
Seat 3: 3f5c4b90 (big blind) folded before Flop
Seat 4: Hero showed [Td Ac] and won ($0.34) with a pair of Fours
Seat 5: cf24dfe4 folded before Flop (didn't bet)
Seat 6: 509dbe09 folded before Flop (didn't bet)


Poker Hand #RC3795929605: Hold'em No Limit ($0.02/$0.05) - 2025/08/10 08:21:56
Table 'RushAndCash11064865' 6-max Seat #1 is the button
Seat 1: a57b331d ($24.11 in chips)
Seat 2: 3f5c4b90 ($9.33 in chips)
Seat 3: fa1b15ba ($12.22 in chips)
Seat 4: Hero ($4.95 in chips)
Seat 5: 73869740 ($5.38 in chips)
Seat 6: 43f64b9b ($7.23 in chips)
3f5c4b90: posts small blind $0.02
fa1b15ba: posts big blind $0.05
*** HOLE CARDS ***
Dealt to a57b331d 
Dealt to 3f5c4b90 
Dealt to fa1b15ba 
Dealt to Hero [2s 2d]
Dealt to 73869740 
Dealt to 43f64b9b 
Hero: folds
73869740: folds
43f64b9b: folds
a57b331d: folds
3f5c4b90: folds
Uncalled bet ($0.03) returned to fa1b15ba
*** SHOWDOWN ***
fa1b15ba collected $0.04 from pot
*** SUMMARY ***
Total pot $0.04 | Rake $0 | Jackpot $0 | Bingo $0 | Fortune $0 | Tax $0
Seat 1: a57b331d (button) folded before Flop (didn't bet)
Seat 2: 3f5c4b90 (small blind) folded before Flop
Seat 3: fa1b15ba (big blind) collected ($0.04)
Seat 4: Hero folded before Flop (didn't bet)
Seat 5: 73869740 folded before Flop (didn't bet)
Seat 6: 43f64b9b folded before Flop (didn't bet)


Poker Hand #RC3795929591: Hold'em No Limit ($0.02/$0.05) - 2025/08/10 08:21:53
Table 'RushAndCash11064851' 6-max Seat #1 is the button
Seat 1: cef92baa ($6.81 in chips)
Seat 2: cf791d0b ($6.12 in chips)
Seat 3: 17ea5244 ($4.85 in chips)
Seat 4: bf4e2b6b ($14.66 in chips)
Seat 5: 2a76f9f5 ($8.38 in chips)
Seat 6: Hero ($4.95 in chips)
cf791d0b: posts small blind $0.02
17ea5244: posts big blind $0.05
*** HOLE CARDS ***
Dealt to cef92baa 
Dealt to cf791d0b 
Dealt to 17ea5244 
Dealt to bf4e2b6b 
Dealt to 2a76f9f5 
Dealt to Hero [5s Ts]
bf4e2b6b: folds
2a76f9f5: folds
Hero: folds
cef92baa: raises $0.06 to $0.11
cf791d0b: folds
17ea5244: calls $0.06
*** FLOP *** [4h Js 2d]
17ea5244: checks
cef92baa: bets $0.08
17ea5244: calls $0.08
*** TURN *** [4h Js 2d] [6d]
17ea5244: checks
cef92baa: checks
*** RIVER *** [4h Js 2d 6d] [5c]
17ea5244: bets $0.14
cef92baa: folds
Uncalled bet ($0.14) returned to 17ea5244
*** SHOWDOWN ***
17ea5244 collected $0.38 from pot
*** SUMMARY ***
Total pot $0.4 | Rake $0.02 | Jackpot $0 | Bingo $0 | Fortune $0 | Tax $0
Board [4h Js 2d 6d 5c]
Seat 1: cef92baa (button) folded on the River
Seat 2: cf791d0b (small blind) folded before Flop
Seat 3: 17ea5244 (big blind) won ($0.38)
Seat 4: bf4e2b6b folded before Flop (didn't bet)
Seat 5: 2a76f9f5 folded before Flop (didn't bet)
Seat 6: Hero folded before Flop (didn't bet)


Poker Hand #RC3795929415: Hold'em No Limit ($0.02/$0.05) - 2025/08/10 08:20:57
Table 'RushAndCash11064675' 6-max Seat #1 is the button
Seat 1: a63176ef ($5 in chips)
Seat 2: ec623442 ($5.18 in chips)
Seat 3: Hero ($4.6 in chips)
Seat 4: 6bc386a7 ($5.65 in chips)
Seat 5: 6a823878 ($9.74 in chips)
Seat 6: 4328ce0 ($4.05 in chips)
ec623442: posts small blind $0.02
Hero: posts big blind $0.05
*** HOLE CARDS ***
Dealt to a63176ef 
Dealt to ec623442 
Dealt to Hero [4s 8s]
Dealt to 6bc386a7 
Dealt to 6a823878 
Dealt to 4328ce0 
6bc386a7: folds
6a823878: folds
4328ce0: folds
a63176ef: folds
ec623442: raises $0.1 to $0.15
Hero: calls $0.1
*** FLOP *** [Kd 7s 8c]
ec623442: checks
Hero: checks
*** TURN *** [Kd 7s 8c] [3s]
ec623442: bets $0.23
Hero: raises $0.77 to $1
ec623442: folds
Uncalled bet ($0.77) returned to Hero
*** SHOWDOWN ***
Hero collected $0.73 from pot
*** SUMMARY ***
Total pot $0.76 | Rake $0.03 | Jackpot $0 | Bingo $0 | Fortune $0 | Tax $0
Board [Kd 7s 8c 3s]
Seat 1: a63176ef (button) folded before Flop (didn't bet)
Seat 2: ec623442 (small blind) folded on the Turn
Seat 3: Hero (big blind) won ($0.73)
Seat 4: 6bc386a7 folded before Flop (didn't bet)
Seat 5: 6a823878 folded before Flop (didn't bet)
Seat 6: 4328ce0 folded before Flop (didn't bet)


Poker Hand #RC3795929399: Hold'em No Limit ($0.02/$0.05) - 2025/08/10 08:20:52
Table 'RushAndCash11064659' 6-max Seat #1 is the button
Seat 1: Hero ($4.6 in chips)
Seat 2: 4844e57f ($11.79 in chips)
Seat 3: 7e9b978a ($5 in chips)
Seat 4: cf3b419d ($4.18 in chips)
Seat 5: e5d47869 ($7.21 in chips)
Seat 6: 43f64b9b ($7.04 in chips)
4844e57f: posts small blind $0.02
7e9b978a: posts big blind $0.05
*** HOLE CARDS ***
Dealt to Hero [6d 2c]
Dealt to 4844e57f 
Dealt to 7e9b978a 
Dealt to cf3b419d 
Dealt to e5d47869 
Dealt to 43f64b9b 
cf3b419d: folds
e5d47869: folds
43f64b9b: raises $0.05 to $0.1
Hero: folds
4844e57f: folds
7e9b978a: folds
Uncalled bet ($0.05) returned to 43f64b9b
*** SHOWDOWN ***
43f64b9b collected $0.12 from pot
*** SUMMARY ***
Total pot $0.12 | Rake $0 | Jackpot $0 | Bingo $0 | Fortune $0 | Tax $0
Seat 1: Hero (button) folded before Flop (didn't bet)
Seat 2: 4844e57f (small blind) folded before Flop
Seat 3: 7e9b978a (big blind) folded before Flop
Seat 4: cf3b419d folded before Flop (didn't bet)
Seat 5: e5d47869 folded before Flop (didn't bet)
Seat 6: 43f64b9b collected ($0.12)


Poker Hand #RC3795929383: Hold'em No Limit ($0.02/$0.05) - 2025/08/10 08:20:46
Table 'RushAndCash11064643' 6-max Seat #1 is the button
Seat 1: 42c31e1a ($13.14 in chips)
Seat 2: Hero ($4.62 in chips)
Seat 3: 3f43d5e9 ($4.99 in chips)
Seat 4: b1c861b6 ($6.19 in chips)
Seat 5: 31da014d ($7.1 in chips)
Seat 6: 1087965d ($5.23 in chips)
Hero: posts small blind $0.02
3f43d5e9: posts big blind $0.05
*** HOLE CARDS ***
Dealt to 42c31e1a 
Dealt to Hero [Qc 8s]
Dealt to 3f43d5e9 
Dealt to b1c861b6 
Dealt to 31da014d 
Dealt to 1087965d 
b1c861b6: raises $0.08 to $0.13
31da014d: folds
1087965d: folds
42c31e1a: folds
Hero: folds
3f43d5e9: folds
Uncalled bet ($0.08) returned to b1c861b6
*** SHOWDOWN ***
b1c861b6 collected $0.12 from pot
*** SUMMARY ***
Total pot $0.12 | Rake $0 | Jackpot $0 | Bingo $0 | Fortune $0 | Tax $0
Seat 1: 42c31e1a (button) folded before Flop (didn't bet)
Seat 2: Hero (small blind) folded before Flop
Seat 3: 3f43d5e9 (big blind) folded before Flop
Seat 4: b1c861b6 collected ($0.12)
Seat 5: 31da014d folded before Flop (didn't bet)
Seat 6: 1087965d folded before Flop (didn't bet)


Poker Hand #RC3795929373: Hold'em No Limit ($0.02/$0.05) - 2025/08/10 08:20:43
Table 'RushAndCash11064633' 6-max Seat #1 is the button
Seat 1: b1c861b6 ($6.19 in chips)
Seat 2: cf24dfe4 ($6.05 in chips)
Seat 3: 42c31e1a ($13.19 in chips)
Seat 4: Hero ($4.62 in chips)
Seat 5: c1a29539 ($6.77 in chips)
Seat 6: 1cc4b631 ($6.63 in chips)
cf24dfe4: posts small blind $0.02
42c31e1a: posts big blind $0.05
*** HOLE CARDS ***
Dealt to b1c861b6 
Dealt to cf24dfe4 
Dealt to 42c31e1a 
Dealt to Hero [4s 3c]
Dealt to c1a29539 
Dealt to 1cc4b631 
Hero: folds
c1a29539: folds
1cc4b631: raises $0.05 to $0.1
b1c861b6: folds
cf24dfe4: folds
42c31e1a: folds
Uncalled bet ($0.05) returned to 1cc4b631
*** SHOWDOWN ***
1cc4b631 collected $0.12 from pot
*** SUMMARY ***
Total pot $0.12 | Rake $0 | Jackpot $0 | Bingo $0 | Fortune $0 | Tax $0
Seat 1: b1c861b6 (button) folded before Flop (didn't bet)
Seat 2: cf24dfe4 (small blind) folded before Flop
Seat 3: 42c31e1a (big blind) folded before Flop
Seat 4: Hero folded before Flop (didn't bet)
Seat 5: c1a29539 folded before Flop (didn't bet)
Seat 6: 1cc4b631 collected ($0.12)


Poker Hand #RC3795929362: Hold'em No Limit ($0.02/$0.05) - 2025/08/10 08:20:39
Table 'RushAndCash11064622' 6-max Seat #1 is the button
Seat 1: d27c038b ($5.27 in chips)
Seat 2: b1c861b6 ($6.21 in chips)
Seat 3: 57f07a10 ($6.22 in chips)
Seat 4: ae904d2 ($5.81 in chips)
Seat 5: Hero ($4.62 in chips)
Seat 6: dca1c3af ($7.2 in chips)
b1c861b6: posts small blind $0.02
57f07a10: posts big blind $0.05
*** HOLE CARDS ***
Dealt to d27c038b 
Dealt to b1c861b6 
Dealt to 57f07a10 
Dealt to ae904d2 
Dealt to Hero [Ah 4s]
Dealt to dca1c3af 
ae904d2: folds
Hero: folds
dca1c3af: folds
d27c038b: raises $0.07 to $0.12
b1c861b6: folds
57f07a10: folds
Uncalled bet ($0.07) returned to d27c038b
*** SHOWDOWN ***
d27c038b collected $0.12 from pot
*** SUMMARY ***
Total pot $0.12 | Rake $0 | Jackpot $0 | Bingo $0 | Fortune $0 | Tax $0
Seat 1: d27c038b (button) collected ($0.12)
Seat 2: b1c861b6 (small blind) folded before Flop
Seat 3: 57f07a10 (big blind) folded before Flop
Seat 4: ae904d2 folded before Flop (didn't bet)
Seat 5: Hero folded before Flop (didn't bet)
Seat 6: dca1c3af folded before Flop (didn't bet)


Poker Hand #RC3795929352: Hold'em No Limit ($0.02/$0.05) - 2025/08/10 08:20:35
Table 'RushAndCash11064612' 6-max Seat #1 is the button
Seat 1: dca1c3af ($7.2 in chips)
Seat 2: 483f17c3 ($14.9 in chips)
Seat 3: 4844e57f ($11.86 in chips)
Seat 4: 6780a6cb ($5 in chips)
Seat 5: Hero ($4.62 in chips)
Seat 6: d796f1b5 ($9.13 in chips)
483f17c3: posts small blind $0.02
4844e57f: posts big blind $0.05
*** HOLE CARDS ***
Dealt to dca1c3af 
Dealt to 483f17c3 
Dealt to 4844e57f 
Dealt to 6780a6cb 
Dealt to Hero [9s 4c]
Dealt to d796f1b5 
6780a6cb: raises $0.05 to $0.1
Hero: folds
d796f1b5: folds
dca1c3af: folds
483f17c3: folds
4844e57f: folds
Uncalled bet ($0.05) returned to 6780a6cb
*** SHOWDOWN ***
6780a6cb collected $0.12 from pot
*** SUMMARY ***
Total pot $0.12 | Rake $0 | Jackpot $0 | Bingo $0 | Fortune $0 | Tax $0
Seat 1: dca1c3af (button) folded before Flop (didn't bet)
Seat 2: 483f17c3 (small blind) folded before Flop
Seat 3: 4844e57f (big blind) folded before Flop
Seat 4: 6780a6cb collected ($0.12)
Seat 5: Hero folded before Flop (didn't bet)
Seat 6: d796f1b5 folded before Flop (didn't bet)


Poker Hand #RC3795929318: Hold'em No Limit ($0.02/$0.05) - 2025/08/10 08:20:24
Table 'RushAndCash11064578' 6-max Seat #1 is the button
Seat 1: 14157496 ($7.02 in chips)
Seat 2: 1dafb1bc ($32.63 in chips)
Seat 3: 25c3aebf ($3.62 in chips)
Seat 4: Hero ($4.62 in chips)
Seat 5: 3baac59e ($4.93 in chips)
Seat 6: b1c861b6 ($6.26 in chips)
1dafb1bc: posts small blind $0.02
25c3aebf: posts big blind $0.05
*** HOLE CARDS ***
Dealt to 14157496 
Dealt to 1dafb1bc 
Dealt to 25c3aebf 
Dealt to Hero [Js Qh]
Dealt to 3baac59e 
Dealt to b1c861b6 
Hero: folds
3baac59e: raises $0.05 to $0.1
b1c861b6: folds
14157496: folds
1dafb1bc: folds
25c3aebf: raises $0.27 to $0.37
3baac59e: raises $0.57 to $0.94
25c3aebf: calls $0.57
*** FIRST FLOP *** [6c 4h 3c]
25c3aebf: checks
3baac59e: bets $3.99 and is all-in
25c3aebf: calls $2.68 and is all-in
Uncalled bet ($1.31) returned to 3baac59e
3baac59e: shows [Ah As] (a pair of Aces)
25c3aebf: shows [8s 8c] (a pair of Eights)
*** FIRST TURN *** [6c 4h 3c] [Kh]
*** FIRST RIVER *** [6c 4h 3c Kh] [8h]
*** SECOND TURN *** [6c 4h 3c] [Kd]
*** SECOND RIVER *** [6c 4h 3c Kd] [9h]
*** FIRST SHOWDOWN ***
25c3aebf collected $3.53 from pot
*** SECOND SHOWDOWN ***
3baac59e collected $3.47 from pot
*** SUMMARY ***
Total pot $7.26 | Rake $0.19 | Jackpot $0.07 | Bingo $0 | Fortune $0 | Tax $0
Hand was run two times
FIRST Board [6c 4h 3c Kh 8h]
SECOND Board [Kd 9h]
Seat 1: 14157496 (button) folded before Flop (didn't bet)
Seat 2: 1dafb1bc (small blind) folded before Flop
Seat 3: 25c3aebf (big blind) showed [8s 8c] and won ($3.53) with three of a kind, Eights, and lost
Seat 4: Hero folded before Flop (didn't bet)
Seat 5: 3baac59e showed [Ah As] and lost with a pair of Aces, and won ($3.47)
Seat 6: b1c861b6 folded before Flop (didn't bet)


Poker Hand #RC3795929298: Hold'em No Limit ($0.02/$0.05) - 2025/08/10 08:20:18
Table 'RushAndCash11064558' 6-max Seat #1 is the button
Seat 1: Hero ($4.62 in chips)
Seat 2: 2b56ac20 ($15.53 in chips)
Seat 3: a187372 ($6.67 in chips)
Seat 4: a1651cdc ($6.21 in chips)
Seat 5: 8b390e1e ($5.01 in chips)
Seat 6: e400ddd3 ($5.13 in chips)
2b56ac20: posts small blind $0.02
a187372: posts big blind $0.05
*** HOLE CARDS ***
Dealt to Hero [Th 7c]
Dealt to 2b56ac20 
Dealt to a187372 
Dealt to a1651cdc 
Dealt to 8b390e1e 
Dealt to e400ddd3 
a1651cdc: folds
8b390e1e: folds
e400ddd3: raises $0.08 to $0.13
Hero: folds
2b56ac20: folds
a187372: calls $0.08
*** FLOP *** [3d 7s 4h]
a187372: checks
e400ddd3: checks
*** TURN *** [3d 7s 4h] [5d]
a187372: bets $0.1
e400ddd3: calls $0.1
*** RIVER *** [3d 7s 4h 5d] [4d]
a187372: bets $0.32
e400ddd3: raises $0.58 to $0.9
a187372: folds
Uncalled bet ($0.58) returned to e400ddd3
*** SHOWDOWN ***
e400ddd3 collected $1.07 from pot
*** SUMMARY ***
Total pot $1.12 | Rake $0.05 | Jackpot $0 | Bingo $0 | Fortune $0 | Tax $0
Board [3d 7s 4h 5d 4d]
Seat 1: Hero (button) folded before Flop (didn't bet)
Seat 2: 2b56ac20 (small blind) folded before Flop
Seat 3: a187372 (big blind) folded on the River
Seat 4: a1651cdc folded before Flop (didn't bet)
Seat 5: 8b390e1e folded before Flop (didn't bet)
Seat 6: e400ddd3 won ($1.07)


Poker Hand #RC3795929076: Hold'em No Limit ($0.02/$0.05) - 2025/08/10 08:19:11
Table 'RushAndCash11064336' 6-max Seat #1 is the button
Seat 1: ede202e3 ($3.2 in chips)
Seat 2: Hero ($4.95 in chips)
Seat 3: c1a29539 ($6.84 in chips)
Seat 4: fccf4928 ($11.72 in chips)
Seat 5: a187372 ($6.33 in chips)
Seat 6: 4328ce0 ($4.03 in chips)
Hero: posts small blind $0.02
c1a29539: posts big blind $0.05
*** HOLE CARDS ***
Dealt to ede202e3 
Dealt to Hero [5h 6h]
Dealt to c1a29539 
Dealt to fccf4928 
Dealt to a187372 
Dealt to 4328ce0 
fccf4928: folds
a187372: raises $0.06 to $0.11
4328ce0: folds
ede202e3: folds
Hero: calls $0.09
c1a29539: folds
*** FLOP *** [5d 7h Jh]
Hero: checks
a187372: checks
*** TURN *** [5d 7h Jh] [4c]
Hero: bets $0.22
a187372: calls $0.22
*** RIVER *** [5d 7h Jh 4c] [As]
Hero: checks
a187372: bets $0.49
Hero: folds
Uncalled bet ($0.49) returned to a187372
*** SHOWDOWN ***
a187372 collected $0.67 from pot
*** SUMMARY ***
Total pot $0.71 | Rake $0.04 | Jackpot $0 | Bingo $0 | Fortune $0 | Tax $0
Board [5d 7h Jh 4c As]
Seat 1: ede202e3 (button) folded before Flop (didn't bet)
Seat 2: Hero (small blind) folded on the River
Seat 3: c1a29539 (big blind) folded before Flop
Seat 4: fccf4928 folded before Flop (didn't bet)
Seat 5: a187372 won ($0.67)
Seat 6: 4328ce0 folded before Flop (didn't bet)


Poker Hand #RC3795928998: Hold'em No Limit ($0.02/$0.05) - 2025/08/10 08:18:46
Table 'RushAndCash11064258' 6-max Seat #1 is the button
Seat 1: 1cfd181b ($6.03 in chips)
Seat 2: 71c02919 ($4.88 in chips)
Seat 3: Hero ($5 in chips)
Seat 4: f76279b5 ($8.21 in chips)
Seat 5: 59da8582 ($11.2 in chips)
Seat 6: 2a76f9f5 ($6.01 in chips)
71c02919: posts small blind $0.02
Hero: posts big blind $0.05
*** HOLE CARDS ***
Dealt to 1cfd181b 
Dealt to 71c02919 
Dealt to Hero [8s 7s]
Dealt to f76279b5 
Dealt to 59da8582 
Dealt to 2a76f9f5 
f76279b5: folds
59da8582: raises $0.07 to $0.12
2a76f9f5: folds
1cfd181b: raises $0.33 to $0.45
71c02919: folds
Hero: folds
59da8582: raises $0.45 to $0.9
1cfd181b: calls $0.45
*** FLOP *** [2d 6d 8d]
59da8582: bets $1
1cfd181b: folds
Uncalled bet ($1) returned to 59da8582
*** SHOWDOWN ***
59da8582 collected $1.71 from pot
*** SUMMARY ***
Total pot $1.87 | Rake $0.09 | Jackpot $0.07 | Bingo $0 | Fortune $0 | Tax $0
Board [2d 6d 8d]
Seat 1: 1cfd181b (button) folded on the Flop
Seat 2: 71c02919 (small blind) folded before Flop
Seat 3: Hero (big blind) folded before Flop
Seat 4: f76279b5 folded before Flop (didn't bet)
Seat 5: 59da8582 won ($1.71)
Seat 6: 2a76f9f5 folded before Flop (didn't bet)


Poker Hand #RC3795928691: Hold'em No Limit ($0.02/$0.05) - 2025/08/10 08:17:11
Table 'RushAndCash11063951' 6-max Seat #1 is the button
Seat 1: Hero ($4.98 in chips)
Seat 2: 45a89215 ($9.89 in chips)
Seat 3: fecbabe7 ($5.4 in chips)
Seat 4: a323a285 ($5.57 in chips)
Seat 5: 69e805cf ($16.25 in chips)
Seat 6: a8d350f7 ($5.04 in chips)
45a89215: posts small blind $0.02
fecbabe7: posts big blind $0.05
*** HOLE CARDS ***
Dealt to Hero [Qh Ac]
Dealt to 45a89215 
Dealt to fecbabe7 
Dealt to a323a285 
Dealt to 69e805cf 
Dealt to a8d350f7 
a323a285: folds
69e805cf: folds
a8d350f7: folds
Hero: raises $0.05 to $0.1
45a89215: folds
fecbabe7: raises $0.4 to $0.5
Hero: calls $0.4
*** FLOP *** [5s 9c Jd]
fecbabe7: bets $0.34
Hero: calls $0.34
*** TURN *** [5s 9c Jd] [Qc]
fecbabe7: bets $0.85
Hero: calls $0.85
*** RIVER *** [5s 9c Jd Qc] [4c]
fecbabe7: bets $3.71 and is all-in
Hero: calls $3.29 and is all-in
Uncalled bet ($0.42) returned to fecbabe7
fecbabe7: shows [Tc Kh] (a straight, King to Nine)
Hero: shows [Qh Ac] (a pair of Queens)
*** SHOWDOWN ***
fecbabe7 collected $9.76 from pot
*** SUMMARY ***
Total pot $9.98 | Rake $0.15 | Jackpot $0.07 | Bingo $0 | Fortune $0 | Tax $0
Board [5s 9c Jd Qc 4c]
Seat 1: Hero (button) showed [Qh Ac] and lost with a pair of Queens
Seat 2: 45a89215 (small blind) folded before Flop
Seat 3: fecbabe7 (big blind) showed [Tc Kh] and won ($9.76) with a straight, King to Nine
Seat 4: a323a285 folded before Flop (didn't bet)
Seat 5: 69e805cf folded before Flop (didn't bet)
Seat 6: a8d350f7 folded before Flop (didn't bet)


Poker Hand #RC3795928641: Hold'em No Limit ($0.02/$0.05) - 2025/08/10 08:16:53
Table 'RushAndCash11063901' 6-max Seat #1 is the button
Seat 1: 2b56ac20 ($15.52 in chips)
Seat 2: Hero ($5 in chips)
Seat 3: d14db4c5 ($8.62 in chips)
Seat 4: 85e4ce3a ($15.62 in chips)
Seat 5: bc911417 ($5 in chips)
Seat 6: 827e3595 ($8.3 in chips)
Hero: posts small blind $0.02
d14db4c5: posts big blind $0.05
*** HOLE CARDS ***
Dealt to 2b56ac20 
Dealt to Hero [Jd 8c]
Dealt to d14db4c5 
Dealt to 85e4ce3a 
Dealt to bc911417 
Dealt to 827e3595 
85e4ce3a: folds
bc911417: raises $0.05 to $0.1
827e3595: folds
2b56ac20: calls $0.1
Hero: folds
d14db4c5: calls $0.05
*** FLOP *** [Ts 7c Qs]
d14db4c5: checks
bc911417: bets $0.05
2b56ac20: folds
d14db4c5: folds
Uncalled bet ($0.05) returned to bc911417
*** SHOWDOWN ***
bc911417 collected $0.31 from pot
*** SUMMARY ***
Total pot $0.32 | Rake $0.01 | Jackpot $0 | Bingo $0 | Fortune $0 | Tax $0
Board [Ts 7c Qs]
Seat 1: 2b56ac20 (button) folded on the Flop
Seat 2: Hero (small blind) folded before Flop
Seat 3: d14db4c5 (big blind) folded on the Flop
Seat 4: 85e4ce3a folded before Flop (didn't bet)
Seat 5: bc911417 won ($0.31)
Seat 6: 827e3595 folded before Flop (didn't bet)


Poker Hand #RC3795928629: Hold'em No Limit ($0.02/$0.05) - 2025/08/10 08:16:50
Table 'RushAndCash11063889' 6-max Seat #1 is the button
Seat 1: b3da168 ($5.86 in chips)
Seat 2: 3f43d5e9 ($1.91 in chips)
Seat 3: e533c044 ($5 in chips)
Seat 4: 4b9df3fe ($8.6 in chips)
Seat 5: 1dc75478 ($7.88 in chips)
Seat 6: Hero ($5 in chips)
3f43d5e9: posts small blind $0.02
e533c044: posts big blind $0.05
*** HOLE CARDS ***
Dealt to b3da168 
Dealt to 3f43d5e9 
Dealt to e533c044 
Dealt to 4b9df3fe 
Dealt to 1dc75478 
Dealt to Hero [9s 7d]
4b9df3fe: folds
1dc75478: folds
Hero: folds
b3da168: folds
3f43d5e9: folds
Uncalled bet ($0.03) returned to e533c044
*** SHOWDOWN ***
e533c044 collected $0.04 from pot
*** SUMMARY ***
Total pot $0.04 | Rake $0 | Jackpot $0 | Bingo $0 | Fortune $0 | Tax $0
Seat 1: b3da168 (button) folded before Flop (didn't bet)
Seat 2: 3f43d5e9 (small blind) folded before Flop
Seat 3: e533c044 (big blind) collected ($0.04)
Seat 4: 4b9df3fe folded before Flop (didn't bet)
Seat 5: 1dc75478 folded before Flop (didn't bet)
Seat 6: Hero folded before Flop (didn't bet)


Poker Hand #RC3795928421: Hold'em No Limit ($0.02/$0.05) - 2025/08/10 08:15:42
Table 'RushAndCash11063681' 6-max Seat #1 is the button
Seat 1: 827e3595 ($4.37 in chips)
Seat 2: 72e119cc ($4.88 in chips)
Seat 3: Hero ($4.25 in chips)
Seat 4: 17b790ab ($5.23 in chips)
Seat 5: 20f74a86 ($5 in chips)
Seat 6: 999a0f96 ($5.46 in chips)
72e119cc: posts small blind $0.02
Hero: posts big blind $0.05
*** HOLE CARDS ***
Dealt to 827e3595 
Dealt to 72e119cc 
Dealt to Hero [Jh 6h]
Dealt to 17b790ab 
Dealt to 20f74a86 
Dealt to 999a0f96 
17b790ab: folds
20f74a86: folds
999a0f96: folds
827e3595: raises $0.1 to $0.15
72e119cc: folds
Hero: raises $0.31 to $0.46
827e3595: calls $0.31
*** FLOP *** [As 7c 9c]
Hero: bets $0.27
827e3595: calls $0.27
*** TURN *** [As 7c 9c] [9s]
Hero: bets $0.72
827e3595: calls $0.72
*** RIVER *** [As 7c 9c 9s] [Ad]
Hero: bets $2.8 and is all-in
827e3595: calls $2.8
Hero: shows [Jh 6h] (two pair, Aces and Nines)
827e3595: shows [Ac Th] (a full house, Aces full of Nines)
*** SHOWDOWN ***
827e3595 collected $8.2 from pot
*** SUMMARY ***
Total pot $8.52 | Rake $0.25 | Jackpot $0.07 | Bingo $0 | Fortune $0 | Tax $0
Board [As 7c 9c 9s Ad]
Seat 1: 827e3595 (button) showed [Ac Th] and won ($8.2) with a full house, Aces full of Nines
Seat 2: 72e119cc (small blind) folded before Flop
Seat 3: Hero (big blind) showed [Jh 6h] and lost with two pair, Aces and Nines
Seat 4: 17b790ab folded before Flop (didn't bet)
Seat 5: 20f74a86 folded before Flop (didn't bet)
Seat 6: 999a0f96 folded before Flop (didn't bet)


Poker Hand #RC3795928406: Hold'em No Limit ($0.02/$0.05) - 2025/08/10 08:15:38
Table 'RushAndCash11063666' 6-max Seat #1 is the button
Seat 1: f6bf8dfb ($5.58 in chips)
Seat 2: fccf4928 ($9.87 in chips)
Seat 3: a8d350f7 ($5 in chips)
Seat 4: 4844e57f ($11.46 in chips)
Seat 5: Hero ($4.25 in chips)
Seat 6: 7bb0edca ($5 in chips)
fccf4928: posts small blind $0.02
a8d350f7: posts big blind $0.05
*** HOLE CARDS ***
Dealt to f6bf8dfb 
Dealt to fccf4928 
Dealt to a8d350f7 
Dealt to 4844e57f 
Dealt to Hero [4s 3c]
Dealt to 7bb0edca 
4844e57f: raises $0.05 to $0.1
Hero: folds
7bb0edca: folds
f6bf8dfb: folds
fccf4928: folds
a8d350f7: calls $0.05
*** FLOP *** [Qd Jh 5h]
a8d350f7: bets $0.11
4844e57f: folds
Uncalled bet ($0.11) returned to a8d350f7
*** SHOWDOWN ***
a8d350f7 collected $0.21 from pot
*** SUMMARY ***
Total pot $0.22 | Rake $0.01 | Jackpot $0 | Bingo $0 | Fortune $0 | Tax $0
Board [Qd Jh 5h]
Seat 1: f6bf8dfb (button) folded before Flop (didn't bet)
Seat 2: fccf4928 (small blind) folded before Flop
Seat 3: a8d350f7 (big blind) won ($0.21)
Seat 4: 4844e57f folded on the Flop
Seat 5: Hero folded before Flop (didn't bet)
Seat 6: 7bb0edca folded before Flop (didn't bet)


Poker Hand #RC3795928392: Hold'em No Limit ($0.02/$0.05) - 2025/08/10 08:15:34
Table 'RushAndCash11063652' 6-max Seat #1 is the button
Seat 1: 7b419a6a ($7.86 in chips)
Seat 2: fecbabe7 ($5 in chips)
Seat 3: 7d1f43e4 ($5.57 in chips)
Seat 4: Hero ($4.25 in chips)
Seat 5: 41ed372d ($5.36 in chips)
Seat 6: 1f81ea21 ($2.9 in chips)
fecbabe7: posts small blind $0.02
7d1f43e4: posts big blind $0.05
*** HOLE CARDS ***
Dealt to 7b419a6a 
Dealt to fecbabe7 
Dealt to 7d1f43e4 
Dealt to Hero [5h 2h]
Dealt to 41ed372d 
Dealt to 1f81ea21 
Hero: folds
41ed372d: folds
1f81ea21: calls $0.05
7b419a6a: folds
fecbabe7: calls $0.03
7d1f43e4: checks
*** FLOP *** [4c 9c Kc]
fecbabe7: checks
7d1f43e4: checks
1f81ea21: checks
*** TURN *** [4c 9c Kc] [9d]
fecbabe7: bets $0.08
7d1f43e4: calls $0.08
1f81ea21: folds
*** RIVER *** [4c 9c Kc 9d] [5d]
fecbabe7: bets $0.24
7d1f43e4: calls $0.24
fecbabe7: shows [9h 7d] (three of a kind, Nines)
7d1f43e4: shows [3s 9s] (three of a kind, Nines)
*** SHOWDOWN ***
fecbabe7 collected $0.75 from pot
*** SUMMARY ***
Total pot $0.79 | Rake $0.04 | Jackpot $0 | Bingo $0 | Fortune $0 | Tax $0
Board [4c 9c Kc 9d 5d]
Seat 1: 7b419a6a (button) folded before Flop (didn't bet)
Seat 2: fecbabe7 (small blind) showed [9h 7d] and won ($0.75) with three of a kind, Nines
Seat 3: 7d1f43e4 (big blind) showed [3s 9s] and lost with three of a kind, Nines
Seat 4: Hero folded before Flop (didn't bet)
Seat 5: 41ed372d folded before Flop (didn't bet)
Seat 6: 1f81ea21 folded on the Turn


Poker Hand #RC3795928381: Hold'em No Limit ($0.02/$0.05) - 2025/08/10 08:15:31
Table 'RushAndCash11063641' 6-max Seat #1 is the button
Seat 1: be93df25 ($5 in chips)
Seat 2: fab46f2c ($17.3 in chips)
Seat 3: 7b419a6a ($7.91 in chips)
Seat 4: 95a8436b ($7.56 in chips)
Seat 5: Hero ($4.25 in chips)
Seat 6: 279a8e9f ($5 in chips)
fab46f2c: posts small blind $0.02
7b419a6a: posts big blind $0.05
*** HOLE CARDS ***
Dealt to be93df25 
Dealt to fab46f2c 
Dealt to 7b419a6a 
Dealt to 95a8436b 
Dealt to Hero [Th 5d]
Dealt to 279a8e9f 
95a8436b: raises $0.05 to $0.1
Hero: folds
279a8e9f: folds
be93df25: folds
fab46f2c: folds
7b419a6a: folds
Uncalled bet ($0.05) returned to 95a8436b
*** SHOWDOWN ***
95a8436b collected $0.12 from pot
*** SUMMARY ***
Total pot $0.12 | Rake $0 | Jackpot $0 | Bingo $0 | Fortune $0 | Tax $0
Seat 1: be93df25 (button) folded before Flop (didn't bet)
Seat 2: fab46f2c (small blind) folded before Flop
Seat 3: 7b419a6a (big blind) folded before Flop
Seat 4: 95a8436b collected ($0.12)
Seat 5: Hero folded before Flop (didn't bet)
Seat 6: 279a8e9f folded before Flop (didn't bet)


Poker Hand #RC3795928369: Hold'em No Limit ($0.02/$0.05) - 2025/08/10 08:15:27
Table 'RushAndCash11063629' 6-max Seat #1 is the button
Seat 1: 57f07a10 ($5.87 in chips)
Seat 2: 2c28207b ($7.52 in chips)
Seat 3: 213520b1 ($10.2 in chips)
Seat 4: 95a8436b ($7.56 in chips)
Seat 5: Hero ($4.25 in chips)
Seat 6: 9999c04f ($3.33 in chips)
2c28207b: posts small blind $0.02
213520b1: posts big blind $0.05
*** HOLE CARDS ***
Dealt to 57f07a10 
Dealt to 2c28207b 
Dealt to 213520b1 
Dealt to 95a8436b 
Dealt to Hero [4d 6h]
Dealt to 9999c04f 
95a8436b: folds
Hero: folds
9999c04f: raises $0.07 to $0.12
57f07a10: folds
2c28207b: folds
213520b1: folds
Uncalled bet ($0.07) returned to 9999c04f
*** SHOWDOWN ***
9999c04f collected $0.12 from pot
*** SUMMARY ***
Total pot $0.12 | Rake $0 | Jackpot $0 | Bingo $0 | Fortune $0 | Tax $0
Seat 1: 57f07a10 (button) folded before Flop (didn't bet)
Seat 2: 2c28207b (small blind) folded before Flop
Seat 3: 213520b1 (big blind) folded before Flop
Seat 4: 95a8436b folded before Flop (didn't bet)
Seat 5: Hero folded before Flop (didn't bet)
Seat 6: 9999c04f collected ($0.12)


Poker Hand #RC3795928354: Hold'em No Limit ($0.02/$0.05) - 2025/08/10 08:15:22
Table 'RushAndCash11063614' 6-max Seat #1 is the button
Seat 1: Hero ($4.25 in chips)
Seat 2: 9fb5ba89 ($9.5 in chips)
Seat 3: 95a8436b ($7.61 in chips)
Seat 4: 87171343 ($8.71 in chips)
Seat 5: 483f17c3 ($15.62 in chips)
Seat 6: d27c038b ($6.31 in chips)
9fb5ba89: posts small blind $0.02
95a8436b: posts big blind $0.05
*** HOLE CARDS ***
Dealt to Hero [4d Jh]
Dealt to 9fb5ba89 
Dealt to 95a8436b 
Dealt to 87171343 
Dealt to 483f17c3 
Dealt to d27c038b 
87171343: raises $0.06 to $0.11
483f17c3: folds
d27c038b: folds
Hero: folds
9fb5ba89: calls $0.09
95a8436b: folds
*** FLOP *** [5d 2c 9c]
9fb5ba89: checks
87171343: checks
*** TURN *** [5d 2c 9c] [Ks]
9fb5ba89: checks
87171343: checks
*** RIVER *** [5d 2c 9c Ks] [Qh]
9fb5ba89: checks
87171343: checks
9fb5ba89: shows [As 8d] (Ace high)
87171343: shows [Js 9s] (a pair of Nines)
*** SHOWDOWN ***
87171343 collected $0.26 from pot
*** SUMMARY ***
Total pot $0.27 | Rake $0.01 | Jackpot $0 | Bingo $0 | Fortune $0 | Tax $0
Board [5d 2c 9c Ks Qh]
Seat 1: Hero (button) folded before Flop (didn't bet)
Seat 2: 9fb5ba89 (small blind) showed [As 8d] and lost with Ace high
Seat 3: 95a8436b (big blind) folded before Flop
Seat 4: 87171343 showed [Js 9s] and won ($0.26) with a pair of Nines
Seat 5: 483f17c3 folded before Flop (didn't bet)
Seat 6: d27c038b folded before Flop (didn't bet)


Poker Hand #RC3795928279: Hold'em No Limit ($0.02/$0.05) - 2025/08/10 08:14:59
Table 'RushAndCash11063539' 6-max Seat #1 is the button
Seat 1: 7b5755e7 ($4.93 in chips)
Seat 2: Hero ($4.11 in chips)
Seat 3: 6e4d185c ($14.01 in chips)
Seat 4: 95a8436b ($7.71 in chips)
Seat 5: a63176ef ($7.34 in chips)
Seat 6: 3f43d5e9 ($2.78 in chips)
Hero: posts small blind $0.02
6e4d185c: posts big blind $0.05
*** HOLE CARDS ***
Dealt to 7b5755e7 
Dealt to Hero [8h 6h]
Dealt to 6e4d185c 
Dealt to 95a8436b 
Dealt to a63176ef 
Dealt to 3f43d5e9 
95a8436b: raises $0.05 to $0.1
a63176ef: folds
3f43d5e9: folds
7b5755e7: folds
Hero: raises $0.24 to $0.34
6e4d185c: folds
95a8436b: folds
Uncalled bet ($0.24) returned to Hero
*** SHOWDOWN ***
Hero collected $0.24 from pot
*** SUMMARY ***
Total pot $0.25 | Rake $0.01 | Jackpot $0 | Bingo $0 | Fortune $0 | Tax $0
Seat 1: 7b5755e7 (button) folded before Flop (didn't bet)
Seat 2: Hero (small blind) collected ($0.24)
Seat 3: 6e4d185c (big blind) folded before Flop
Seat 4: 95a8436b folded before Flop
Seat 5: a63176ef folded before Flop (didn't bet)
Seat 6: 3f43d5e9 folded before Flop (didn't bet)


Poker Hand #RC3795928241: Hold'em No Limit ($0.02/$0.05) - 2025/08/10 08:14:47
Table 'RushAndCash11063501' 6-max Seat #1 is the button
Seat 1: 63f3fdb ($5.26 in chips)
Seat 2: f321949b ($12.27 in chips)
Seat 3: Hero ($4.16 in chips)
Seat 4: 7c3a91fe ($5.07 in chips)
Seat 5: 95be8ce6 ($1.8 in chips)
Seat 6: ff54033f ($6.97 in chips)
f321949b: posts small blind $0.02
Hero: posts big blind $0.05
*** HOLE CARDS ***
Dealt to 63f3fdb 
Dealt to f321949b 
Dealt to Hero [Js 7c]
Dealt to 7c3a91fe 
Dealt to 95be8ce6 
Dealt to ff54033f 
7c3a91fe: folds
95be8ce6: folds
ff54033f: raises $0.08 to $0.13
63f3fdb: folds
f321949b: folds
Hero: folds
Uncalled bet ($0.08) returned to ff54033f
*** SHOWDOWN ***
ff54033f collected $0.12 from pot
*** SUMMARY ***
Total pot $0.12 | Rake $0 | Jackpot $0 | Bingo $0 | Fortune $0 | Tax $0
Seat 1: 63f3fdb (button) folded before Flop (didn't bet)
Seat 2: f321949b (small blind) folded before Flop
Seat 3: Hero (big blind) folded before Flop
Seat 4: 7c3a91fe folded before Flop (didn't bet)
Seat 5: 95be8ce6 folded before Flop (didn't bet)
Seat 6: ff54033f collected ($0.12)


Poker Hand #RC3795928227: Hold'em No Limit ($0.02/$0.05) - 2025/08/10 08:14:43
Table 'RushAndCash11063487' 6-max Seat #1 is the button
Seat 1: f6c47f47 ($3.62 in chips)
Seat 2: 8d7849e9 ($6.05 in chips)
Seat 3: f3a1d090 ($23.89 in chips)
Seat 4: d796f1b5 ($14.51 in chips)
Seat 5: Hero ($4.16 in chips)
Seat 6: ba3893c4 ($5.33 in chips)
8d7849e9: posts small blind $0.02
f3a1d090: posts big blind $0.05
*** HOLE CARDS ***
Dealt to f6c47f47 
Dealt to 8d7849e9 
Dealt to f3a1d090 
Dealt to d796f1b5 
Dealt to Hero [4s 4d]
Dealt to ba3893c4 
d796f1b5: raises $0.05 to $0.1
Hero: folds
ba3893c4: folds
f6c47f47: calls $0.1
8d7849e9: folds
f3a1d090: folds
*** FLOP *** [7h 9c Kh]
d796f1b5: checks
f6c47f47: checks
*** TURN *** [7h 9c Kh] [9s]
d796f1b5: checks
f6c47f47: bets $0.21
d796f1b5: folds
Uncalled bet ($0.21) returned to f6c47f47
*** SHOWDOWN ***
f6c47f47 collected $0.26 from pot
*** SUMMARY ***
Total pot $0.27 | Rake $0.01 | Jackpot $0 | Bingo $0 | Fortune $0 | Tax $0
Board [7h 9c Kh 9s]
Seat 1: f6c47f47 (button) won ($0.26)
Seat 2: 8d7849e9 (small blind) folded before Flop
Seat 3: f3a1d090 (big blind) folded before Flop
Seat 4: d796f1b5 folded on the Turn
Seat 5: Hero folded before Flop (didn't bet)
Seat 6: ba3893c4 folded before Flop (didn't bet)


Poker Hand #RC3795928197: Hold'em No Limit ($0.02/$0.05) - 2025/08/10 08:14:32
Table 'RushAndCash11063457' 6-max Seat #1 is the button
Seat 1: 81b8bd6d ($5.1 in chips)
Seat 2: be93df25 ($5.02 in chips)
Seat 3: e8d6e6da ($5.77 in chips)
Seat 4: Hero ($4.09 in chips)
Seat 5: fa60e706 ($5.31 in chips)
Seat 6: 82af3a70 ($4.65 in chips)
be93df25: posts small blind $0.02
e8d6e6da: posts big blind $0.05
*** HOLE CARDS ***
Dealt to 81b8bd6d 
Dealt to be93df25 
Dealt to e8d6e6da 
Dealt to Hero [Qh Qc]
Dealt to fa60e706 
Dealt to 82af3a70 
Hero: raises $0.05 to $0.1
fa60e706: folds
82af3a70: folds
81b8bd6d: folds
be93df25: folds
e8d6e6da: folds
Uncalled bet ($0.05) returned to Hero
*** SHOWDOWN ***
Hero collected $0.12 from pot
*** SUMMARY ***
Total pot $0.12 | Rake $0 | Jackpot $0 | Bingo $0 | Fortune $0 | Tax $0
Seat 1: 81b8bd6d (button) folded before Flop (didn't bet)
Seat 2: be93df25 (small blind) folded before Flop
Seat 3: e8d6e6da (big blind) folded before Flop
Seat 4: Hero collected ($0.12)
Seat 5: fa60e706 folded before Flop (didn't bet)
Seat 6: 82af3a70 folded before Flop (didn't bet)


Poker Hand #RC3795928118: Hold'em No Limit ($0.02/$0.05) - 2025/08/10 08:14:07
Table 'RushAndCash11063378' 6-max Seat #1 is the button
Seat 1: f6ecbdd ($13.23 in chips)
Seat 2: b0fd3437 ($7.09 in chips)
Seat 3: 2c53d2c7 ($6.06 in chips)
Seat 4: 2a76f9f5 ($6.77 in chips)
Seat 5: Hero ($4.19 in chips)
Seat 6: 7f40418 ($5.3 in chips)
b0fd3437: posts small blind $0.02
2c53d2c7: posts big blind $0.05
*** HOLE CARDS ***
Dealt to f6ecbdd 
Dealt to b0fd3437 
Dealt to 2c53d2c7 
Dealt to 2a76f9f5 
Dealt to Hero [Td Th]
Dealt to 7f40418 
2a76f9f5: folds
Hero: raises $0.05 to $0.1
7f40418: folds
f6ecbdd: raises $0.2 to $0.3
b0fd3437: folds
2c53d2c7: raises $0.6 to $0.9
Hero: folds
f6ecbdd: folds
Uncalled bet ($0.6) returned to 2c53d2c7
*** SHOWDOWN ***
2c53d2c7 collected $0.69 from pot
*** SUMMARY ***
Total pot $0.72 | Rake $0.03 | Jackpot $0 | Bingo $0 | Fortune $0 | Tax $0
Seat 1: f6ecbdd (button) folded before Flop
Seat 2: b0fd3437 (small blind) folded before Flop
Seat 3: 2c53d2c7 (big blind) collected ($0.69)
Seat 4: 2a76f9f5 folded before Flop (didn't bet)
Seat 5: Hero folded before Flop
Seat 6: 7f40418 folded before Flop (didn't bet)


Poker Hand #RC3795927951: Hold'em No Limit ($0.02/$0.05) - 2025/08/10 08:13:13
Table 'RushAndCash11063211' 6-max Seat #1 is the button
Seat 1: 3f5c4b90 ($9.42 in chips)
Seat 2: bf4e2b6b ($11.29 in chips)
Seat 3: Hero ($4.44 in chips)
Seat 4: 402f5d1a ($6.15 in chips)
Seat 5: cb83453e ($11.34 in chips)
Seat 6: 7f40418 ($5 in chips)
bf4e2b6b: posts small blind $0.02
Hero: posts big blind $0.05
*** HOLE CARDS ***
Dealt to 3f5c4b90 
Dealt to bf4e2b6b 
Dealt to Hero [Td Th]
Dealt to 402f5d1a 
Dealt to cb83453e 
Dealt to 7f40418 
402f5d1a: calls $0.05
cb83453e: folds
7f40418: raises $0.2 to $0.25
3f5c4b90: folds
bf4e2b6b: folds
Hero: calls $0.2
402f5d1a: folds
*** FLOP *** [3d 7c Qc]
Hero: checks
7f40418: checks
*** TURN *** [3d 7c Qc] [9s]
Hero: checks
7f40418: bets $0.57
Hero: folds
Uncalled bet ($0.57) returned to 7f40418
*** SHOWDOWN ***
7f40418 collected $0.55 from pot
*** SUMMARY ***
Total pot $0.57 | Rake $0.02 | Jackpot $0 | Bingo $0 | Fortune $0 | Tax $0
Board [3d 7c Qc 9s]
Seat 1: 3f5c4b90 (button) folded before Flop (didn't bet)
Seat 2: bf4e2b6b (small blind) folded before Flop
Seat 3: Hero (big blind) folded on the Turn
Seat 4: 402f5d1a folded before Flop
Seat 5: cb83453e folded before Flop (didn't bet)
Seat 6: 7f40418 won ($0.55)


Poker Hand #RC3795927928: Hold'em No Limit ($0.02/$0.05) - 2025/08/10 08:13:06
Table 'RushAndCash11063188' 6-max Seat #1 is the button
Seat 1: a4b58f11 ($14.72 in chips)
Seat 2: c68d0db6 ($1.19 in chips)
Seat 3: fecbabe7 ($5 in chips)
Seat 4: 57f07a10 ($4.96 in chips)
Seat 5: Hero ($4.44 in chips)
Seat 6: d7fd8492 ($16.54 in chips)
c68d0db6: posts small blind $0.02
fecbabe7: posts big blind $0.05
*** HOLE CARDS ***
Dealt to a4b58f11 
Dealt to c68d0db6 
Dealt to fecbabe7 
Dealt to 57f07a10 
Dealt to Hero [2h 4s]
Dealt to d7fd8492 
57f07a10: folds
Hero: folds
d7fd8492: calls $0.05
a4b58f11: folds
c68d0db6: folds
fecbabe7: checks
*** FLOP *** [6h Qh Kc]
fecbabe7: checks
d7fd8492: checks
*** TURN *** [6h Qh Kc] [9c]
fecbabe7: checks
d7fd8492: checks
*** RIVER *** [6h Qh Kc 9c] [Ah]
fecbabe7: checks
d7fd8492: bets $0.09
fecbabe7: folds
Uncalled bet ($0.09) returned to d7fd8492
*** SHOWDOWN ***
d7fd8492 collected $0.12 from pot
*** SUMMARY ***
Total pot $0.12 | Rake $0 | Jackpot $0 | Bingo $0 | Fortune $0 | Tax $0
Board [6h Qh Kc 9c Ah]
Seat 1: a4b58f11 (button) folded before Flop (didn't bet)
Seat 2: c68d0db6 (small blind) folded before Flop
Seat 3: fecbabe7 (big blind) folded on the River
Seat 4: 57f07a10 folded before Flop (didn't bet)
Seat 5: Hero folded before Flop (didn't bet)
Seat 6: d7fd8492 won ($0.12)


Poker Hand #RC3795927877: Hold'em No Limit ($0.02/$0.05) - 2025/08/10 08:12:53
Table 'RushAndCash11063137' 6-max Seat #1 is the button
Seat 1: 42c5560c ($5.11 in chips)
Seat 2: Hero ($4.46 in chips)
Seat 3: de5456c0 ($5 in chips)
Seat 4: bc911417 ($5 in chips)
Seat 5: 667b62d6 ($8.24 in chips)
Seat 6: bbe9b1b1 ($5 in chips)
Hero: posts small blind $0.02
de5456c0: posts big blind $0.05
*** HOLE CARDS ***
Dealt to 42c5560c 
Dealt to Hero [3s Ac]
Dealt to de5456c0 
Dealt to bc911417 
Dealt to 667b62d6 
Dealt to bbe9b1b1 
bc911417: folds
667b62d6: raises $0.08 to $0.13
bbe9b1b1: folds
42c5560c: folds
Hero: folds
de5456c0: folds
Uncalled bet ($0.08) returned to 667b62d6
*** SHOWDOWN ***
667b62d6 collected $0.12 from pot
*** SUMMARY ***
Total pot $0.12 | Rake $0 | Jackpot $0 | Bingo $0 | Fortune $0 | Tax $0
Seat 1: 42c5560c (button) folded before Flop (didn't bet)
Seat 2: Hero (small blind) folded before Flop
Seat 3: de5456c0 (big blind) folded before Flop
Seat 4: bc911417 folded before Flop (didn't bet)
Seat 5: 667b62d6 collected ($0.12)
Seat 6: bbe9b1b1 folded before Flop (didn't bet)


Poker Hand #RC3795927864: Hold'em No Limit ($0.02/$0.05) - 2025/08/10 08:12:49
Table 'RushAndCash11063124' 6-max Seat #1 is the button
Seat 1: eaca1ea ($5.67 in chips)
Seat 2: bc911417 ($5 in chips)
Seat 3: e8d6e6da ($5.9 in chips)
Seat 4: 4b9df3fe ($6.64 in chips)
Seat 5: c6b4a39c ($5.43 in chips)
Seat 6: Hero ($4.46 in chips)
bc911417: posts small blind $0.02
e8d6e6da: posts big blind $0.05
*** HOLE CARDS ***
Dealt to eaca1ea 
Dealt to bc911417 
Dealt to e8d6e6da 
Dealt to 4b9df3fe 
Dealt to c6b4a39c 
Dealt to Hero [3c Jd]
4b9df3fe: folds
c6b4a39c: folds
Hero: folds
eaca1ea: raises $0.08 to $0.13
bc911417: folds
e8d6e6da: calls $0.08
*** FLOP *** [Ah Td 4d]
e8d6e6da: checks
eaca1ea: bets $0.09
e8d6e6da: folds
Uncalled bet ($0.09) returned to eaca1ea
*** SHOWDOWN ***
eaca1ea collected $0.27 from pot
*** SUMMARY ***
Total pot $0.28 | Rake $0.01 | Jackpot $0 | Bingo $0 | Fortune $0 | Tax $0
Board [Ah Td 4d]
Seat 1: eaca1ea (button) won ($0.27)
Seat 2: bc911417 (small blind) folded before Flop
Seat 3: e8d6e6da (big blind) folded on the Flop
Seat 4: 4b9df3fe folded before Flop (didn't bet)
Seat 5: c6b4a39c folded before Flop (didn't bet)
Seat 6: Hero folded before Flop (didn't bet)


Poker Hand #RC3795927835: Hold'em No Limit ($0.02/$0.05) - 2025/08/10 08:12:41
Table 'RushAndCash11063095' 6-max Seat #1 is the button
Seat 1: Hero ($4.46 in chips)
Seat 2: 2d1b3dec ($6.17 in chips)
Seat 3: c489ef79 ($4.95 in chips)
Seat 4: b2532ba1 ($7.06 in chips)
Seat 5: 68db1858 ($3.45 in chips)
Seat 6: cb7dd5c ($5 in chips)
2d1b3dec: posts small blind $0.02
c489ef79: posts big blind $0.05
*** HOLE CARDS ***
Dealt to Hero [2c Jh]
Dealt to 2d1b3dec 
Dealt to c489ef79 
Dealt to b2532ba1 
Dealt to 68db1858 
Dealt to cb7dd5c 
b2532ba1: folds
68db1858: raises $0.1 to $0.15
cb7dd5c: folds
Hero: folds
2d1b3dec: folds
c489ef79: folds
Uncalled bet ($0.1) returned to 68db1858
*** SHOWDOWN ***
68db1858 collected $0.12 from pot
*** SUMMARY ***
Total pot $0.12 | Rake $0 | Jackpot $0 | Bingo $0 | Fortune $0 | Tax $0
Seat 1: Hero (button) folded before Flop (didn't bet)
Seat 2: 2d1b3dec (small blind) folded before Flop
Seat 3: c489ef79 (big blind) folded before Flop
Seat 4: b2532ba1 folded before Flop (didn't bet)
Seat 5: 68db1858 collected ($0.12)
Seat 6: cb7dd5c folded before Flop (didn't bet)


Poker Hand #RC3795927810: Hold'em No Limit ($0.02/$0.05) - 2025/08/10 08:12:32
Table 'RushAndCash11063070' 6-max Seat #1 is the button
Seat 1: Hero ($4.46 in chips)
Seat 2: 42c31e1a ($9.38 in chips)
Seat 3: b18a3d20 ($2.88 in chips)
Seat 4: 9d70d038 ($11.01 in chips)
Seat 5: bc8475a8 ($7.87 in chips)
Seat 6: d1364679 ($7.22 in chips)
42c31e1a: posts small blind $0.02
b18a3d20: posts big blind $0.05
*** HOLE CARDS ***
Dealt to Hero [3c 7h]
Dealt to 42c31e1a 
Dealt to b18a3d20 
Dealt to 9d70d038 
Dealt to bc8475a8 
Dealt to d1364679 
9d70d038: folds
bc8475a8: raises $0.07 to $0.12
d1364679: folds
Hero: folds
42c31e1a: folds
b18a3d20: folds
Uncalled bet ($0.07) returned to bc8475a8
*** SHOWDOWN ***
bc8475a8 collected $0.12 from pot
*** SUMMARY ***
Total pot $0.12 | Rake $0 | Jackpot $0 | Bingo $0 | Fortune $0 | Tax $0
Seat 1: Hero (button) folded before Flop (didn't bet)
Seat 2: 42c31e1a (small blind) folded before Flop
Seat 3: b18a3d20 (big blind) folded before Flop
Seat 4: 9d70d038 folded before Flop (didn't bet)
Seat 5: bc8475a8 collected ($0.12)
Seat 6: d1364679 folded before Flop (didn't bet)


Poker Hand #RC3795927799: Hold'em No Limit ($0.02/$0.05) - 2025/08/10 08:12:29
Table 'RushAndCash11063059' 6-max Seat #1 is the button
Seat 1: b18a3d20 ($2.88 in chips)
Seat 2: Hero ($4.48 in chips)
Seat 3: f01023d5 ($5.53 in chips)
Seat 4: fd1bec92 ($13.06 in chips)
Seat 5: 42c31e1a ($9.38 in chips)
Seat 6: 665d5285 ($10.64 in chips)
Hero: posts small blind $0.02
f01023d5: posts big blind $0.05
*** HOLE CARDS ***
Dealt to b18a3d20 
Dealt to Hero [2h 4d]
Dealt to f01023d5 
Dealt to fd1bec92 
Dealt to 42c31e1a 
Dealt to 665d5285 
fd1bec92: folds
42c31e1a: folds
665d5285: folds
b18a3d20: folds
Hero: folds
Uncalled bet ($0.03) returned to f01023d5
*** SHOWDOWN ***
f01023d5 collected $0.04 from pot
*** SUMMARY ***
Total pot $0.04 | Rake $0 | Jackpot $0 | Bingo $0 | Fortune $0 | Tax $0
Seat 1: b18a3d20 (button) folded before Flop (didn't bet)
Seat 2: Hero (small blind) folded before Flop
Seat 3: f01023d5 (big blind) collected ($0.04)
Seat 4: fd1bec92 folded before Flop (didn't bet)
Seat 5: 42c31e1a folded before Flop (didn't bet)
Seat 6: 665d5285 folded before Flop (didn't bet)


Poker Hand #RC3795927774: Hold'em No Limit ($0.02/$0.05) - 2025/08/10 08:12:21
Table 'RushAndCash11063034' 6-max Seat #1 is the button
Seat 1: 1982f140 ($9.55 in chips)
Seat 2: 5b54e251 ($11.02 in chips)
Seat 3: Hero ($4.53 in chips)
Seat 4: e7e9348c ($16.45 in chips)
Seat 5: 18b1ecd7 ($5.17 in chips)
Seat 6: 18ca1e6b ($8.51 in chips)
5b54e251: posts small blind $0.02
Hero: posts big blind $0.05
*** HOLE CARDS ***
Dealt to 1982f140 
Dealt to 5b54e251 
Dealt to Hero [6s 2c]
Dealt to e7e9348c 
Dealt to 18b1ecd7 
Dealt to 18ca1e6b 
e7e9348c: calls $0.05
18b1ecd7: folds
18ca1e6b: folds
1982f140: folds
5b54e251: raises $0.23 to $0.28
Hero: folds
e7e9348c: folds
Uncalled bet ($0.23) returned to 5b54e251
*** SHOWDOWN ***
5b54e251 collected $0.15 from pot
*** SUMMARY ***
Total pot $0.15 | Rake $0 | Jackpot $0 | Bingo $0 | Fortune $0 | Tax $0
Seat 1: 1982f140 (button) folded before Flop (didn't bet)
Seat 2: 5b54e251 (small blind) collected ($0.15)
Seat 3: Hero (big blind) folded before Flop
Seat 4: e7e9348c folded before Flop
Seat 5: 18b1ecd7 folded before Flop (didn't bet)
Seat 6: 18ca1e6b folded before Flop (didn't bet)


Poker Hand #RC3795927762: Hold'em No Limit ($0.02/$0.05) - 2025/08/10 08:12:17
Table 'RushAndCash11063022' 6-max Seat #1 is the button
Seat 1: 1cebd796 ($6.9 in chips)
Seat 2: 5aed7ada ($5.46 in chips)
Seat 3: 43f64b9b ($5.02 in chips)
Seat 4: 117c5240 ($11.63 in chips)
Seat 5: 18b1ecd7 ($5.17 in chips)
Seat 6: Hero ($4.53 in chips)
5aed7ada: posts small blind $0.02
43f64b9b: posts big blind $0.05
*** HOLE CARDS ***
Dealt to 1cebd796 
Dealt to 5aed7ada 
Dealt to 43f64b9b 
Dealt to 117c5240 
Dealt to 18b1ecd7 
Dealt to Hero [2s 2c]
117c5240: raises $0.05 to $0.1
18b1ecd7: folds
Hero: folds
1cebd796: calls $0.1
5aed7ada: folds
43f64b9b: folds
*** FLOP *** [2h Qh 7s]
117c5240: bets $0.09
1cebd796: raises $0.15 to $0.24
117c5240: calls $0.15
*** TURN *** [2h Qh 7s] [8h]
117c5240: checks
1cebd796: checks
*** RIVER *** [2h Qh 7s 8h] [Td]
117c5240: bets $0.5
1cebd796: folds
Uncalled bet ($0.5) returned to 117c5240
*** SHOWDOWN ***
117c5240 collected $0.72 from pot
*** SUMMARY ***
Total pot $0.75 | Rake $0.03 | Jackpot $0 | Bingo $0 | Fortune $0 | Tax $0
Board [2h Qh 7s 8h Td]
Seat 1: 1cebd796 (button) folded on the River
Seat 2: 5aed7ada (small blind) folded before Flop
Seat 3: 43f64b9b (big blind) folded before Flop
Seat 4: 117c5240 won ($0.72)
Seat 5: 18b1ecd7 folded before Flop (didn't bet)
Seat 6: Hero folded before Flop (didn't bet)


Poker Hand #RC3795927730: Hold'em No Limit ($0.02/$0.05) - 2025/08/10 08:12:09
Table 'RushAndCash11062990' 6-max Seat #1 is the button
Seat 1: b24cb5d8 ($10.84 in chips)
Seat 2: cf3b419d ($6.15 in chips)
Seat 3: 94a86efb ($5.13 in chips)
Seat 4: f3a1d090 ($24.64 in chips)
Seat 5: eda05e75 ($5 in chips)
Seat 6: Hero ($4.53 in chips)
cf3b419d: posts small blind $0.02
94a86efb: posts big blind $0.05
*** HOLE CARDS ***
Dealt to b24cb5d8 
Dealt to cf3b419d 
Dealt to 94a86efb 
Dealt to f3a1d090 
Dealt to eda05e75 
Dealt to Hero [5d Ac]
f3a1d090: raises $0.07 to $0.12
eda05e75: folds
Hero: folds
b24cb5d8: folds
cf3b419d: folds
94a86efb: folds
Uncalled bet ($0.07) returned to f3a1d090
*** SHOWDOWN ***
f3a1d090 collected $0.12 from pot
*** SUMMARY ***
Total pot $0.12 | Rake $0 | Jackpot $0 | Bingo $0 | Fortune $0 | Tax $0
Seat 1: b24cb5d8 (button) folded before Flop (didn't bet)
Seat 2: cf3b419d (small blind) folded before Flop
Seat 3: 94a86efb (big blind) folded before Flop
Seat 4: f3a1d090 collected ($0.12)
Seat 5: eda05e75 folded before Flop (didn't bet)
Seat 6: Hero folded before Flop (didn't bet)


Poker Hand #RC3795927716: Hold'em No Limit ($0.02/$0.05) - 2025/08/10 08:12:05
Table 'RushAndCash11062976' 6-max Seat #1 is the button
Seat 1: c74f6781 ($5.02 in chips)
Seat 2: 9e0c2202 ($5 in chips)
Seat 3: aa95eeae ($6.96 in chips)
Seat 4: Hero ($4.53 in chips)
Seat 5: 210c8e9b ($13.19 in chips)
Seat 6: 9b73cb59 ($9.45 in chips)
9e0c2202: posts small blind $0.02
aa95eeae: posts big blind $0.05
*** HOLE CARDS ***
Dealt to c74f6781 
Dealt to 9e0c2202 
Dealt to aa95eeae 
Dealt to Hero [2s 3h]
Dealt to 210c8e9b 
Dealt to 9b73cb59 
Hero: folds
210c8e9b: folds
9b73cb59: folds
c74f6781: raises $0.05 to $0.1
9e0c2202: calls $0.08
aa95eeae: folds
*** FLOP *** [Jd 2c 5d]
9e0c2202: checks
c74f6781: bets $0.13
9e0c2202: calls $0.13
*** TURN *** [Jd 2c 5d] [4s]
9e0c2202: checks
c74f6781: bets $0.17
9e0c2202: folds
Uncalled bet ($0.17) returned to c74f6781
*** SHOWDOWN ***
c74f6781 collected $0.49 from pot
*** SUMMARY ***
Total pot $0.51 | Rake $0.02 | Jackpot $0 | Bingo $0 | Fortune $0 | Tax $0
Board [Jd 2c 5d 4s]
Seat 1: c74f6781 (button) won ($0.49)
Seat 2: 9e0c2202 (small blind) folded on the Turn
Seat 3: aa95eeae (big blind) folded before Flop
Seat 4: Hero folded before Flop (didn't bet)
Seat 5: 210c8e9b folded before Flop (didn't bet)
Seat 6: 9b73cb59 folded before Flop (didn't bet)


Poker Hand #RC3795927698: Hold'em No Limit ($0.02/$0.05) - 2025/08/10 08:12:01
Table 'RushAndCash11062958' 6-max Seat #1 is the button
Seat 1: 8934bd25 ($4.91 in chips)
Seat 2: 605e49e4 ($16.34 in chips)
Seat 3: 70573b8 ($5.43 in chips)
Seat 4: 147849a7 ($5.38 in chips)
Seat 5: Hero ($4.53 in chips)
Seat 6: cb83453e ($10.98 in chips)
605e49e4: posts small blind $0.02
70573b8: posts big blind $0.05
*** HOLE CARDS ***
Dealt to 8934bd25 
Dealt to 605e49e4 
Dealt to 70573b8 
Dealt to 147849a7 
Dealt to Hero [6h 7s]
Dealt to cb83453e 
147849a7: folds
Hero: folds
cb83453e: folds
8934bd25: folds
605e49e4: folds
Uncalled bet ($0.03) returned to 70573b8
*** SHOWDOWN ***
70573b8 collected $0.04 from pot
*** SUMMARY ***
Total pot $0.04 | Rake $0 | Jackpot $0 | Bingo $0 | Fortune $0 | Tax $0
Seat 1: 8934bd25 (button) folded before Flop (didn't bet)
Seat 2: 605e49e4 (small blind) folded before Flop
Seat 3: 70573b8 (big blind) collected ($0.04)
Seat 4: 147849a7 folded before Flop (didn't bet)
Seat 5: Hero folded before Flop (didn't bet)
Seat 6: cb83453e folded before Flop (didn't bet)


Poker Hand #RC3795927526: Hold'em No Limit ($0.02/$0.05) - 2025/08/10 08:11:13
Table 'RushAndCash11062786' 6-max Seat #1 is the button
Seat 1: e416125e ($5 in chips)
Seat 2: Hero ($4.63 in chips)
Seat 3: 560bbe0d ($13.02 in chips)
Seat 4: 665d5285 ($10.57 in chips)
Seat 5: 59da8582 ($6.83 in chips)
Seat 6: 483f17c3 ($16.08 in chips)
Hero: posts small blind $0.02
560bbe0d: posts big blind $0.05
*** HOLE CARDS ***
Dealt to e416125e 
Dealt to Hero [4d 7d]
Dealt to 560bbe0d 
Dealt to 665d5285 
Dealt to 59da8582 
Dealt to 483f17c3 
665d5285: folds
59da8582: folds
483f17c3: folds
e416125e: folds
Hero: raises $0.05 to $0.1
560bbe0d: calls $0.05
*** FLOP *** [Ks 5s 4c]
Hero: checks
560bbe0d: checks
*** TURN *** [Ks 5s 4c] [8s]
Hero: checks
560bbe0d: checks
*** RIVER *** [Ks 5s 4c 8s] [Qh]
Hero: checks
560bbe0d: checks
Hero: shows [4d 7d] (a pair of Fours)
560bbe0d: shows [2c 5c] (a pair of Fives)
*** SHOWDOWN ***
560bbe0d collected $0.19 from pot
*** SUMMARY ***
Total pot $0.2 | Rake $0.01 | Jackpot $0 | Bingo $0 | Fortune $0 | Tax $0
Board [Ks 5s 4c 8s Qh]
Seat 1: e416125e (button) folded before Flop (didn't bet)
Seat 2: Hero (small blind) showed [4d 7d] and lost with a pair of Fours
Seat 3: 560bbe0d (big blind) showed [2c 5c] and won ($0.19) with a pair of Fives
Seat 4: 665d5285 folded before Flop (didn't bet)
Seat 5: 59da8582 folded before Flop (didn't bet)
Seat 6: 483f17c3 folded before Flop (didn't bet)


Poker Hand #RC3795927512: Hold'em No Limit ($0.02/$0.05) - 2025/08/10 08:11:09
Table 'RushAndCash11062772' 6-max Seat #1 is the button
Seat 1: 3f5c4b90 ($8.96 in chips)
Seat 2: 6412bd28 ($5.29 in chips)
Seat 3: aa95eeae ($7.03 in chips)
Seat 4: cf24dfe4 ($7.53 in chips)
Seat 5: 560bbe0d ($13.02 in chips)
Seat 6: Hero ($4.63 in chips)
6412bd28: posts small blind $0.02
aa95eeae: posts big blind $0.05
*** HOLE CARDS ***
Dealt to 3f5c4b90 
Dealt to 6412bd28 
Dealt to aa95eeae 
Dealt to cf24dfe4 
Dealt to 560bbe0d 
Dealt to Hero [2h 6d]
cf24dfe4: folds
560bbe0d: folds
Hero: folds
3f5c4b90: raises $0.08 to $0.13
6412bd28: folds
aa95eeae: folds
Uncalled bet ($0.08) returned to 3f5c4b90
*** SHOWDOWN ***
3f5c4b90 collected $0.12 from pot
*** SUMMARY ***
Total pot $0.12 | Rake $0 | Jackpot $0 | Bingo $0 | Fortune $0 | Tax $0
Seat 1: 3f5c4b90 (button) collected ($0.12)
Seat 2: 6412bd28 (small blind) folded before Flop
Seat 3: aa95eeae (big blind) folded before Flop
Seat 4: cf24dfe4 folded before Flop (didn't bet)
Seat 5: 560bbe0d folded before Flop (didn't bet)
Seat 6: Hero folded before Flop (didn't bet)


Poker Hand #RC3795927486: Hold'em No Limit ($0.02/$0.05) - 2025/08/10 08:11:03
Table 'RushAndCash11062746' 6-max Seat #1 is the button
Seat 1: 71c02919 ($5.01 in chips)
Seat 2: 7a644870 ($5 in chips)
Seat 3: Hero ($4.68 in chips)
Seat 4: 1982f140 ($10.12 in chips)
Seat 5: 81b8bd6d ($4.76 in chips)
Seat 6: dca1c3af ($3 in chips)
7a644870: posts small blind $0.02
Hero: posts big blind $0.05
*** HOLE CARDS ***
Dealt to 71c02919 
Dealt to 7a644870 
Dealt to Hero [2h 9c]
Dealt to 1982f140 
Dealt to 81b8bd6d 
Dealt to dca1c3af 
1982f140: raises $0.08 to $0.13
81b8bd6d: folds
dca1c3af: folds
71c02919: calls $0.13
7a644870: folds
Hero: folds
*** FLOP *** [3c Ah 7s]
1982f140: bets $0.12
71c02919: calls $0.12
*** TURN *** [3c Ah 7s] [6d]
1982f140: bets $0.25
71c02919: calls $0.25
*** RIVER *** [3c Ah 7s 6d] [Th]
1982f140: checks
71c02919: checks
1982f140: shows [Tc 8c] (a pair of Tens)
71c02919: shows [Ad Jh] (a pair of Aces)
*** SHOWDOWN ***
71c02919 collected $1.01 from pot
*** SUMMARY ***
Total pot $1.07 | Rake $0.06 | Jackpot $0 | Bingo $0 | Fortune $0 | Tax $0
Board [3c Ah 7s 6d Th]
Seat 1: 71c02919 (button) showed [Ad Jh] and won ($1.01) with a pair of Aces
Seat 2: 7a644870 (small blind) folded before Flop
Seat 3: Hero (big blind) folded before Flop
Seat 4: 1982f140 showed [Tc 8c] and lost with a pair of Tens
Seat 5: 81b8bd6d folded before Flop (didn't bet)
Seat 6: dca1c3af folded before Flop (didn't bet)


Poker Hand #RC3795927415: Hold'em No Limit ($0.02/$0.05) - 2025/08/10 08:10:44
Table 'RushAndCash11062675' 6-max Seat #1 is the button
Seat 1: Hero ($4.68 in chips)
Seat 2: a57b331d ($21.8 in chips)
Seat 3: 40e1cc86 ($9.8 in chips)
Seat 4: 196c1899 ($14.13 in chips)
Seat 5: e90b1294 ($5 in chips)
Seat 6: 8d67d790 ($10.24 in chips)
a57b331d: posts small blind $0.02
40e1cc86: posts big blind $0.05
*** HOLE CARDS ***
Dealt to Hero [Qc 5c]
Dealt to a57b331d 
Dealt to 40e1cc86 
Dealt to 196c1899 
Dealt to e90b1294 
Dealt to 8d67d790 
196c1899: folds
e90b1294: folds
8d67d790: raises $0.05 to $0.1
Hero: folds
a57b331d: folds
40e1cc86: folds
Uncalled bet ($0.05) returned to 8d67d790
*** SHOWDOWN ***
8d67d790 collected $0.12 from pot
*** SUMMARY ***
Total pot $0.12 | Rake $0 | Jackpot $0 | Bingo $0 | Fortune $0 | Tax $0
Seat 1: Hero (button) folded before Flop (didn't bet)
Seat 2: a57b331d (small blind) folded before Flop
Seat 3: 40e1cc86 (big blind) folded before Flop
Seat 4: 196c1899 folded before Flop (didn't bet)
Seat 5: e90b1294 folded before Flop (didn't bet)
Seat 6: 8d67d790 collected ($0.12)


Poker Hand #RC3795927400: Hold'em No Limit ($0.02/$0.05) - 2025/08/10 08:10:41
Table 'RushAndCash11062660' 6-max Seat #1 is the button
Seat 1: d3b2bf87 ($6.89 in chips)
Seat 2: 562bc648 ($5 in chips)
Seat 3: 637628c5 ($8.75 in chips)
Seat 4: 8b390e1e ($5.23 in chips)
Seat 5: f6bf8dfb ($5.29 in chips)
Seat 6: Hero ($4.68 in chips)
562bc648: posts small blind $0.02
637628c5: posts big blind $0.05
*** HOLE CARDS ***
Dealt to d3b2bf87 
Dealt to 562bc648 
Dealt to 637628c5 
Dealt to 8b390e1e 
Dealt to f6bf8dfb 
Dealt to Hero [2h Ad]
8b390e1e: folds
f6bf8dfb: folds
Hero: folds
d3b2bf87: raises $0.07 to $0.12
562bc648: folds
637628c5: folds
Uncalled bet ($0.07) returned to d3b2bf87
*** SHOWDOWN ***
d3b2bf87 collected $0.12 from pot
*** SUMMARY ***
Total pot $0.12 | Rake $0 | Jackpot $0 | Bingo $0 | Fortune $0 | Tax $0
Seat 1: d3b2bf87 (button) collected ($0.12)
Seat 2: 562bc648 (small blind) folded before Flop
Seat 3: 637628c5 (big blind) folded before Flop
Seat 4: 8b390e1e folded before Flop (didn't bet)
Seat 5: f6bf8dfb folded before Flop (didn't bet)
Seat 6: Hero folded before Flop (didn't bet)


Poker Hand #RC3795927351: Hold'em No Limit ($0.02/$0.05) - 2025/08/10 08:10:29
Table 'RushAndCash11062611' 6-max Seat #1 is the button
Seat 1: Hero ($4.61 in chips)
Seat 2: c6b4a39c ($5.39 in chips)
Seat 3: 483f17c3 ($16.2 in chips)
Seat 4: 72f7d641 ($11.9 in chips)
Seat 5: 4eeb4b51 ($5 in chips)
Seat 6: fdfc54bf ($16.61 in chips)
c6b4a39c: posts small blind $0.02
483f17c3: posts big blind $0.05
*** HOLE CARDS ***
Dealt to Hero [Ad As]
Dealt to c6b4a39c 
Dealt to 483f17c3 
Dealt to 72f7d641 
Dealt to 4eeb4b51 
Dealt to fdfc54bf 
72f7d641: folds
4eeb4b51: folds
fdfc54bf: folds
Hero: raises $0.05 to $0.1
c6b4a39c: folds
483f17c3: folds
Uncalled bet ($0.05) returned to Hero
*** SHOWDOWN ***
Hero collected $0.12 from pot
*** SUMMARY ***
Total pot $0.12 | Rake $0 | Jackpot $0 | Bingo $0 | Fortune $0 | Tax $0
Seat 1: Hero (button) collected ($0.12)
Seat 2: c6b4a39c (small blind) folded before Flop
Seat 3: 483f17c3 (big blind) folded before Flop
Seat 4: 72f7d641 folded before Flop (didn't bet)
Seat 5: 4eeb4b51 folded before Flop (didn't bet)
Seat 6: fdfc54bf folded before Flop (didn't bet)


Poker Hand #RC3795927315: Hold'em No Limit ($0.02/$0.05) - 2025/08/10 08:10:19
Table 'RushAndCash11062575' 6-max Seat #1 is the button
Seat 1: 7d1f43e4 ($4.17 in chips)
Seat 2: 7f40418 ($5 in chips)
Seat 3: b6de5713 ($11.45 in chips)
Seat 4: Hero ($4.61 in chips)
Seat 5: 9b73cb59 ($9.52 in chips)
Seat 6: eda05e75 ($5 in chips)
7f40418: posts small blind $0.02
b6de5713: posts big blind $0.05
*** HOLE CARDS ***
Dealt to 7d1f43e4 
Dealt to 7f40418 
Dealt to b6de5713 
Dealt to Hero [Jc Qc]
Dealt to 9b73cb59 
Dealt to eda05e75 
Hero: folds
9b73cb59: folds
eda05e75: raises $0.05 to $0.1
7d1f43e4: folds
7f40418: folds
b6de5713: calls $0.05
*** FLOP *** [Kh 7h 6s]
b6de5713: bets $0.08
eda05e75: calls $0.08
*** TURN *** [Kh 7h 6s] [Td]
b6de5713: bets $0.13
eda05e75: calls $0.13
*** RIVER *** [Kh 7h 6s Td] [4c]
b6de5713: checks
eda05e75: checks
b6de5713: shows [6h 4h] (two pair, Sixes and Fours)
eda05e75: shows [Qs Ad] (Ace high)
*** SHOWDOWN ***
b6de5713 collected $0.61 from pot
*** SUMMARY ***
Total pot $0.64 | Rake $0.03 | Jackpot $0 | Bingo $0 | Fortune $0 | Tax $0
Board [Kh 7h 6s Td 4c]
Seat 1: 7d1f43e4 (button) folded before Flop (didn't bet)
Seat 2: 7f40418 (small blind) folded before Flop
Seat 3: b6de5713 (big blind) showed [6h 4h] and won ($0.61) with two pair, Sixes and Fours
Seat 4: Hero folded before Flop (didn't bet)
Seat 5: 9b73cb59 folded before Flop (didn't bet)
Seat 6: eda05e75 showed [Qs Ad] and lost with Ace high


Poker Hand #RC3795927255: Hold'em No Limit ($0.02/$0.05) - 2025/08/10 08:10:04
Table 'RushAndCash11062515' 6-max Seat #1 is the button
Seat 1: f6c47f47 ($4.03 in chips)
Seat 2: Hero ($4.63 in chips)
Seat 3: ae6360a0 ($6.55 in chips)
Seat 4: b38edfef ($5.42 in chips)
Seat 5: e8d6e6da ($5.87 in chips)
Seat 6: 68db1858 ($5.6 in chips)
Hero: posts small blind $0.02
ae6360a0: posts big blind $0.05
*** HOLE CARDS ***
Dealt to f6c47f47 
Dealt to Hero [8h 7s]
Dealt to ae6360a0 
Dealt to b38edfef 
Dealt to e8d6e6da 
Dealt to 68db1858 
b38edfef: folds
e8d6e6da: raises $0.05 to $0.1
68db1858: folds
f6c47f47: folds
Hero: folds
ae6360a0: calls $0.05
*** FLOP *** [7d Ac Qc]
ae6360a0: checks
e8d6e6da: bets $0.08
ae6360a0: calls $0.08
*** TURN *** [7d Ac Qc] [Js]
ae6360a0: checks
e8d6e6da: bets $0.26
ae6360a0: folds
Uncalled bet ($0.26) returned to e8d6e6da
*** SHOWDOWN ***
e8d6e6da collected $0.37 from pot
*** SUMMARY ***
Total pot $0.38 | Rake $0.01 | Jackpot $0 | Bingo $0 | Fortune $0 | Tax $0
Board [7d Ac Qc Js]
Seat 1: f6c47f47 (button) folded before Flop (didn't bet)
Seat 2: Hero (small blind) folded before Flop
Seat 3: ae6360a0 (big blind) folded on the Turn
Seat 4: b38edfef folded before Flop (didn't bet)
Seat 5: e8d6e6da won ($0.37)
Seat 6: 68db1858 folded before Flop (didn't bet)


Poker Hand #RC3795927215: Hold'em No Limit ($0.02/$0.05) - 2025/08/10 08:09:55
Table 'RushAndCash11062475' 6-max Seat #1 is the button
Seat 1: 9999c04f ($2.97 in chips)
Seat 2: 55c5398 ($5.77 in chips)
Seat 3: Hero ($4.68 in chips)
Seat 4: a2b313bf ($13.8 in chips)
Seat 5: b1b3930a ($5.1 in chips)
Seat 6: 1cebd796 ($6.84 in chips)
55c5398: posts small blind $0.02
Hero: posts big blind $0.05
*** HOLE CARDS ***
Dealt to 9999c04f 
Dealt to 55c5398 
Dealt to Hero [6s 9c]
Dealt to a2b313bf 
Dealt to b1b3930a 
Dealt to 1cebd796 
a2b313bf: folds
b1b3930a: raises $0.08 to $0.13
1cebd796: folds
9999c04f: folds
55c5398: raises $0.31 to $0.44
Hero: folds
b1b3930a: calls $0.31
*** FLOP *** [8s 2h 5c]
55c5398: bets $0.49
b1b3930a: calls $0.49
*** TURN *** [8s 2h 5c] [6c]
55c5398: bets $1.91
b1b3930a: folds
Uncalled bet ($1.91) returned to 55c5398
*** SHOWDOWN ***
55c5398 collected $1.75 from pot
*** SUMMARY ***
Total pot $1.91 | Rake $0.09 | Jackpot $0.07 | Bingo $0 | Fortune $0 | Tax $0
Board [8s 2h 5c 6c]
Seat 1: 9999c04f (button) folded before Flop (didn't bet)
Seat 2: 55c5398 (small blind) won ($1.75)
Seat 3: Hero (big blind) folded before Flop
Seat 4: a2b313bf folded before Flop (didn't bet)
Seat 5: b1b3930a folded on the Turn
Seat 6: 1cebd796 folded before Flop (didn't bet)


Poker Hand #RC3795927200: Hold'em No Limit ($0.02/$0.05) - 2025/08/10 08:09:50
Table 'RushAndCash11062460' 6-max Seat #1 is the button
Seat 1: d5b42329 ($10.17 in chips)
Seat 2: ae6360a0 ($6.57 in chips)
Seat 3: 52682b66 ($2.13 in chips)
Seat 4: 9fd1d64c ($5.19 in chips)
Seat 5: Hero ($4.68 in chips)
Seat 6: b1b3930a ($5.1 in chips)
ae6360a0: posts small blind $0.02
52682b66: posts big blind $0.05
*** HOLE CARDS ***
Dealt to d5b42329 
Dealt to ae6360a0 
Dealt to 52682b66 
Dealt to 9fd1d64c 
Dealt to Hero [7d 9d]
Dealt to b1b3930a 
9fd1d64c: folds
Hero: folds
b1b3930a: folds
d5b42329: raises $0.08 to $0.13
ae6360a0: folds
52682b66: folds
Uncalled bet ($0.08) returned to d5b42329
*** SHOWDOWN ***
d5b42329 collected $0.12 from pot
*** SUMMARY ***
Total pot $0.12 | Rake $0 | Jackpot $0 | Bingo $0 | Fortune $0 | Tax $0
Seat 1: d5b42329 (button) collected ($0.12)
Seat 2: ae6360a0 (small blind) folded before Flop
Seat 3: 52682b66 (big blind) folded before Flop
Seat 4: 9fd1d64c folded before Flop (didn't bet)
Seat 5: Hero folded before Flop (didn't bet)
Seat 6: b1b3930a folded before Flop (didn't bet)


Poker Hand #RC3795927187: Hold'em No Limit ($0.02/$0.05) - 2025/08/10 08:09:46
Table 'RushAndCash11062447' 6-max Seat #1 is the button
Seat 1: d5b42329 ($10.17 in chips)
Seat 2: bf51b512 ($5.77 in chips)
Seat 3: 8a158df0 ($9.7 in chips)
Seat 4: 52682b66 ($2.13 in chips)
Seat 5: 8d67d790 ($10.24 in chips)
Seat 6: Hero ($4.68 in chips)
bf51b512: posts small blind $0.02
8a158df0: posts big blind $0.05
*** HOLE CARDS ***
Dealt to d5b42329 
Dealt to bf51b512 
Dealt to 8a158df0 
Dealt to 52682b66 
Dealt to 8d67d790 
Dealt to Hero [Tc 3h]
52682b66: folds
8d67d790: folds
Hero: folds
d5b42329: folds
bf51b512: folds
Uncalled bet ($0.03) returned to 8a158df0
*** SHOWDOWN ***
8a158df0 collected $0.04 from pot
*** SUMMARY ***
Total pot $0.04 | Rake $0 | Jackpot $0 | Bingo $0 | Fortune $0 | Tax $0
Seat 1: d5b42329 (button) folded before Flop (didn't bet)
Seat 2: bf51b512 (small blind) folded before Flop
Seat 3: 8a158df0 (big blind) collected ($0.04)
Seat 4: 52682b66 folded before Flop (didn't bet)
Seat 5: 8d67d790 folded before Flop (didn't bet)
Seat 6: Hero folded before Flop (didn't bet)


Poker Hand #RC3795927169: Hold'em No Limit ($0.02/$0.05) - 2025/08/10 08:09:41
Table 'RushAndCash11062429' 6-max Seat #1 is the button
Seat 1: 196a508f ($13.46 in chips)
Seat 2: 6e6b280f ($12.68 in chips)
Seat 3: 65914450 ($27.08 in chips)
Seat 4: Hero ($4.68 in chips)
Seat 5: 2c28207b ($6.94 in chips)
Seat 6: ca112d1 ($7.84 in chips)
6e6b280f: posts small blind $0.02
65914450: posts big blind $0.05
*** HOLE CARDS ***
Dealt to 196a508f 
Dealt to 6e6b280f 
Dealt to 65914450 
Dealt to Hero [Qh 3s]
Dealt to 2c28207b 
Dealt to ca112d1 
Hero: folds
2c28207b: folds
ca112d1: folds
196a508f: folds
6e6b280f: raises $0.08 to $0.13
65914450: calls $0.08
*** FLOP *** [3h Kc 6c]
6e6b280f: checks
65914450: checks
*** TURN *** [3h Kc 6c] [4d]
6e6b280f: checks
65914450: bets $0.13
6e6b280f: folds
Uncalled bet ($0.13) returned to 65914450
*** SHOWDOWN ***
65914450 collected $0.25 from pot
*** SUMMARY ***
Total pot $0.26 | Rake $0.01 | Jackpot $0 | Bingo $0 | Fortune $0 | Tax $0
Board [3h Kc 6c 4d]
Seat 1: 196a508f (button) folded before Flop (didn't bet)
Seat 2: 6e6b280f (small blind) folded on the Turn
Seat 3: 65914450 (big blind) won ($0.25)
Seat 4: Hero folded before Flop (didn't bet)
Seat 5: 2c28207b folded before Flop (didn't bet)
Seat 6: ca112d1 folded before Flop (didn't bet)


Poker Hand #RC3795927129: Hold'em No Limit ($0.02/$0.05) - 2025/08/10 08:09:30
Table 'RushAndCash11062389' 6-max Seat #1 is the button
Seat 1: 2c53d2c7 ($5.13 in chips)
Seat 2: fa76288b ($6.15 in chips)
Seat 3: Hero ($4.73 in chips)
Seat 4: 3f5c4b90 ($8.75 in chips)
Seat 5: d796f1b5 ($13.55 in chips)
Seat 6: 1cebd796 ($6.77 in chips)
fa76288b: posts small blind $0.02
Hero: posts big blind $0.05
*** HOLE CARDS ***
Dealt to 2c53d2c7 
Dealt to fa76288b 
Dealt to Hero [5d 2c]
Dealt to 3f5c4b90 
Dealt to d796f1b5 
Dealt to 1cebd796 
3f5c4b90: folds
d796f1b5: folds
1cebd796: raises $0.12 to $0.17
2c53d2c7: folds
fa76288b: folds
Hero: folds
Uncalled bet ($0.12) returned to 1cebd796
*** SHOWDOWN ***
1cebd796 collected $0.12 from pot
*** SUMMARY ***
Total pot $0.12 | Rake $0 | Jackpot $0 | Bingo $0 | Fortune $0 | Tax $0
Seat 1: 2c53d2c7 (button) folded before Flop (didn't bet)
Seat 2: fa76288b (small blind) folded before Flop
Seat 3: Hero (big blind) folded before Flop
Seat 4: 3f5c4b90 folded before Flop (didn't bet)
Seat 5: d796f1b5 folded before Flop (didn't bet)
Seat 6: 1cebd796 collected ($0.12)


Poker Hand #RC3795926866: Hold'em No Limit ($0.02/$0.05) - 2025/08/10 08:08:19
Table 'RushAndCash11062126' 6-max Seat #1 is the button
Seat 1: Hero ($4.62 in chips)
Seat 2: 9fd1d64c ($5.01 in chips)
Seat 3: fa76288b ($6.25 in chips)
Seat 4: fc1e46cd ($5.8 in chips)
Seat 5: 72f7d641 ($11.83 in chips)
Seat 6: a63176ef ($6.96 in chips)
9fd1d64c: posts small blind $0.02
fa76288b: posts big blind $0.05
*** HOLE CARDS ***
Dealt to Hero [Jc 9d]
Dealt to 9fd1d64c 
Dealt to fa76288b 
Dealt to fc1e46cd 
Dealt to 72f7d641 
Dealt to a63176ef 
fc1e46cd: folds
72f7d641: folds
a63176ef: folds
Hero: raises $0.05 to $0.1
9fd1d64c: folds
fa76288b: calls $0.05
*** FLOP *** [4s Kd 5h]
fa76288b: checks
Hero: checks
*** TURN *** [4s Kd 5h] [5d]
fa76288b: checks
Hero: checks
*** RIVER *** [4s Kd 5h 5d] [Jd]
fa76288b: checks
Hero: checks
fa76288b: shows [8c 8h] (two pair, Eights and Fives)
Hero: shows [Jc 9d] (two pair, Jacks and Fives)
*** SHOWDOWN ***
Hero collected $0.21 from pot
*** SUMMARY ***
Total pot $0.22 | Rake $0.01 | Jackpot $0 | Bingo $0 | Fortune $0 | Tax $0
Board [4s Kd 5h 5d Jd]
Seat 1: Hero (button) showed [Jc 9d] and won ($0.21) with two pair, Jacks and Fives
Seat 2: 9fd1d64c (small blind) folded before Flop
Seat 3: fa76288b (big blind) showed [8c 8h] and lost with two pair, Eights and Fives
Seat 4: fc1e46cd folded before Flop (didn't bet)
Seat 5: 72f7d641 folded before Flop (didn't bet)
Seat 6: a63176ef folded before Flop (didn't bet)


Poker Hand #RC3795926827: Hold'em No Limit ($0.02/$0.05) - 2025/08/10 08:08:08
Table 'RushAndCash11062087' 6-max Seat #1 is the button
Seat 1: 117c5240 ($13.05 in chips)
Seat 2: Hero ($4.64 in chips)
Seat 3: c1d96785 ($11.54 in chips)
Seat 4: 52682b66 ($2.17 in chips)
Seat 5: 949b5efc ($6.23 in chips)
Seat 6: 38df6650 ($5 in chips)
Hero: posts small blind $0.02
c1d96785: posts big blind $0.05
*** HOLE CARDS ***
Dealt to 117c5240 
Dealt to Hero [Ah 7c]
Dealt to c1d96785 
Dealt to 52682b66 
Dealt to 949b5efc 
Dealt to 38df6650 
52682b66: folds
949b5efc: folds
38df6650: raises $0.05 to $0.1
117c5240: folds
Hero: folds
c1d96785: calls $0.05
*** FLOP *** [Ad Kh Td]
c1d96785: checks
38df6650: checks
*** TURN *** [Ad Kh Td] [9c]
c1d96785: bets $0.11
38df6650: folds
Uncalled bet ($0.11) returned to c1d96785
*** SHOWDOWN ***
c1d96785 collected $0.21 from pot
*** SUMMARY ***
Total pot $0.22 | Rake $0.01 | Jackpot $0 | Bingo $0 | Fortune $0 | Tax $0
Board [Ad Kh Td 9c]
Seat 1: 117c5240 (button) folded before Flop (didn't bet)
Seat 2: Hero (small blind) folded before Flop
Seat 3: c1d96785 (big blind) won ($0.21)
Seat 4: 52682b66 folded before Flop (didn't bet)
Seat 5: 949b5efc folded before Flop (didn't bet)
Seat 6: 38df6650 folded on the Turn


Poker Hand #RC3795926817: Hold'em No Limit ($0.02/$0.05) - 2025/08/10 08:08:04
Table 'RushAndCash11062077' 6-max Seat #1 is the button
Seat 1: 3bd13722 ($7.67 in chips)
Seat 2: 82af3a70 ($8.08 in chips)
Seat 3: a4b58f11 ($15.06 in chips)
Seat 4: 3e70c87e ($7.66 in chips)
Seat 5: Hero ($4.64 in chips)
Seat 6: e37bd647 ($1.65 in chips)
82af3a70: posts small blind $0.02
a4b58f11: posts big blind $0.05
*** HOLE CARDS ***
Dealt to 3bd13722 
Dealt to 82af3a70 
Dealt to a4b58f11 
Dealt to 3e70c87e 
Dealt to Hero [3c 4h]
Dealt to e37bd647 
3e70c87e: folds
Hero: folds
e37bd647: raises $0.1 to $0.15
3bd13722: raises $0.3 to $0.45
82af3a70: folds
a4b58f11: folds
e37bd647: calls $0.3
*** FLOP *** [Td As Tc]
e37bd647: checks
3bd13722: checks
*** TURN *** [Td As Tc] [6h]
e37bd647: checks
3bd13722: checks
*** RIVER *** [Td As Tc 6h] [7d]
e37bd647: bets $0.68
3bd13722: calls $0.68
e37bd647: shows [8h Kh] (a pair of Tens)
3bd13722: shows [Ah 3h] (two pair, Aces and Tens)
*** SHOWDOWN ***
3bd13722 collected $2.15 from pot
*** SUMMARY ***
Total pot $2.33 | Rake $0.11 | Jackpot $0.07 | Bingo $0 | Fortune $0 | Tax $0
Board [Td As Tc 6h 7d]
Seat 1: 3bd13722 (button) showed [Ah 3h] and won ($2.15) with two pair, Aces and Tens
Seat 2: 82af3a70 (small blind) folded before Flop
Seat 3: a4b58f11 (big blind) folded before Flop
Seat 4: 3e70c87e folded before Flop (didn't bet)
Seat 5: Hero folded before Flop (didn't bet)
Seat 6: e37bd647 showed [8h Kh] and lost with a pair of Tens


Poker Hand #RC3795926806: Hold'em No Limit ($0.02/$0.05) - 2025/08/10 08:08:01
Table 'RushAndCash11062066' 6-max Seat #1 is the button
Seat 1: e612f091 ($5 in chips)
Seat 2: c47898d9 ($5.69 in chips)
Seat 3: 69e805cf ($16.27 in chips)
Seat 4: 7a644870 ($5.14 in chips)
Seat 5: Hero ($4.64 in chips)
Seat 6: a4b58f11 ($15.06 in chips)
c47898d9: posts small blind $0.02
69e805cf: posts big blind $0.05
*** HOLE CARDS ***
Dealt to e612f091 
Dealt to c47898d9 
Dealt to 69e805cf 
Dealt to 7a644870 
Dealt to Hero [9c Ad]
Dealt to a4b58f11 
7a644870: raises $0.08 to $0.13
Hero: folds
a4b58f11: folds
e612f091: folds
c47898d9: folds
69e805cf: folds
Uncalled bet ($0.08) returned to 7a644870
*** SHOWDOWN ***
7a644870 collected $0.12 from pot
*** SUMMARY ***
Total pot $0.12 | Rake $0 | Jackpot $0 | Bingo $0 | Fortune $0 | Tax $0
Seat 1: e612f091 (button) folded before Flop (didn't bet)
Seat 2: c47898d9 (small blind) folded before Flop
Seat 3: 69e805cf (big blind) folded before Flop
Seat 4: 7a644870 collected ($0.12)
Seat 5: Hero folded before Flop (didn't bet)
Seat 6: a4b58f11 folded before Flop (didn't bet)


Poker Hand #RC3795926794: Hold'em No Limit ($0.02/$0.05) - 2025/08/10 08:07:57
Table 'RushAndCash11062054' 6-max Seat #1 is the button
Seat 1: 98a38c2c ($5 in chips)
Seat 2: e612f091 ($5 in chips)
Seat 3: 339cbf14 ($5 in chips)
Seat 4: Hero ($4.64 in chips)
Seat 5: 2bd5a8b ($5.55 in chips)
Seat 6: 69e805cf ($16.27 in chips)
e612f091: posts small blind $0.02
339cbf14: posts big blind $0.05
*** HOLE CARDS ***
Dealt to 98a38c2c 
Dealt to e612f091 
Dealt to 339cbf14 
Dealt to Hero [4d 5s]
Dealt to 2bd5a8b 
Dealt to 69e805cf 
Hero: folds
2bd5a8b: raises $0.05 to $0.1
69e805cf: folds
98a38c2c: folds
e612f091: folds
339cbf14: folds
Uncalled bet ($0.05) returned to 2bd5a8b
*** SHOWDOWN ***
2bd5a8b collected $0.12 from pot
*** SUMMARY ***
Total pot $0.12 | Rake $0 | Jackpot $0 | Bingo $0 | Fortune $0 | Tax $0
Seat 1: 98a38c2c (button) folded before Flop (didn't bet)
Seat 2: e612f091 (small blind) folded before Flop
Seat 3: 339cbf14 (big blind) folded before Flop
Seat 4: Hero folded before Flop (didn't bet)
Seat 5: 2bd5a8b collected ($0.12)
Seat 6: 69e805cf folded before Flop (didn't bet)


Poker Hand #RC3795926691: Hold'em No Limit ($0.02/$0.05) - 2025/08/10 08:07:25
Table 'RushAndCash11061951' 6-max Seat #1 is the button
Seat 1: e248cbd0 ($5.09 in chips)
Seat 2: 74f4cd20 ($9 in chips)
Seat 3: a6551a2a ($10.91 in chips)
Seat 4: fecbabe7 ($5.34 in chips)
Seat 5: b6de5713 ($10.77 in chips)
Seat 6: Hero ($4.74 in chips)
74f4cd20: posts small blind $0.02
a6551a2a: posts big blind $0.05
*** HOLE CARDS ***
Dealt to e248cbd0 
Dealt to 74f4cd20 
Dealt to a6551a2a 
Dealt to fecbabe7 
Dealt to b6de5713 
Dealt to Hero [9d Qd]
fecbabe7: folds
b6de5713: folds
Hero: raises $0.05 to $0.1
e248cbd0: raises $0.21 to $0.31
74f4cd20: folds
a6551a2a: raises $0.69 to $1
Hero: folds
e248cbd0: calls $0.69
*** FLOP *** [Ks Jc Ad]
a6551a2a: bets $0.7
e248cbd0: calls $0.7
*** TURN *** [Ks Jc Ad] [9h]
a6551a2a: checks
e248cbd0: checks
*** RIVER *** [Ks Jc Ad 9h] [3d]
a6551a2a: bets $3.52
e248cbd0: folds
Uncalled bet ($3.52) returned to a6551a2a
*** SHOWDOWN ***
a6551a2a collected $3.3 from pot
*** SUMMARY ***
Total pot $3.52 | Rake $0.15 | Jackpot $0.07 | Bingo $0 | Fortune $0 | Tax $0
Board [Ks Jc Ad 9h 3d]
Seat 1: e248cbd0 (button) folded on the River
Seat 2: 74f4cd20 (small blind) folded before Flop
Seat 3: a6551a2a (big blind) won ($3.3)
Seat 4: fecbabe7 folded before Flop (didn't bet)
Seat 5: b6de5713 folded before Flop (didn't bet)
Seat 6: Hero folded before Flop


Poker Hand #RC3795926626: Hold'em No Limit ($0.02/$0.05) - 2025/08/10 08:07:06
Table 'RushAndCash11061886' 6-max Seat #1 is the button
Seat 1: 808de8ec ($2.91 in chips)
Seat 2: 69e805cf ($16.37 in chips)
Seat 3: Hero ($4.79 in chips)
Seat 4: d1364679 ($7.56 in chips)
Seat 5: a64a8453 ($5.13 in chips)
Seat 6: a57b331d ($22.02 in chips)
69e805cf: posts small blind $0.02
Hero: posts big blind $0.05
*** HOLE CARDS ***
Dealt to 808de8ec 
Dealt to 69e805cf 
Dealt to Hero [As 7h]
Dealt to d1364679 
Dealt to a64a8453 
Dealt to a57b331d 
d1364679: raises $0.08 to $0.13
a64a8453: folds
a57b331d: folds
808de8ec: calls $0.13
69e805cf: folds
Hero: folds
*** FLOP *** [Jc Qd 2s]
d1364679: checks
808de8ec: checks
*** TURN *** [Jc Qd 2s] [Ad]
d1364679: checks
808de8ec: checks
*** RIVER *** [Jc Qd 2s Ad] [Qc]
d1364679: checks
808de8ec: checks
d1364679: shows [8d 7d] (a pair of Queens)
808de8ec: shows [Js 7s] (two pair, Queens and Jacks)
*** SHOWDOWN ***
808de8ec collected $0.32 from pot
*** SUMMARY ***
Total pot $0.33 | Rake $0.01 | Jackpot $0 | Bingo $0 | Fortune $0 | Tax $0
Board [Jc Qd 2s Ad Qc]
Seat 1: 808de8ec (button) showed [Js 7s] and won ($0.32) with two pair, Queens and Jacks
Seat 2: 69e805cf (small blind) folded before Flop
Seat 3: Hero (big blind) folded before Flop
Seat 4: d1364679 showed [8d 7d] and lost with a pair of Queens
Seat 5: a64a8453 folded before Flop (didn't bet)
Seat 6: a57b331d folded before Flop (didn't bet)


Poker Hand #RC3795926568: Hold'em No Limit ($0.02/$0.05) - 2025/08/10 08:06:49
Table 'RushAndCash11061828' 6-max Seat #1 is the button
Seat 1: 65914450 ($25.57 in chips)
Seat 2: Hero ($4.81 in chips)
Seat 3: 637628c5 ($7.6 in chips)
Seat 4: 56c36787 ($7.49 in chips)
Seat 5: 83bc5fa2 ($6.66 in chips)
Seat 6: dd92de38 ($5 in chips)
Hero: posts small blind $0.02
637628c5: posts big blind $0.05
*** HOLE CARDS ***
Dealt to 65914450 
Dealt to Hero [5h 3c]
Dealt to 637628c5 
Dealt to 56c36787 
Dealt to 83bc5fa2 
Dealt to dd92de38 
56c36787: folds
83bc5fa2: raises $0.05 to $0.1
dd92de38: folds
65914450: folds
Hero: folds
637628c5: folds
Uncalled bet ($0.05) returned to 83bc5fa2
*** SHOWDOWN ***
83bc5fa2 collected $0.12 from pot
*** SUMMARY ***
Total pot $0.12 | Rake $0 | Jackpot $0 | Bingo $0 | Fortune $0 | Tax $0
Seat 1: 65914450 (button) folded before Flop (didn't bet)
Seat 2: Hero (small blind) folded before Flop
Seat 3: 637628c5 (big blind) folded before Flop
Seat 4: 56c36787 folded before Flop (didn't bet)
Seat 5: 83bc5fa2 collected ($0.12)
Seat 6: dd92de38 folded before Flop (didn't bet)


Poker Hand #RC3795926532: Hold'em No Limit ($0.02/$0.05) - 2025/08/10 08:06:37
Table 'RushAndCash11061792' 6-max Seat #1 is the button
Seat 1: Hero ($4.81 in chips)
Seat 2: 7a7287fd ($6.21 in chips)
Seat 3: 732373fb ($5.26 in chips)
Seat 4: 9999c04f ($4.05 in chips)
Seat 5: 5ef3551b ($12.02 in chips)
Seat 6: 2465a84d ($17.18 in chips)
7a7287fd: posts small blind $0.02
732373fb: posts big blind $0.05
*** HOLE CARDS ***
Dealt to Hero [7s 6h]
Dealt to 7a7287fd 
Dealt to 732373fb 
Dealt to 9999c04f 
Dealt to 5ef3551b 
Dealt to 2465a84d 
9999c04f: folds
5ef3551b: folds
2465a84d: folds
Hero: folds
7a7287fd: folds
Uncalled bet ($0.03) returned to 732373fb
*** SHOWDOWN ***
732373fb collected $0.04 from pot
*** SUMMARY ***
Total pot $0.04 | Rake $0 | Jackpot $0 | Bingo $0 | Fortune $0 | Tax $0
Seat 1: Hero (button) folded before Flop (didn't bet)
Seat 2: 7a7287fd (small blind) folded before Flop
Seat 3: 732373fb (big blind) collected ($0.04)
Seat 4: 9999c04f folded before Flop (didn't bet)
Seat 5: 5ef3551b folded before Flop (didn't bet)
Seat 6: 2465a84d folded before Flop (didn't bet)


Poker Hand #RC3795926519: Hold'em No Limit ($0.02/$0.05) - 2025/08/10 08:06:34
Table 'RushAndCash11061779' 6-max Seat #1 is the button
Seat 1: 34f17b0d ($5 in chips)
Seat 2: 21c45711 ($5.13 in chips)
Seat 3: 779ef097 ($12.8 in chips)
Seat 4: 483f17c3 ($16.27 in chips)
Seat 5: Hero ($4.81 in chips)
Seat 6: a4b58f11 ($15.02 in chips)
21c45711: posts small blind $0.02
779ef097: posts big blind $0.05
*** HOLE CARDS ***
Dealt to 34f17b0d 
Dealt to 21c45711 
Dealt to 779ef097 
Dealt to 483f17c3 
Dealt to Hero [3h 4h]
Dealt to a4b58f11 
483f17c3: raises $0.08 to $0.13
Hero: folds
a4b58f11: folds
34f17b0d: folds
21c45711: calls $0.11
779ef097: folds
*** FLOP *** [2c 7c Js]
21c45711: checks
483f17c3: checks
*** TURN *** [2c 7c Js] [5d]
21c45711: checks
483f17c3: checks
*** RIVER *** [2c 7c Js 5d] [2s]
21c45711: checks
483f17c3: checks
21c45711: shows [Td As] (a pair of Twos)
483f17c3: shows [Tc Th] (two pair, Tens and Twos)
*** SHOWDOWN ***
483f17c3 collected $0.3 from pot
*** SUMMARY ***
Total pot $0.31 | Rake $0.01 | Jackpot $0 | Bingo $0 | Fortune $0 | Tax $0
Board [2c 7c Js 5d 2s]
Seat 1: 34f17b0d (button) folded before Flop (didn't bet)
Seat 2: 21c45711 (small blind) showed [Td As] and lost with a pair of Twos
Seat 3: 779ef097 (big blind) folded before Flop
Seat 4: 483f17c3 showed [Tc Th] and won ($0.3) with two pair, Tens and Twos
Seat 5: Hero folded before Flop (didn't bet)
Seat 6: a4b58f11 folded before Flop (didn't bet)


Poker Hand #RC3795926505: Hold'em No Limit ($0.02/$0.05) - 2025/08/10 08:06:30
Table 'RushAndCash11061765' 6-max Seat #1 is the button
Seat 1: 5f0e6d7 ($2.26 in chips)
Seat 2: 949b5efc ($5 in chips)
Seat 3: 3f43d5e9 ($4.88 in chips)
Seat 4: Hero ($4.81 in chips)
Seat 5: 196a508f ($13.93 in chips)
Seat 6: 42c5560c ($5.63 in chips)
949b5efc: posts small blind $0.02
3f43d5e9: posts big blind $0.05
*** HOLE CARDS ***
Dealt to 5f0e6d7 
Dealt to 949b5efc 
Dealt to 3f43d5e9 
Dealt to Hero [Th Js]
Dealt to 196a508f 
Dealt to 42c5560c 
Hero: folds
196a508f: folds
42c5560c: folds
5f0e6d7: folds
949b5efc: folds
Uncalled bet ($0.03) returned to 3f43d5e9
*** SHOWDOWN ***
3f43d5e9 collected $0.04 from pot
*** SUMMARY ***
Total pot $0.04 | Rake $0 | Jackpot $0 | Bingo $0 | Fortune $0 | Tax $0
Seat 1: 5f0e6d7 (button) folded before Flop (didn't bet)
Seat 2: 949b5efc (small blind) folded before Flop
Seat 3: 3f43d5e9 (big blind) collected ($0.04)
Seat 4: Hero folded before Flop (didn't bet)
Seat 5: 196a508f folded before Flop (didn't bet)
Seat 6: 42c5560c folded before Flop (didn't bet)


Poker Hand #RC3795926448: Hold'em No Limit ($0.02/$0.05) - 2025/08/10 08:06:15
Table 'RushAndCash11061708' 6-max Seat #1 is the button
Seat 1: Hero ($4.74 in chips)
Seat 2: 2c28207b ($4.84 in chips)
Seat 3: 5c5d4a8d ($11.44 in chips)
Seat 4: db22ee6f ($5.95 in chips)
Seat 5: 8d71181d ($5.11 in chips)
Seat 6: 3f382755 ($5.06 in chips)
2c28207b: posts small blind $0.02
5c5d4a8d: posts big blind $0.05
*** HOLE CARDS ***
Dealt to Hero [9h 9c]
Dealt to 2c28207b 
Dealt to 5c5d4a8d 
Dealt to db22ee6f 
Dealt to 8d71181d 
Dealt to 3f382755 
db22ee6f: folds
8d71181d: folds
3f382755: folds
Hero: raises $0.1 to $0.15
2c28207b: folds
5c5d4a8d: folds
Uncalled bet ($0.1) returned to Hero
*** SHOWDOWN ***
Hero collected $0.12 from pot
*** SUMMARY ***
Total pot $0.12 | Rake $0 | Jackpot $0 | Bingo $0 | Fortune $0 | Tax $0
Seat 1: Hero (button) collected ($0.12)
Seat 2: 2c28207b (small blind) folded before Flop
Seat 3: 5c5d4a8d (big blind) folded before Flop
Seat 4: db22ee6f folded before Flop (didn't bet)
Seat 5: 8d71181d folded before Flop (didn't bet)
Seat 6: 3f382755 folded before Flop (didn't bet)


Poker Hand #RC3795926390: Hold'em No Limit ($0.02/$0.05) - 2025/08/10 08:06:00
Table 'RushAndCash11061650' 6-max Seat #1 is the button
Seat 1: d5bb3acb ($4.26 in chips)
Seat 2: Hero ($4.76 in chips)
Seat 3: 5b54e251 ($11.57 in chips)
Seat 4: b5d00661 ($4.68 in chips)
Seat 5: 29f4658d ($17.18 in chips)
Seat 6: 3bd13722 ($7.58 in chips)
Hero: posts small blind $0.02
5b54e251: posts big blind $0.05
*** HOLE CARDS ***
Dealt to d5bb3acb 
Dealt to Hero [Td Qc]
Dealt to 5b54e251 
Dealt to b5d00661 
Dealt to 29f4658d 
Dealt to 3bd13722 
b5d00661: folds
29f4658d: folds
3bd13722: folds
d5bb3acb: raises $0.13 to $0.18
Hero: folds
5b54e251: folds
Uncalled bet ($0.13) returned to d5bb3acb
*** SHOWDOWN ***
d5bb3acb collected $0.12 from pot
*** SUMMARY ***
Total pot $0.12 | Rake $0 | Jackpot $0 | Bingo $0 | Fortune $0 | Tax $0
Seat 1: d5bb3acb (button) collected ($0.12)
Seat 2: Hero (small blind) folded before Flop
Seat 3: 5b54e251 (big blind) folded before Flop
Seat 4: b5d00661 folded before Flop (didn't bet)
Seat 5: 29f4658d folded before Flop (didn't bet)
Seat 6: 3bd13722 folded before Flop (didn't bet)


Poker Hand #RC3795926327: Hold'em No Limit ($0.02/$0.05) - 2025/08/10 08:05:44
Table 'RushAndCash11061587' 6-max Seat #1 is the button
Seat 1: 5b54e251 ($11.57 in chips)
Seat 2: d6378e6 ($5.66 in chips)
Seat 3: Hero ($4.81 in chips)
Seat 4: bbe9b1b1 ($5 in chips)
Seat 5: 78871292 ($5.71 in chips)
Seat 6: 42c31e1a ($8.13 in chips)
d6378e6: posts small blind $0.02
Hero: posts big blind $0.05
*** HOLE CARDS ***
Dealt to 5b54e251 
Dealt to d6378e6 
Dealt to Hero [9s Ah]
Dealt to bbe9b1b1 
Dealt to 78871292 
Dealt to 42c31e1a 
bbe9b1b1: raises $0.07 to $0.12
78871292: raises $0.36 to $0.48
42c31e1a: raises $0.74 to $1.22
5b54e251: folds
d6378e6: folds
Hero: folds
bbe9b1b1: folds
78871292: calls $0.74
*** FLOP *** [8s 4h 3h]
78871292: checks
42c31e1a: bets $0.87
78871292: calls $0.87
*** TURN *** [8s 4h 3h] [3s]
78871292: checks
42c31e1a: bets $1.45
78871292: raises $2.17 to $3.62 and is all-in
42c31e1a: calls $2.17
78871292: shows [Jc Jd] (two pair, Jacks and Threes)
42c31e1a: shows [Kh Kc] (two pair, Kings and Threes)
*** RIVER *** [8s 4h 3h 3s] [Th]
*** SHOWDOWN ***
42c31e1a collected $11.39 from pot
*** SUMMARY ***
Total pot $11.61 | Rake $0.15 | Jackpot $0.07 | Bingo $0 | Fortune $0 | Tax $0
Board [8s 4h 3h 3s Th]
Seat 1: 5b54e251 (button) folded before Flop (didn't bet)
Seat 2: d6378e6 (small blind) folded before Flop
Seat 3: Hero (big blind) folded before Flop
Seat 4: bbe9b1b1 folded before Flop
Seat 5: 78871292 showed [Jc Jd] and lost with two pair, Jacks and Threes
Seat 6: 42c31e1a showed [Kh Kc] and won ($11.39) with two pair, Kings and Threes


Poker Hand #RC3795926313: Hold'em No Limit ($0.02/$0.05) - 2025/08/10 08:05:40
Table 'RushAndCash11061573' 6-max Seat #1 is the button
Seat 1: 65376f32 ($4.06 in chips)
Seat 2: db3d7016 ($5.58 in chips)
Seat 3: 29f4658d ($17.16 in chips)
Seat 4: f2e3feac ($7.5 in chips)
Seat 5: Hero ($4.81 in chips)
Seat 6: 9999c04f ($5.36 in chips)
db3d7016: posts small blind $0.02
29f4658d: posts big blind $0.05
*** HOLE CARDS ***
Dealt to 65376f32 
Dealt to db3d7016 
Dealt to 29f4658d 
Dealt to f2e3feac 
Dealt to Hero [7h Th]
Dealt to 9999c04f 
f2e3feac: folds
Hero: folds
9999c04f: folds
65376f32: folds
db3d7016: folds
Uncalled bet ($0.03) returned to 29f4658d
*** SHOWDOWN ***
29f4658d collected $0.04 from pot
*** SUMMARY ***
Total pot $0.04 | Rake $0 | Jackpot $0 | Bingo $0 | Fortune $0 | Tax $0
Seat 1: 65376f32 (button) folded before Flop (didn't bet)
Seat 2: db3d7016 (small blind) folded before Flop
Seat 3: 29f4658d (big blind) collected ($0.04)
Seat 4: f2e3feac folded before Flop (didn't bet)
Seat 5: Hero folded before Flop (didn't bet)
Seat 6: 9999c04f folded before Flop (didn't bet)


Poker Hand #RC3795926301: Hold'em No Limit ($0.02/$0.05) - 2025/08/10 08:05:36
Table 'RushAndCash11061561' 6-max Seat #1 is the button
Seat 1: 679f38b2 ($6.42 in chips)
Seat 2: 74f4cd20 ($8.74 in chips)
Seat 3: f6ecbdd ($7.28 in chips)
Seat 4: 5c5d4a8d ($11.64 in chips)
Seat 5: Hero ($4.81 in chips)
Seat 6: 69e805cf ($16.44 in chips)
74f4cd20: posts small blind $0.02
f6ecbdd: posts big blind $0.05
*** HOLE CARDS ***
Dealt to 679f38b2 
Dealt to 74f4cd20 
Dealt to f6ecbdd 
Dealt to 5c5d4a8d 
Dealt to Hero [Ah 8c]
Dealt to 69e805cf 
5c5d4a8d: folds
Hero: folds
69e805cf: raises $0.07 to $0.12
679f38b2: folds
74f4cd20: folds
f6ecbdd: folds
Uncalled bet ($0.07) returned to 69e805cf
*** SHOWDOWN ***
69e805cf collected $0.12 from pot
*** SUMMARY ***
Total pot $0.12 | Rake $0 | Jackpot $0 | Bingo $0 | Fortune $0 | Tax $0
Seat 1: 679f38b2 (button) folded before Flop (didn't bet)
Seat 2: 74f4cd20 (small blind) folded before Flop
Seat 3: f6ecbdd (big blind) folded before Flop
Seat 4: 5c5d4a8d folded before Flop (didn't bet)
Seat 5: Hero folded before Flop (didn't bet)
Seat 6: 69e805cf collected ($0.12)


Poker Hand #RC3795926289: Hold'em No Limit ($0.02/$0.05) - 2025/08/10 08:05:32
Table 'RushAndCash11061549' 6-max Seat #1 is the button
Seat 1: 64f50505 ($9.26 in chips)
Seat 2: 42c31e1a ($8.15 in chips)
Seat 3: 5ef3551b ($13.13 in chips)
Seat 4: Hero ($4.81 in chips)
Seat 5: e38ce9f1 ($18.27 in chips)
Seat 6: 18ca1e6b ($7 in chips)
42c31e1a: posts small blind $0.02
5ef3551b: posts big blind $0.05
*** HOLE CARDS ***
Dealt to 64f50505 
Dealt to 42c31e1a 
Dealt to 5ef3551b 
Dealt to Hero [2s 6d]
Dealt to e38ce9f1 
Dealt to 18ca1e6b 
Hero: folds
e38ce9f1: folds
18ca1e6b: folds
64f50505: raises $0.1 to $0.15
42c31e1a: folds
5ef3551b: raises $0.4 to $0.55
64f50505: calls $0.4
*** FLOP *** [9s 7d 2d]
5ef3551b: checks
64f50505: checks
*** TURN *** [9s 7d 2d] [7c]
5ef3551b: bets $0.56
64f50505: raises $0.74 to $1.3
5ef3551b: folds
Uncalled bet ($0.74) returned to 64f50505
*** SHOWDOWN ***
64f50505 collected $2.07 from pot
*** SUMMARY ***
Total pot $2.24 | Rake $0.1 | Jackpot $0.07 | Bingo $0 | Fortune $0 | Tax $0
Board [9s 7d 2d 7c]
Seat 1: 64f50505 (button) won ($2.07)
Seat 2: 42c31e1a (small blind) folded before Flop
Seat 3: 5ef3551b (big blind) folded on the Turn
Seat 4: Hero folded before Flop (didn't bet)
Seat 5: e38ce9f1 folded before Flop (didn't bet)
Seat 6: 18ca1e6b folded before Flop (didn't bet)


Poker Hand #RC3795926138: Hold'em No Limit ($0.02/$0.05) - 2025/08/10 08:04:49
Table 'RushAndCash11061398' 6-max Seat #1 is the button
Seat 1: e38ce9f1 ($18.13 in chips)
Seat 2: 74f4cd20 ($8.81 in chips)
Seat 3: Hero ($4.94 in chips)
Seat 4: 3e70c87e ($9.76 in chips)
Seat 5: 4cd607b4 ($8.7 in chips)
Seat 6: 7f40418 ($5.72 in chips)
74f4cd20: posts small blind $0.02
Hero: posts big blind $0.05
*** HOLE CARDS ***
Dealt to e38ce9f1 
Dealt to 74f4cd20 
Dealt to Hero [6h 8c]
Dealt to 3e70c87e 
Dealt to 4cd607b4 
Dealt to 7f40418 
3e70c87e: folds
4cd607b4: folds
7f40418: folds
e38ce9f1: raises $0.08 to $0.13
74f4cd20: folds
Hero: calls $0.08
*** FLOP *** [2h Ah 9c]
Hero: checks
e38ce9f1: bets $0.14
Hero: folds
Uncalled bet ($0.14) returned to e38ce9f1
*** SHOWDOWN ***
e38ce9f1 collected $0.27 from pot
*** SUMMARY ***
Total pot $0.28 | Rake $0.01 | Jackpot $0 | Bingo $0 | Fortune $0 | Tax $0
Board [2h Ah 9c]
Seat 1: e38ce9f1 (button) won ($0.27)
Seat 2: 74f4cd20 (small blind) folded before Flop
Seat 3: Hero (big blind) folded on the Flop
Seat 4: 3e70c87e folded before Flop (didn't bet)
Seat 5: 4cd607b4 folded before Flop (didn't bet)
Seat 6: 7f40418 folded before Flop (didn't bet)


Poker Hand #RC3795926122: Hold'em No Limit ($0.02/$0.05) - 2025/08/10 08:04:45
Table 'RushAndCash11061382' 6-max Seat #1 is the button
Seat 1: e8380f03 ($5.49 in chips)
Seat 2: 14893e07 ($5 in chips)
Seat 3: b83c710b ($5 in chips)
Seat 4: Hero ($4.94 in chips)
Seat 5: 2bd5a8b ($5.19 in chips)
Seat 6: 4cd607b4 ($8.7 in chips)
14893e07: posts small blind $0.02
b83c710b: posts big blind $0.05
*** HOLE CARDS ***
Dealt to e8380f03 
Dealt to 14893e07 
Dealt to b83c710b 
Dealt to Hero [3s Kc]
Dealt to 2bd5a8b 
Dealt to 4cd607b4 
Hero: folds
2bd5a8b: folds
4cd607b4: folds
e8380f03: folds
14893e07: raises $0.05 to $0.1
b83c710b: folds
Uncalled bet ($0.05) returned to 14893e07
*** SHOWDOWN ***
14893e07 collected $0.1 from pot
*** SUMMARY ***
Total pot $0.1 | Rake $0 | Jackpot $0 | Bingo $0 | Fortune $0 | Tax $0
Seat 1: e8380f03 (button) folded before Flop (didn't bet)
Seat 2: 14893e07 (small blind) collected ($0.1)
Seat 3: b83c710b (big blind) folded before Flop
Seat 4: Hero folded before Flop (didn't bet)
Seat 5: 2bd5a8b folded before Flop (didn't bet)
Seat 6: 4cd607b4 folded before Flop (didn't bet)


Poker Hand #RC3795926078: Hold'em No Limit ($0.02/$0.05) - 2025/08/10 08:04:35
Table 'RushAndCash11061338' 6-max Seat #1 is the button
Seat 1: 82af3a70 ($8.62 in chips)
Seat 2: Hero ($4.96 in chips)
Seat 3: e8380f03 ($5.54 in chips)
Seat 4: 4328ce0 ($4.38 in chips)
Seat 5: 5ef3551b ($13.15 in chips)
Seat 6: e7e9348c ($15.15 in chips)
Hero: posts small blind $0.02
e8380f03: posts big blind $0.05
*** HOLE CARDS ***
Dealt to 82af3a70 
Dealt to Hero [9c Qh]
Dealt to e8380f03 
Dealt to 4328ce0 
Dealt to 5ef3551b 
Dealt to e7e9348c 
4328ce0: raises $0.05 to $0.1
5ef3551b: folds
e7e9348c: folds
82af3a70: raises $0.05 to $0.15
Hero: folds
e8380f03: folds
4328ce0: raises $0.45 to $0.6
82af3a70: folds
Uncalled bet ($0.45) returned to 4328ce0
*** SHOWDOWN ***
4328ce0 collected $0.36 from pot
*** SUMMARY ***
Total pot $0.37 | Rake $0.01 | Jackpot $0 | Bingo $0 | Fortune $0 | Tax $0
Seat 1: 82af3a70 (button) folded before Flop
Seat 2: Hero (small blind) folded before Flop
Seat 3: e8380f03 (big blind) folded before Flop
Seat 4: 4328ce0 collected ($0.36)
Seat 5: 5ef3551b folded before Flop (didn't bet)
Seat 6: e7e9348c folded before Flop (didn't bet)


Poker Hand #RC3795926064: Hold'em No Limit ($0.02/$0.05) - 2025/08/10 08:04:32
Table 'RushAndCash11061324' 6-max Seat #1 is the button
Seat 1: Hero ($4.96 in chips)
Seat 2: b6de5713 ($11.11 in chips)
Seat 3: 4b731a27 ($6.05 in chips)
Seat 4: 7f40418 ($5.79 in chips)
Seat 5: 3533113a ($10.9 in chips)
Seat 6: 29f4658d ($16.77 in chips)
b6de5713: posts small blind $0.02
4b731a27: posts big blind $0.05
*** HOLE CARDS ***
Dealt to Hero [8s 4h]
Dealt to b6de5713 
Dealt to 4b731a27 
Dealt to 7f40418 
Dealt to 3533113a 
Dealt to 29f4658d 
7f40418: folds
3533113a: folds
29f4658d: raises $0.08 to $0.13
Hero: folds
b6de5713: raises $0.32 to $0.45
4b731a27: folds
29f4658d: raises $0.62 to $1.07
b6de5713: folds
Uncalled bet ($0.62) returned to 29f4658d
*** SHOWDOWN ***
29f4658d collected $0.91 from pot
*** SUMMARY ***
Total pot $0.95 | Rake $0.04 | Jackpot $0 | Bingo $0 | Fortune $0 | Tax $0
Seat 1: Hero (button) folded before Flop (didn't bet)
Seat 2: b6de5713 (small blind) folded before Flop
Seat 3: 4b731a27 (big blind) folded before Flop
Seat 4: 7f40418 folded before Flop (didn't bet)
Seat 5: 3533113a folded before Flop (didn't bet)
Seat 6: 29f4658d collected ($0.91)


Poker Hand #RC3795926052: Hold'em No Limit ($0.02/$0.05) - 2025/08/10 08:04:28
Table 'RushAndCash11061312' 6-max Seat #1 is the button
Seat 1: 74f4cd20 ($8.86 in chips)
Seat 2: 605e49e4 ($5.22 in chips)
Seat 3: f6c47f47 ($5.41 in chips)
Seat 4: Hero ($4.96 in chips)
Seat 5: ca112d1 ($9.22 in chips)
Seat 6: da84e89d ($8.4 in chips)
605e49e4: posts small blind $0.02
f6c47f47: posts big blind $0.05
*** HOLE CARDS ***
Dealt to 74f4cd20 
Dealt to 605e49e4 
Dealt to f6c47f47 
Dealt to Hero [8h 2d]
Dealt to ca112d1 
Dealt to da84e89d 
Hero: folds
ca112d1: raises $0.05 to $0.1
da84e89d: folds
74f4cd20: folds
605e49e4: raises $0.25 to $0.35
f6c47f47: folds
ca112d1: folds
Uncalled bet ($0.25) returned to 605e49e4
*** SHOWDOWN ***
605e49e4 collected $0.24 from pot
*** SUMMARY ***
Total pot $0.25 | Rake $0.01 | Jackpot $0 | Bingo $0 | Fortune $0 | Tax $0
Seat 1: 74f4cd20 (button) folded before Flop (didn't bet)
Seat 2: 605e49e4 (small blind) collected ($0.24)
Seat 3: f6c47f47 (big blind) folded before Flop
Seat 4: Hero folded before Flop (didn't bet)
Seat 5: ca112d1 folded before Flop
Seat 6: da84e89d folded before Flop (didn't bet)


Poker Hand #RC3795926037: Hold'em No Limit ($0.02/$0.05) - 2025/08/10 08:04:24
Table 'RushAndCash11061297' 6-max Seat #1 is the button
Seat 1: f6c47f47 ($5.41 in chips)
Seat 2: 82af3a70 ($8.57 in chips)
Seat 3: 9999c04f ($5.9 in chips)
Seat 4: Hero ($4.96 in chips)
Seat 5: 79ab917c ($5.07 in chips)
Seat 6: 7869fb4b ($5.09 in chips)
82af3a70: posts small blind $0.02
9999c04f: posts big blind $0.05
*** HOLE CARDS ***
Dealt to f6c47f47 
Dealt to 82af3a70 
Dealt to 9999c04f 
Dealt to Hero [Jd 5h]
Dealt to 79ab917c 
Dealt to 7869fb4b 
Hero: folds
79ab917c: folds
7869fb4b: folds
f6c47f47: folds
82af3a70: raises $0.05 to $0.1
9999c04f: folds
Uncalled bet ($0.05) returned to 82af3a70
*** SHOWDOWN ***
82af3a70 collected $0.1 from pot
*** SUMMARY ***
Total pot $0.1 | Rake $0 | Jackpot $0 | Bingo $0 | Fortune $0 | Tax $0
Seat 1: f6c47f47 (button) folded before Flop (didn't bet)
Seat 2: 82af3a70 (small blind) collected ($0.1)
Seat 3: 9999c04f (big blind) folded before Flop
Seat 4: Hero folded before Flop (didn't bet)
Seat 5: 79ab917c folded before Flop (didn't bet)
Seat 6: 7869fb4b folded before Flop (didn't bet)


Poker Hand #RC3795926009: Hold'em No Limit ($0.02/$0.05) - 2025/08/10 08:04:18
Table 'RushAndCash11061269' 6-max Seat #1 is the button
Seat 1: c68d0db6 ($5.14 in chips)
Seat 2: a57b331d ($21.84 in chips)
Seat 3: 2a76f9f5 ($6.55 in chips)
Seat 4: 41ed372d ($5.36 in chips)
Seat 5: 45a89215 ($5 in chips)
Seat 6: Hero ($4.96 in chips)
a57b331d: posts small blind $0.02
2a76f9f5: posts big blind $0.05
*** HOLE CARDS ***
Dealt to c68d0db6 
Dealt to a57b331d 
Dealt to 2a76f9f5 
Dealt to 41ed372d 
Dealt to 45a89215 
Dealt to Hero [4c 7s]
41ed372d: folds
45a89215: folds
Hero: folds
c68d0db6: raises $0.07 to $0.12
a57b331d: folds
2a76f9f5: folds
Uncalled bet ($0.07) returned to c68d0db6
*** SHOWDOWN ***
c68d0db6 collected $0.12 from pot
*** SUMMARY ***
Total pot $0.12 | Rake $0 | Jackpot $0 | Bingo $0 | Fortune $0 | Tax $0
Seat 1: c68d0db6 (button) collected ($0.12)
Seat 2: a57b331d (small blind) folded before Flop
Seat 3: 2a76f9f5 (big blind) folded before Flop
Seat 4: 41ed372d folded before Flop (didn't bet)
Seat 5: 45a89215 folded before Flop (didn't bet)
Seat 6: Hero folded before Flop (didn't bet)


Poker Hand #RC3795925978: Hold'em No Limit ($0.02/$0.05) - 2025/08/10 08:04:10
Table 'RushAndCash11061238' 6-max Seat #1 is the button
Seat 1: b2532ba1 ($7.11 in chips)
Seat 2: Hero ($4.98 in chips)
Seat 3: c47898d9 ($5.92 in chips)
Seat 4: 256f1bf0 ($4.95 in chips)
Seat 5: 95a8436b ($10.17 in chips)
Seat 6: 3817bfda ($9.88 in chips)
Hero: posts small blind $0.02
c47898d9: posts big blind $0.05
*** HOLE CARDS ***
Dealt to b2532ba1 
Dealt to Hero [5d 3s]
Dealt to c47898d9 
Dealt to 256f1bf0 
Dealt to 95a8436b 
Dealt to 3817bfda 
256f1bf0: folds
95a8436b: folds
3817bfda: folds
b2532ba1: raises $0.07 to $0.12
Hero: folds
c47898d9: folds
Uncalled bet ($0.07) returned to b2532ba1
*** SHOWDOWN ***
b2532ba1 collected $0.12 from pot
*** SUMMARY ***
Total pot $0.12 | Rake $0 | Jackpot $0 | Bingo $0 | Fortune $0 | Tax $0
Seat 1: b2532ba1 (button) collected ($0.12)
Seat 2: Hero (small blind) folded before Flop
Seat 3: c47898d9 (big blind) folded before Flop
Seat 4: 256f1bf0 folded before Flop (didn't bet)
Seat 5: 95a8436b folded before Flop (didn't bet)
Seat 6: 3817bfda folded before Flop (didn't bet)


Poker Hand #RC3795925962: Hold'em No Limit ($0.02/$0.05) - 2025/08/10 08:04:05
Table 'RushAndCash11061222' 6-max Seat #1 is the button
Seat 1: 5ab0b835 ($6.66 in chips)
Seat 2: 5525973a ($10.42 in chips)
Seat 3: Hero ($5.03 in chips)
Seat 4: 146e862a ($2.72 in chips)
Seat 5: e400ddd3 ($5.12 in chips)
Seat 6: fc1e46cd ($6.13 in chips)
5525973a: posts small blind $0.02
Hero: posts big blind $0.05
*** HOLE CARDS ***
Dealt to 5ab0b835 
Dealt to 5525973a 
Dealt to Hero [4h 9d]
Dealt to 146e862a 
Dealt to e400ddd3 
Dealt to fc1e46cd 
146e862a: folds
e400ddd3: folds
fc1e46cd: raises $0.05 to $0.1
5ab0b835: folds
5525973a: folds
Hero: folds
Uncalled bet ($0.05) returned to fc1e46cd
*** SHOWDOWN ***
fc1e46cd collected $0.12 from pot
*** SUMMARY ***
Total pot $0.12 | Rake $0 | Jackpot $0 | Bingo $0 | Fortune $0 | Tax $0
Seat 1: 5ab0b835 (button) folded before Flop (didn't bet)
Seat 2: 5525973a (small blind) folded before Flop
Seat 3: Hero (big blind) folded before Flop
Seat 4: 146e862a folded before Flop (didn't bet)
Seat 5: e400ddd3 folded before Flop (didn't bet)
Seat 6: fc1e46cd collected ($0.12)


Poker Hand #RC3795925949: Hold'em No Limit ($0.02/$0.05) - 2025/08/10 08:04:02
Table 'RushAndCash11061209' 6-max Seat #1 is the button
Seat 1: Hero ($5.03 in chips)
Seat 2: 210c8e9b ($13.06 in chips)
Seat 3: b6de5713 ($11.11 in chips)
Seat 4: e400ddd3 ($5.12 in chips)
Seat 5: 83e19d4d ($6.02 in chips)
Seat 6: 779ef097 ($13.25 in chips)
210c8e9b: posts small blind $0.02
b6de5713: posts big blind $0.05
*** HOLE CARDS ***
Dealt to Hero [5h 2d]
Dealt to 210c8e9b 
Dealt to b6de5713 
Dealt to e400ddd3 
Dealt to 83e19d4d 
Dealt to 779ef097 
e400ddd3: folds
83e19d4d: folds
779ef097: folds
Hero: folds
210c8e9b: folds
Uncalled bet ($0.03) returned to b6de5713
*** SHOWDOWN ***
b6de5713 collected $0.04 from pot
*** SUMMARY ***
Total pot $0.04 | Rake $0 | Jackpot $0 | Bingo $0 | Fortune $0 | Tax $0
Seat 1: Hero (button) folded before Flop (didn't bet)
Seat 2: 210c8e9b (small blind) folded before Flop
Seat 3: b6de5713 (big blind) collected ($0.04)
Seat 4: e400ddd3 folded before Flop (didn't bet)
Seat 5: 83e19d4d folded before Flop (didn't bet)
Seat 6: 779ef097 folded before Flop (didn't bet)


Poker Hand #RC3795925935: Hold'em No Limit ($0.02/$0.05) - 2025/08/10 08:03:58
Table 'RushAndCash11061195' 6-max Seat #1 is the button
Seat 1: 7e6ca83c ($12.37 in chips)
Seat 2: fc1e46cd ($6.15 in chips)
Seat 3: 5525973a ($10.47 in chips)
Seat 4: 6e85c1d6 ($7.32 in chips)
Seat 5: Hero ($5.03 in chips)
Seat 6: 70573b8 ($5.11 in chips)
fc1e46cd: posts small blind $0.02
5525973a: posts big blind $0.05
*** HOLE CARDS ***
Dealt to 7e6ca83c 
Dealt to fc1e46cd 
Dealt to 5525973a 
Dealt to 6e85c1d6 
Dealt to Hero [8d Kc]
Dealt to 70573b8 
6e85c1d6: folds
Hero: folds
70573b8: folds
7e6ca83c: raises $0.08 to $0.13
fc1e46cd: folds
5525973a: folds
Uncalled bet ($0.08) returned to 7e6ca83c
*** SHOWDOWN ***
7e6ca83c collected $0.12 from pot
*** SUMMARY ***
Total pot $0.12 | Rake $0 | Jackpot $0 | Bingo $0 | Fortune $0 | Tax $0
Seat 1: 7e6ca83c (button) collected ($0.12)
Seat 2: fc1e46cd (small blind) folded before Flop
Seat 3: 5525973a (big blind) folded before Flop
Seat 4: 6e85c1d6 folded before Flop (didn't bet)
Seat 5: Hero folded before Flop (didn't bet)
Seat 6: 70573b8 folded before Flop (didn't bet)


Poker Hand #RC3795925920: Hold'em No Limit ($0.02/$0.05) - 2025/08/10 08:03:54
Table 'RushAndCash11061180' 6-max Seat #1 is the button
Seat 1: 9aa76ee3 ($5 in chips)
Seat 2: 6a823878 ($7.92 in chips)
Seat 3: 5b54e251 ($11.71 in chips)
Seat 4: 74f4cd20 ($8.75 in chips)
Seat 5: 6e85c1d6 ($7.32 in chips)
Seat 6: Hero ($5.03 in chips)
6a823878: posts small blind $0.02
5b54e251: posts big blind $0.05
*** HOLE CARDS ***
Dealt to 9aa76ee3 
Dealt to 6a823878 
Dealt to 5b54e251 
Dealt to 74f4cd20 
Dealt to 6e85c1d6 
Dealt to Hero [Jh 9d]
74f4cd20: raises $0.05 to $0.1
6e85c1d6: folds
Hero: folds
9aa76ee3: folds
6a823878: folds
5b54e251: calls $0.05
*** FLOP *** [2s Qh 3c]
5b54e251: checks
74f4cd20: bets $0.08
5b54e251: folds
Uncalled bet ($0.08) returned to 74f4cd20
*** SHOWDOWN ***
74f4cd20 collected $0.21 from pot
*** SUMMARY ***
Total pot $0.22 | Rake $0.01 | Jackpot $0 | Bingo $0 | Fortune $0 | Tax $0
Board [2s Qh 3c]
Seat 1: 9aa76ee3 (button) folded before Flop (didn't bet)
Seat 2: 6a823878 (small blind) folded before Flop
Seat 3: 5b54e251 (big blind) folded on the Flop
Seat 4: 74f4cd20 won ($0.21)
Seat 5: 6e85c1d6 folded before Flop (didn't bet)
Seat 6: Hero folded before Flop (didn't bet)


Poker Hand #RC3795925888: Hold'em No Limit ($0.02/$0.05) - 2025/08/10 08:03:45
Table 'RushAndCash11061148' 6-max Seat #1 is the button
Seat 1: Hero ($5.03 in chips)
Seat 2: db3d7016 ($5 in chips)
Seat 3: a0ebcff ($6.22 in chips)
Seat 4: a63176ef ($7.68 in chips)
Seat 5: 9fd1d64c ($5 in chips)
Seat 6: 8d1c252c ($5 in chips)
db3d7016: posts small blind $0.02
a0ebcff: posts big blind $0.05
*** HOLE CARDS ***
Dealt to Hero [Qh 8h]
Dealt to db3d7016 
Dealt to a0ebcff 
Dealt to a63176ef 
Dealt to 9fd1d64c 
Dealt to 8d1c252c 
a63176ef: folds
9fd1d64c: folds
8d1c252c: raises $0.08 to $0.13
Hero: folds
db3d7016: folds
a0ebcff: calls $0.08
*** FLOP *** [As 9c Qs]
a0ebcff: checks
8d1c252c: checks
*** TURN *** [As 9c Qs] [Th]
a0ebcff: checks
8d1c252c: bets $0.14
a0ebcff: folds
Uncalled bet ($0.14) returned to 8d1c252c
*** SHOWDOWN ***
8d1c252c collected $0.27 from pot
*** SUMMARY ***
Total pot $0.28 | Rake $0.01 | Jackpot $0 | Bingo $0 | Fortune $0 | Tax $0
Board [As 9c Qs Th]
Seat 1: Hero (button) folded before Flop (didn't bet)
Seat 2: db3d7016 (small blind) folded before Flop
Seat 3: a0ebcff (big blind) folded on the Turn
Seat 4: a63176ef folded before Flop (didn't bet)
Seat 5: 9fd1d64c folded before Flop (didn't bet)
Seat 6: 8d1c252c won ($0.27)


Poker Hand #RC3795925826: Hold'em No Limit ($0.02/$0.05) - 2025/08/10 08:03:27
Table 'RushAndCash11061086' 6-max Seat #1 is the button
Seat 1: c3155cc0 ($5.09 in chips)
Seat 2: Hero ($5.05 in chips)
Seat 3: e248cbd0 ($5.04 in chips)
Seat 4: 1eef3559 ($10.31 in chips)
Seat 5: a187372 ($5 in chips)
Seat 6: e7e9348c ($15.04 in chips)
Hero: posts small blind $0.02
e248cbd0: posts big blind $0.05
*** HOLE CARDS ***
Dealt to c3155cc0 
Dealt to Hero [9d 7h]
Dealt to e248cbd0 
Dealt to 1eef3559 
Dealt to a187372 
Dealt to e7e9348c 
1eef3559: folds
a187372: raises $0.06 to $0.11
e7e9348c: folds
c3155cc0: folds
Hero: folds
e248cbd0: folds
Uncalled bet ($0.06) returned to a187372
*** SHOWDOWN ***
a187372 collected $0.12 from pot
*** SUMMARY ***
Total pot $0.12 | Rake $0 | Jackpot $0 | Bingo $0 | Fortune $0 | Tax $0
Seat 1: c3155cc0 (button) folded before Flop (didn't bet)
Seat 2: Hero (small blind) folded before Flop
Seat 3: e248cbd0 (big blind) folded before Flop
Seat 4: 1eef3559 folded before Flop (didn't bet)
Seat 5: a187372 collected ($0.12)
Seat 6: e7e9348c folded before Flop (didn't bet)


Poker Hand #RC3795925790: Hold'em No Limit ($0.02/$0.05) - 2025/08/10 08:03:15
Table 'RushAndCash11061050' 6-max Seat #1 is the button
Seat 1: 560bbe0d ($14.06 in chips)
Seat 2: 4f108f4c ($5.54 in chips)
Seat 3: Hero ($5.03 in chips)
Seat 4: 78871292 ($3.7 in chips)
Seat 5: 80630135 ($8.97 in chips)
Seat 6: 115a6213 ($5 in chips)
4f108f4c: posts small blind $0.02
Hero: posts big blind $0.05
*** HOLE CARDS ***
Dealt to 560bbe0d 
Dealt to 4f108f4c 
Dealt to Hero [8s 4s]
Dealt to 78871292 
Dealt to 80630135 
Dealt to 115a6213 
78871292: folds
80630135: folds
115a6213: folds
560bbe0d: folds
4f108f4c: folds
Uncalled bet ($0.03) returned to Hero
*** SHOWDOWN ***
Hero collected $0.04 from pot
*** SUMMARY ***
Total pot $0.04 | Rake $0 | Jackpot $0 | Bingo $0 | Fortune $0 | Tax $0
Seat 1: 560bbe0d (button) folded before Flop (didn't bet)
Seat 2: 4f108f4c (small blind) folded before Flop
Seat 3: Hero (big blind) collected ($0.04)
Seat 4: 78871292 folded before Flop (didn't bet)
Seat 5: 80630135 folded before Flop (didn't bet)
Seat 6: 115a6213 folded before Flop (didn't bet)


Poker Hand #RC3795925588: Hold'em No Limit ($0.02/$0.05) - 2025/08/10 08:02:21
Table 'RushAndCash11060848' 6-max Seat #1 is the button
Seat 1: a0ebcff ($5 in chips)
Seat 2: 1cebd796 ($6.05 in chips)
Seat 3: 49991131 ($10.1 in chips)
Seat 4: bf4e2b6b ($10.35 in chips)
Seat 5: 72f7d641 ($7.97 in chips)
Seat 6: Hero ($4.78 in chips)
1cebd796: posts small blind $0.02
49991131: posts big blind $0.05
*** HOLE CARDS ***
Dealt to a0ebcff 
Dealt to 1cebd796 
Dealt to 49991131 
Dealt to bf4e2b6b 
Dealt to 72f7d641 
Dealt to Hero [5s As]
bf4e2b6b: folds
72f7d641: folds
Hero: raises $0.05 to $0.1
a0ebcff: folds
1cebd796: folds
49991131: calls $0.05
*** FLOP *** [3s 7c 7d]
49991131: checks
Hero: checks
*** TURN *** [3s 7c 7d] [Qs]
49991131: bets $0.15
Hero: raises $0.62 to $0.77
49991131: folds
Uncalled bet ($0.62) returned to Hero
*** SHOWDOWN ***
Hero collected $0.5 from pot
*** SUMMARY ***
Total pot $0.52 | Rake $0.02 | Jackpot $0 | Bingo $0 | Fortune $0 | Tax $0
Board [3s 7c 7d Qs]
Seat 1: a0ebcff (button) folded before Flop (didn't bet)
Seat 2: 1cebd796 (small blind) folded before Flop
Seat 3: 49991131 (big blind) folded on the Turn
Seat 4: bf4e2b6b folded before Flop (didn't bet)
Seat 5: 72f7d641 folded before Flop (didn't bet)
Seat 6: Hero won ($0.5)


Poker Hand #RC3795925571: Hold'em No Limit ($0.02/$0.05) - 2025/08/10 08:02:16
Table 'RushAndCash11060831' 6-max Seat #1 is the button
Seat 1: 9e906893 ($3.44 in chips)
Seat 2: 7869fb4b ($5.09 in chips)
Seat 3: edfd9c9a ($13.8 in chips)
Seat 4: 95a8436b ($10.1 in chips)
Seat 5: Hero ($4.78 in chips)
Seat 6: 9ef40456 ($6.11 in chips)
7869fb4b: posts small blind $0.02
edfd9c9a: posts big blind $0.05
*** HOLE CARDS ***
Dealt to 9e906893 
Dealt to 7869fb4b 
Dealt to edfd9c9a 
Dealt to 95a8436b 
Dealt to Hero [Ad 4s]
Dealt to 9ef40456 
95a8436b: folds
Hero: folds
9ef40456: folds
9e906893: folds
7869fb4b: calls $0.03
edfd9c9a: checks
*** FLOP *** [6h Ks Ac]
7869fb4b: bets $0.05
edfd9c9a: folds
Uncalled bet ($0.05) returned to 7869fb4b
*** SHOWDOWN ***
7869fb4b collected $0.1 from pot
*** SUMMARY ***
Total pot $0.1 | Rake $0 | Jackpot $0 | Bingo $0 | Fortune $0 | Tax $0
Board [6h Ks Ac]
Seat 1: 9e906893 (button) folded before Flop (didn't bet)
Seat 2: 7869fb4b (small blind) won ($0.1)
Seat 3: edfd9c9a (big blind) folded on the Flop
Seat 4: 95a8436b folded before Flop (didn't bet)
Seat 5: Hero folded before Flop (didn't bet)
Seat 6: 9ef40456 folded before Flop (didn't bet)


Poker Hand #RC3795925561: Hold'em No Limit ($0.02/$0.05) - 2025/08/10 08:02:13
Table 'RushAndCash11060821' 6-max Seat #1 is the button
Seat 1: 2a76f9f5 ($6.69 in chips)
Seat 2: 13034233 ($4.95 in chips)
Seat 3: accb3720 ($5 in chips)
Seat 4: Hero ($4.78 in chips)
Seat 5: 9e906893 ($3.44 in chips)
Seat 6: f6c47f47 ($5.02 in chips)
13034233: posts small blind $0.02
accb3720: posts big blind $0.05
*** HOLE CARDS ***
Dealt to 2a76f9f5 
Dealt to 13034233 
Dealt to accb3720 
Dealt to Hero [Qc 3c]
Dealt to 9e906893 
Dealt to f6c47f47 
Hero: folds
9e906893: folds
f6c47f47: raises $0.05 to $0.1
2a76f9f5: folds
13034233: folds
accb3720: calls $0.05
*** FLOP *** [4d 8s 7h]
accb3720: checks
f6c47f47: bets $0.08
accb3720: raises $0.29 to $0.37
f6c47f47: folds
Uncalled bet ($0.29) returned to accb3720
*** SHOWDOWN ***
accb3720 collected $0.36 from pot
*** SUMMARY ***
Total pot $0.38 | Rake $0.02 | Jackpot $0 | Bingo $0 | Fortune $0 | Tax $0
Board [4d 8s 7h]
Seat 1: 2a76f9f5 (button) folded before Flop (didn't bet)
Seat 2: 13034233 (small blind) folded before Flop
Seat 3: accb3720 (big blind) won ($0.36)
Seat 4: Hero folded before Flop (didn't bet)
Seat 5: 9e906893 folded before Flop (didn't bet)
Seat 6: f6c47f47 folded on the Flop


Poker Hand #RC3795925549: Hold'em No Limit ($0.02/$0.05) - 2025/08/10 08:02:09
Table 'RushAndCash11060809' 6-max Seat #1 is the button
Seat 1: 9d70d038 ($7.69 in chips)
Seat 2: f6c47f47 ($5.04 in chips)
Seat 3: 665d5285 ($10.62 in chips)
Seat 4: Hero ($4.78 in chips)
Seat 5: 83e19d4d ($5.55 in chips)
Seat 6: bbe9b1b1 ($6.3 in chips)
f6c47f47: posts small blind $0.02
665d5285: posts big blind $0.05
*** HOLE CARDS ***
Dealt to 9d70d038 
Dealt to f6c47f47 
Dealt to 665d5285 
Dealt to Hero [8d Tc]
Dealt to 83e19d4d 
Dealt to bbe9b1b1 
Hero: folds
83e19d4d: folds
bbe9b1b1: folds
9d70d038: raises $0.05 to $0.1
f6c47f47: folds
665d5285: folds
Uncalled bet ($0.05) returned to 9d70d038
*** SHOWDOWN ***
9d70d038 collected $0.12 from pot
*** SUMMARY ***
Total pot $0.12 | Rake $0 | Jackpot $0 | Bingo $0 | Fortune $0 | Tax $0
Seat 1: 9d70d038 (button) collected ($0.12)
Seat 2: f6c47f47 (small blind) folded before Flop
Seat 3: 665d5285 (big blind) folded before Flop
Seat 4: Hero folded before Flop (didn't bet)
Seat 5: 83e19d4d folded before Flop (didn't bet)
Seat 6: bbe9b1b1 folded before Flop (didn't bet)


Poker Hand #RC3795925537: Hold'em No Limit ($0.02/$0.05) - 2025/08/10 08:02:05
Table 'RushAndCash11060797' 6-max Seat #1 is the button
Seat 1: Hero ($4.78 in chips)
Seat 2: 807ad75a ($5.47 in chips)
Seat 3: 4cb26b71 ($5.86 in chips)
Seat 4: df963cf7 ($4.93 in chips)
Seat 5: 17597972 ($5.14 in chips)
Seat 6: b83c710b ($5.07 in chips)
807ad75a: posts small blind $0.02
4cb26b71: posts big blind $0.05
*** HOLE CARDS ***
Dealt to Hero [Kd 4h]
Dealt to 807ad75a 
Dealt to 4cb26b71 
Dealt to df963cf7 
Dealt to 17597972 
Dealt to b83c710b 
df963cf7: folds
17597972: folds
b83c710b: folds
Hero: folds
807ad75a: raises $0.09 to $0.14
4cb26b71: folds
Uncalled bet ($0.09) returned to 807ad75a
*** SHOWDOWN ***
807ad75a collected $0.1 from pot
*** SUMMARY ***
Total pot $0.1 | Rake $0 | Jackpot $0 | Bingo $0 | Fortune $0 | Tax $0
Seat 1: Hero (button) folded before Flop (didn't bet)
Seat 2: 807ad75a (small blind) collected ($0.1)
Seat 3: 4cb26b71 (big blind) folded before Flop
Seat 4: df963cf7 folded before Flop (didn't bet)
Seat 5: 17597972 folded before Flop (didn't bet)
Seat 6: b83c710b folded before Flop (didn't bet)


Poker Hand #RC3795925452: Hold'em No Limit ($0.02/$0.05) - 2025/08/10 08:01:41
Table 'RushAndCash11060712' 6-max Seat #1 is the button
Seat 1: 6bc386a7 ($7.04 in chips)
Seat 2: Hero ($4.82 in chips)
Seat 3: 42c5560c ($6 in chips)
Seat 4: 336dc8b4 ($9.13 in chips)
Seat 5: f802204 ($5.74 in chips)
Seat 6: 8d1c252c ($5.05 in chips)
Hero: posts small blind $0.02
42c5560c: posts big blind $0.05
*** HOLE CARDS ***
Dealt to 6bc386a7 
Dealt to Hero [5h 6h]
Dealt to 42c5560c 
Dealt to 336dc8b4 
Dealt to f802204 
Dealt to 8d1c252c 
336dc8b4: folds
f802204: raises $0.06 to $0.11
8d1c252c: folds
6bc386a7: folds
Hero: calls $0.09
42c5560c: folds
*** FLOP *** [9c Js 3d]
Hero: checks
f802204: bets $0.2
Hero: folds
Uncalled bet ($0.2) returned to f802204
*** SHOWDOWN ***
f802204 collected $0.26 from pot
*** SUMMARY ***
Total pot $0.27 | Rake $0.01 | Jackpot $0 | Bingo $0 | Fortune $0 | Tax $0
Board [9c Js 3d]
Seat 1: 6bc386a7 (button) folded before Flop (didn't bet)
Seat 2: Hero (small blind) folded on the Flop
Seat 3: 42c5560c (big blind) folded before Flop
Seat 4: 336dc8b4 folded before Flop (didn't bet)
Seat 5: f802204 won ($0.26)
Seat 6: 8d1c252c folded before Flop (didn't bet)


Poker Hand #RC3795925425: Hold'em No Limit ($0.02/$0.05) - 2025/08/10 08:01:34
Table 'RushAndCash11060685' 6-max Seat #1 is the button
Seat 1: 665d5285 ($10.62 in chips)
Seat 2: ccfdc965 ($5.79 in chips)
Seat 3: Hero ($4.87 in chips)
Seat 4: 9f3f3f95 ($5 in chips)
Seat 5: bfa0c2b2 ($5.96 in chips)
Seat 6: 808ba0fa ($6.39 in chips)
ccfdc965: posts small blind $0.02
Hero: posts big blind $0.05
*** HOLE CARDS ***
Dealt to 665d5285 
Dealt to ccfdc965 
Dealt to Hero [3s Js]
Dealt to 9f3f3f95 
Dealt to bfa0c2b2 
Dealt to 808ba0fa 
9f3f3f95: folds
bfa0c2b2: folds
808ba0fa: folds
665d5285: folds
ccfdc965: folds
Uncalled bet ($0.03) returned to Hero
*** SHOWDOWN ***
Hero collected $0.04 from pot
*** SUMMARY ***
Total pot $0.04 | Rake $0 | Jackpot $0 | Bingo $0 | Fortune $0 | Tax $0
Seat 1: 665d5285 (button) folded before Flop (didn't bet)
Seat 2: ccfdc965 (small blind) folded before Flop
Seat 3: Hero (big blind) collected ($0.04)
Seat 4: 9f3f3f95 folded before Flop (didn't bet)
Seat 5: bfa0c2b2 folded before Flop (didn't bet)
Seat 6: 808ba0fa folded before Flop (didn't bet)


Poker Hand #RC3795925408: Hold'em No Limit ($0.02/$0.05) - 2025/08/10 08:01:30
Table 'RushAndCash11060668' 6-max Seat #1 is the button
Seat 1: 35c42e8c ($4.67 in chips)
Seat 2: 69e805cf ($10.23 in chips)
Seat 3: e9f334c0 ($5.21 in chips)
Seat 4: Hero ($4.87 in chips)
Seat 5: 5bde674d ($7.09 in chips)
Seat 6: bfa0c2b2 ($5.96 in chips)
69e805cf: posts small blind $0.02
e9f334c0: posts big blind $0.05
*** HOLE CARDS ***
Dealt to 35c42e8c 
Dealt to 69e805cf 
Dealt to e9f334c0 
Dealt to Hero [2d 8s]
Dealt to 5bde674d 
Dealt to bfa0c2b2 
Hero: folds
5bde674d: folds
bfa0c2b2: folds
35c42e8c: folds
69e805cf: raises $0.1 to $0.15
e9f334c0: calls $0.1
*** FLOP *** [Kc 8c 9s]
69e805cf: bets $0.1
e9f334c0: raises $0.22 to $0.32
69e805cf: raises $1.02 to $1.34
e9f334c0: raises $3.72 to $5.06 and is all-in
69e805cf: calls $3.72
e9f334c0: shows [9d 8d] (two pair, Nines and Eights)
69e805cf: shows [7h Kh] (a pair of Kings)
*** TURN *** [Kc 8c 9s] [Qs]
e9f334c0: Chooses to EV Cashout
*** RIVER *** [Kc 8c 9s Qs] [Kd]
e9f334c0: Receives Cashout ($8.25)
*** SHOWDOWN ***
69e805cf collected $10.2 from pot
*** SUMMARY ***
Total pot $10.42 | Rake $0.15 | Jackpot $0.07 | Bingo $0 | Fortune $0 | Tax $0
Board [Kc 8c 9s Qs Kd]
Seat 1: 35c42e8c (button) folded before Flop (didn't bet)
Seat 2: 69e805cf (small blind) showed [7h Kh] and won ($10.2) with three of a kind, Kings
Seat 3: e9f334c0 (big blind) showed [9d 8d] and lost with two pair, Kings and Nines, EV Cashout ($8.25)
Seat 4: Hero folded before Flop (didn't bet)
Seat 5: 5bde674d folded before Flop (didn't bet)
Seat 6: bfa0c2b2 folded before Flop (didn't bet)


Poker Hand #RC3795925394: Hold'em No Limit ($0.02/$0.05) - 2025/08/10 08:01:27
Table 'RushAndCash11060654' 6-max Seat #1 is the button
Seat 1: 9999c04f ($4.79 in chips)
Seat 2: c5baf2ee ($4.89 in chips)
Seat 3: 149ff18a ($5.48 in chips)
Seat 4: 4e1a3cf1 ($2.89 in chips)
Seat 5: bfa0c2b2 ($5.96 in chips)
Seat 6: Hero ($4.87 in chips)
c5baf2ee: posts small blind $0.02
149ff18a: posts big blind $0.05
*** HOLE CARDS ***
Dealt to 9999c04f 
Dealt to c5baf2ee 
Dealt to 149ff18a 
Dealt to 4e1a3cf1 
Dealt to bfa0c2b2 
Dealt to Hero [6c 8c]
4e1a3cf1: raises $0.05 to $0.1
bfa0c2b2: folds
Hero: folds
9999c04f: calls $0.1
c5baf2ee: folds
149ff18a: folds
*** FLOP *** [Ks 6d 8h]
4e1a3cf1: checks
9999c04f: bets $0.09
4e1a3cf1: calls $0.09
*** TURN *** [Ks 6d 8h] [7d]
4e1a3cf1: checks
9999c04f: checks
*** RIVER *** [Ks 6d 8h 7d] [Jh]
4e1a3cf1: checks
9999c04f: bets $0.1
4e1a3cf1: calls $0.1
9999c04f: shows [Kh Th] (a pair of Kings)
4e1a3cf1: shows [Qs Qc] (a pair of Queens)
*** SHOWDOWN ***
9999c04f collected $0.62 from pot
*** SUMMARY ***
Total pot $0.65 | Rake $0.03 | Jackpot $0 | Bingo $0 | Fortune $0 | Tax $0
Board [Ks 6d 8h 7d Jh]
Seat 1: 9999c04f (button) showed [Kh Th] and won ($0.62) with a pair of Kings
Seat 2: c5baf2ee (small blind) folded before Flop
Seat 3: 149ff18a (big blind) folded before Flop
Seat 4: 4e1a3cf1 showed [Qs Qc] and lost with a pair of Queens
Seat 5: bfa0c2b2 folded before Flop (didn't bet)
Seat 6: Hero folded before Flop (didn't bet)


Poker Hand #RC3795925359: Hold'em No Limit ($0.02/$0.05) - 2025/08/10 08:01:18
Table 'RushAndCash11060619' 6-max Seat #1 is the button
Seat 1: Hero ($4.87 in chips)
Seat 2: 149ff18a ($5.5 in chips)
Seat 3: d27c038b ($6.65 in chips)
Seat 4: 3817bfda ($10.38 in chips)
Seat 5: 32afa283 ($4.26 in chips)
Seat 6: 8b390e1e ($5 in chips)
149ff18a: posts small blind $0.02
d27c038b: posts big blind $0.05
*** HOLE CARDS ***
Dealt to Hero [4s 7d]
Dealt to 149ff18a 
Dealt to d27c038b 
Dealt to 3817bfda 
Dealt to 32afa283 
Dealt to 8b390e1e 
3817bfda: raises $0.07 to $0.12
32afa283: calls $0.12
8b390e1e: folds
Hero: folds
149ff18a: folds
d27c038b: raises $0.4 to $0.52
3817bfda: folds
32afa283: calls $0.4
*** FLOP *** [3h Ks 9d]
d27c038b: checks
32afa283: bets $0.39
d27c038b: calls $0.39
*** TURN *** [3h Ks 9d] [7h]
d27c038b: checks
32afa283: checks
*** RIVER *** [3h Ks 9d 7h] [8d]
d27c038b: checks
32afa283: checks
d27c038b: shows [As 9s] (a pair of Nines)
32afa283: shows [Td Tc] (a pair of Tens)
*** SHOWDOWN ***
32afa283 collected $1.8 from pot
*** SUMMARY ***
Total pot $1.96 | Rake $0.09 | Jackpot $0.07 | Bingo $0 | Fortune $0 | Tax $0
Board [3h Ks 9d 7h 8d]
Seat 1: Hero (button) folded before Flop (didn't bet)
Seat 2: 149ff18a (small blind) folded before Flop
Seat 3: d27c038b (big blind) showed [As 9s] and lost with a pair of Nines
Seat 4: 3817bfda folded before Flop
Seat 5: 32afa283 showed [Td Tc] and won ($1.8) with a pair of Tens
Seat 6: 8b390e1e folded before Flop (didn't bet)


Poker Hand #RC3795925340: Hold'em No Limit ($0.02/$0.05) - 2025/08/10 08:01:14
Table 'RushAndCash11060600' 6-max Seat #1 is the button
Seat 1: 7655cb54 ($5.94 in chips)
Seat 2: Hero ($4.89 in chips)
Seat 3: ac25def9 ($7.28 in chips)
Seat 4: 45a89215 ($4.44 in chips)
Seat 5: 43ab8974 ($6.42 in chips)
Seat 6: 42c5560c ($5.95 in chips)
Hero: posts small blind $0.02
ac25def9: posts big blind $0.05
*** HOLE CARDS ***
Dealt to 7655cb54 
Dealt to Hero [3h Qh]
Dealt to ac25def9 
Dealt to 45a89215 
Dealt to 43ab8974 
Dealt to 42c5560c 
45a89215: folds
43ab8974: folds
42c5560c: raises $0.06 to $0.11
7655cb54: folds
Hero: folds
ac25def9: folds
Uncalled bet ($0.06) returned to 42c5560c
*** SHOWDOWN ***
42c5560c collected $0.12 from pot
*** SUMMARY ***
Total pot $0.12 | Rake $0 | Jackpot $0 | Bingo $0 | Fortune $0 | Tax $0
Seat 1: 7655cb54 (button) folded before Flop (didn't bet)
Seat 2: Hero (small blind) folded before Flop
Seat 3: ac25def9 (big blind) folded before Flop
Seat 4: 45a89215 folded before Flop (didn't bet)
Seat 5: 43ab8974 folded before Flop (didn't bet)
Seat 6: 42c5560c collected ($0.12)


Poker Hand #RC3795925260: Hold'em No Limit ($0.02/$0.05) - 2025/08/10 08:00:54
Table 'RushAndCash11060520' 6-max Seat #1 is the button
Seat 1: bc8475a8 ($5 in chips)
Seat 2: 5818efb5 ($6.12 in chips)
Seat 3: Hero ($4.94 in chips)
Seat 4: 6366e2f ($10.65 in chips)
Seat 5: 2fd706a9 ($14 in chips)
Seat 6: 83e19d4d ($5.19 in chips)
5818efb5: posts small blind $0.02
Hero: posts big blind $0.05
*** HOLE CARDS ***
Dealt to bc8475a8 
Dealt to 5818efb5 
Dealt to Hero [3s 7d]
Dealt to 6366e2f 
Dealt to 2fd706a9 
Dealt to 83e19d4d 
6366e2f: folds
2fd706a9: raises $0.07 to $0.12
83e19d4d: folds
bc8475a8: folds
5818efb5: raises $0.39 to $0.51
Hero: folds
2fd706a9: calls $0.39
*** FLOP *** [2d 9d 8s]
5818efb5: bets $0.81
2fd706a9: folds
Uncalled bet ($0.81) returned to 5818efb5
*** SHOWDOWN ***
5818efb5 collected $1.02 from pot
*** SUMMARY ***
Total pot $1.07 | Rake $0.05 | Jackpot $0 | Bingo $0 | Fortune $0 | Tax $0
Board [2d 9d 8s]
Seat 1: bc8475a8 (button) folded before Flop (didn't bet)
Seat 2: 5818efb5 (small blind) won ($1.02)
Seat 3: Hero (big blind) folded before Flop
Seat 4: 6366e2f folded before Flop (didn't bet)
Seat 5: 2fd706a9 folded on the Flop
Seat 6: 83e19d4d folded before Flop (didn't bet)


Poker Hand #RC3795925247: Hold'em No Limit ($0.02/$0.05) - 2025/08/10 08:00:51
Table 'RushAndCash11060507' 6-max Seat #1 is the button
Seat 1: 6366e2f ($10.65 in chips)
Seat 2: c47206f4 ($10.86 in chips)
Seat 3: 256f1bf0 ($5.38 in chips)
Seat 4: f3a1d090 ($29.3 in chips)
Seat 5: 5818efb5 ($6.12 in chips)
Seat 6: Hero ($4.94 in chips)
c47206f4: posts small blind $0.02
256f1bf0: posts big blind $0.05
*** HOLE CARDS ***
Dealt to 6366e2f 
Dealt to c47206f4 
Dealt to 256f1bf0 
Dealt to f3a1d090 
Dealt to 5818efb5 
Dealt to Hero [Jc 5h]
f3a1d090: raises $0.07 to $0.12
5818efb5: folds
Hero: folds
6366e2f: folds
c47206f4: raises $0.44 to $0.56
256f1bf0: folds
f3a1d090: calls $0.44
*** FLOP *** [3s 7d 3d]
c47206f4: bets $0.58
f3a1d090: calls $0.58
*** TURN *** [3s 7d 3d] [2s]
c47206f4: bets $1.54
f3a1d090: calls $1.54
*** RIVER *** [3s 7d 3d 2s] [Ah]
c47206f4: bets $2.17
f3a1d090: folds
Uncalled bet ($2.17) returned to c47206f4
*** SHOWDOWN ***
c47206f4 collected $5.19 from pot
*** SUMMARY ***
Total pot $5.41 | Rake $0.15 | Jackpot $0.07 | Bingo $0 | Fortune $0 | Tax $0
Board [3s 7d 3d 2s Ah]
Seat 1: 6366e2f (button) folded before Flop (didn't bet)
Seat 2: c47206f4 (small blind) won ($5.19)
Seat 3: 256f1bf0 (big blind) folded before Flop
Seat 4: f3a1d090 folded on the River
Seat 5: 5818efb5 folded before Flop (didn't bet)
Seat 6: Hero folded before Flop (didn't bet)


Poker Hand #RC3795925233: Hold'em No Limit ($0.02/$0.05) - 2025/08/10 08:00:47
Table 'RushAndCash11060493' 6-max Seat #1 is the button
Seat 1: 2d1b3dec ($5 in chips)
Seat 2: 679f38b2 ($10.28 in chips)
Seat 3: 5c5d4a8d ($11.38 in chips)
Seat 4: Hero ($4.94 in chips)
Seat 5: a4b58f11 ($11.63 in chips)
Seat 6: f321949b ($8.39 in chips)
679f38b2: posts small blind $0.02
5c5d4a8d: posts big blind $0.05
*** HOLE CARDS ***
Dealt to 2d1b3dec 
Dealt to 679f38b2 
Dealt to 5c5d4a8d 
Dealt to Hero [6d Ad]
Dealt to a4b58f11 
Dealt to f321949b 
Hero: folds
a4b58f11: folds
f321949b: folds
2d1b3dec: folds
679f38b2: calls $0.03
5c5d4a8d: checks
*** FLOP *** [7d 2d 9h]
679f38b2: checks
5c5d4a8d: checks
*** TURN *** [7d 2d 9h] [4s]
679f38b2: bets $0.1
5c5d4a8d: folds
Uncalled bet ($0.1) returned to 679f38b2
*** SHOWDOWN ***
679f38b2 collected $0.1 from pot
*** SUMMARY ***
Total pot $0.1 | Rake $0 | Jackpot $0 | Bingo $0 | Fortune $0 | Tax $0
Board [7d 2d 9h 4s]
Seat 1: 2d1b3dec (button) folded before Flop (didn't bet)
Seat 2: 679f38b2 (small blind) won ($0.1)
Seat 3: 5c5d4a8d (big blind) folded on the Turn
Seat 4: Hero folded before Flop (didn't bet)
Seat 5: a4b58f11 folded before Flop (didn't bet)
Seat 6: f321949b folded before Flop (didn't bet)


Poker Hand #RC3795925220: Hold'em No Limit ($0.02/$0.05) - 2025/08/10 08:00:44
Table 'RushAndCash11060480' 6-max Seat #1 is the button
Seat 1: d3b2bf87 ($8.68 in chips)
Seat 2: 65376f32 ($4.15 in chips)
Seat 3: c7fa04a1 ($7.22 in chips)
Seat 4: 5525973a ($10.34 in chips)
Seat 5: 69e805cf ($10.35 in chips)
Seat 6: Hero ($4.94 in chips)
65376f32: posts small blind $0.02
c7fa04a1: posts big blind $0.05
*** HOLE CARDS ***
Dealt to d3b2bf87 
Dealt to 65376f32 
Dealt to c7fa04a1 
Dealt to 5525973a 
Dealt to 69e805cf 
Dealt to Hero [Ac 2h]
5525973a: folds
69e805cf: folds
Hero: folds
d3b2bf87: folds
65376f32: folds
Uncalled bet ($0.03) returned to c7fa04a1
*** SHOWDOWN ***
c7fa04a1 collected $0.04 from pot
*** SUMMARY ***
Total pot $0.04 | Rake $0 | Jackpot $0 | Bingo $0 | Fortune $0 | Tax $0
Seat 1: d3b2bf87 (button) folded before Flop (didn't bet)
Seat 2: 65376f32 (small blind) folded before Flop
Seat 3: c7fa04a1 (big blind) collected ($0.04)
Seat 4: 5525973a folded before Flop (didn't bet)
Seat 5: 69e805cf folded before Flop (didn't bet)
Seat 6: Hero folded before Flop (didn't bet)


Poker Hand #RC3795925203: Hold'em No Limit ($0.02/$0.05) - 2025/08/10 08:00:39
Table 'RushAndCash11060463' 6-max Seat #1 is the button
Seat 1: c8568584 ($5.07 in chips)
Seat 2: Hero ($4.96 in chips)
Seat 3: af0721f5 ($5.94 in chips)
Seat 4: 7f40418 ($5.85 in chips)
Seat 5: 807ad75a ($5.3 in chips)
Seat 6: 9efd55a2 ($7.54 in chips)
Hero: posts small blind $0.02
af0721f5: posts big blind $0.05
*** HOLE CARDS ***
Dealt to c8568584 
Dealt to Hero [8s 6c]
Dealt to af0721f5 
Dealt to 7f40418 
Dealt to 807ad75a 
Dealt to 9efd55a2 
7f40418: folds
807ad75a: folds
9efd55a2: folds
c8568584: folds
Hero: folds
Uncalled bet ($0.03) returned to af0721f5
*** SHOWDOWN ***
af0721f5 collected $0.04 from pot
*** SUMMARY ***
Total pot $0.04 | Rake $0 | Jackpot $0 | Bingo $0 | Fortune $0 | Tax $0
Seat 1: c8568584 (button) folded before Flop (didn't bet)
Seat 2: Hero (small blind) folded before Flop
Seat 3: af0721f5 (big blind) collected ($0.04)
Seat 4: 7f40418 folded before Flop (didn't bet)
Seat 5: 807ad75a folded before Flop (didn't bet)
Seat 6: 9efd55a2 folded before Flop (didn't bet)


Poker Hand #RC3795925163: Hold'em No Limit ($0.02/$0.05) - 2025/08/10 08:00:27
Table 'RushAndCash11060423' 6-max Seat #1 is the button
Seat 1: Hero ($4.96 in chips)
Seat 2: 515fd43e ($5 in chips)
Seat 3: 17597972 ($5 in chips)
Seat 4: 8b390e1e ($5 in chips)
Seat 5: 1dafb1bc ($33.35 in chips)
Seat 6: 69e805cf ($10.35 in chips)
515fd43e: posts small blind $0.02
17597972: posts big blind $0.05
*** HOLE CARDS ***
Dealt to Hero [8s Qd]
Dealt to 515fd43e 
Dealt to 17597972 
Dealt to 8b390e1e 
Dealt to 1dafb1bc 
Dealt to 69e805cf 
8b390e1e: folds
1dafb1bc: raises $0.07 to $0.12
69e805cf: folds
Hero: folds
515fd43e: folds
17597972: calls $0.07
*** FLOP *** [Kd Qc 2h]
17597972: checks
1dafb1bc: bets $0.09
17597972: calls $0.09
*** TURN *** [Kd Qc 2h] [6c]
17597972: checks
1dafb1bc: checks
*** RIVER *** [Kd Qc 2h 6c] [8d]
17597972: checks
1dafb1bc: checks
17597972: shows [Qh Jh] (a pair of Queens)
1dafb1bc: shows [9h Ah] (Ace high)
*** SHOWDOWN ***
17597972 collected $0.42 from pot
*** SUMMARY ***
Total pot $0.44 | Rake $0.02 | Jackpot $0 | Bingo $0 | Fortune $0 | Tax $0
Board [Kd Qc 2h 6c 8d]
Seat 1: Hero (button) folded before Flop (didn't bet)
Seat 2: 515fd43e (small blind) folded before Flop
Seat 3: 17597972 (big blind) showed [Qh Jh] and won ($0.42) with a pair of Queens
Seat 4: 8b390e1e folded before Flop (didn't bet)
Seat 5: 1dafb1bc showed [9h Ah] and lost with Ace high
Seat 6: 69e805cf folded before Flop (didn't bet)


Poker Hand #RC3795925126: Hold'em No Limit ($0.02/$0.05) - 2025/08/10 08:00:17
Table 'RushAndCash11060386' 6-max Seat #1 is the button
Seat 1: 7b419a6a ($7.59 in chips)
Seat 2: 80630135 ($7.63 in chips)
Seat 3: Hero ($4.94 in chips)
Seat 4: 9f3f3f95 ($6.21 in chips)
Seat 5: 2a76f9f5 ($6.88 in chips)
Seat 6: fc1e46cd ($5.87 in chips)
80630135: posts small blind $0.02
Hero: posts big blind $0.05
*** HOLE CARDS ***
Dealt to 7b419a6a 
Dealt to 80630135 
Dealt to Hero [5d Jh]
Dealt to 9f3f3f95 
Dealt to 2a76f9f5 
Dealt to fc1e46cd 
9f3f3f95: folds
2a76f9f5: folds
fc1e46cd: folds
7b419a6a: folds
80630135: folds
Uncalled bet ($0.03) returned to Hero
*** SHOWDOWN ***
Hero collected $0.04 from pot
*** SUMMARY ***
Total pot $0.04 | Rake $0 | Jackpot $0 | Bingo $0 | Fortune $0 | Tax $0
Seat 1: 7b419a6a (button) folded before Flop (didn't bet)
Seat 2: 80630135 (small blind) folded before Flop
Seat 3: Hero (big blind) collected ($0.04)
Seat 4: 9f3f3f95 folded before Flop (didn't bet)
Seat 5: 2a76f9f5 folded before Flop (didn't bet)
Seat 6: fc1e46cd folded before Flop (didn't bet)


Poker Hand #RC3795925112: Hold'em No Limit ($0.02/$0.05) - 2025/08/10 08:00:14
Table 'RushAndCash11060372' 6-max Seat #1 is the button
Seat 1: 4b9df3fe ($5.12 in chips)
Seat 2: 2bd5a8b ($5.16 in chips)
Seat 3: eaca1ea ($6.95 in chips)
Seat 4: Hero ($4.94 in chips)
Seat 5: c7fa04a1 ($7.22 in chips)
Seat 6: ae904d2 ($5.5 in chips)
2bd5a8b: posts small blind $0.02
eaca1ea: posts big blind $0.05
*** HOLE CARDS ***
Dealt to 4b9df3fe 
Dealt to 2bd5a8b 
Dealt to eaca1ea 
Dealt to Hero [5h 4c]
Dealt to c7fa04a1 
Dealt to ae904d2 
Hero: folds
c7fa04a1: folds
ae904d2: folds
4b9df3fe: raises $0.08 to $0.13
2bd5a8b: folds
eaca1ea: raises $0.18 to $0.31
4b9df3fe: calls $0.18
*** FLOP *** [5d 2c 6d]
eaca1ea: bets $0.2
4b9df3fe: calls $0.2
*** TURN *** [5d 2c 6d] [9s]
eaca1ea: checks
4b9df3fe: bets $0.52
eaca1ea: folds
Uncalled bet ($0.52) returned to 4b9df3fe
*** SHOWDOWN ***
4b9df3fe collected $0.99 from pot
*** SUMMARY ***
Total pot $1.04 | Rake $0.05 | Jackpot $0 | Bingo $0 | Fortune $0 | Tax $0
Board [5d 2c 6d 9s]
Seat 1: 4b9df3fe (button) won ($0.99)
Seat 2: 2bd5a8b (small blind) folded before Flop
Seat 3: eaca1ea (big blind) folded on the Turn
Seat 4: Hero folded before Flop (didn't bet)
Seat 5: c7fa04a1 folded before Flop (didn't bet)
Seat 6: ae904d2 folded before Flop (didn't bet)


Poker Hand #RC3795925096: Hold'em No Limit ($0.02/$0.05) - 2025/08/10 08:00:10
Table 'RushAndCash11060356' 6-max Seat #1 is the button
Seat 1: 4b9df3fe ($5.12 in chips)
Seat 2: 68c48621 ($5 in chips)
Seat 3: f6c47f47 ($5 in chips)
Seat 4: ae904d2 ($5.5 in chips)
Seat 5: Hero ($4.94 in chips)
Seat 6: 808ba0fa ($6.7 in chips)
68c48621: posts small blind $0.02
f6c47f47: posts big blind $0.05
*** HOLE CARDS ***
Dealt to 4b9df3fe 
Dealt to 68c48621 
Dealt to f6c47f47 
Dealt to ae904d2 
Dealt to Hero [Jc 3d]
Dealt to 808ba0fa 
ae904d2: folds
Hero: folds
808ba0fa: raises $0.07 to $0.12
4b9df3fe: folds
68c48621: folds
f6c47f47: calls $0.07
*** FLOP *** [2d 5c 4c]
f6c47f47: checks
808ba0fa: checks
*** TURN *** [2d 5c 4c] [4h]
f6c47f47: bets $0.2
808ba0fa: folds
Uncalled bet ($0.2) returned to f6c47f47
*** SHOWDOWN ***
f6c47f47 collected $0.25 from pot
*** SUMMARY ***
Total pot $0.26 | Rake $0.01 | Jackpot $0 | Bingo $0 | Fortune $0 | Tax $0
Board [2d 5c 4c 4h]
Seat 1: 4b9df3fe (button) folded before Flop (didn't bet)
Seat 2: 68c48621 (small blind) folded before Flop
Seat 3: f6c47f47 (big blind) won ($0.25)
Seat 4: ae904d2 folded before Flop (didn't bet)
Seat 5: Hero folded before Flop (didn't bet)
Seat 6: 808ba0fa folded on the Turn


Poker Hand #RC3795925033: Hold'em No Limit ($0.02/$0.05) - 2025/08/10 07:59:52
Table 'RushAndCash11060293' 6-max Seat #1 is the button
Seat 1: fecbabe7 ($5 in chips)
Seat 2: 6f8f726b ($12.3 in chips)
Seat 3: e364483e ($8.27 in chips)
Seat 4: b1b3930a ($5.5 in chips)
Seat 5: 665d5285 ($10.69 in chips)
Seat 6: Hero ($4.87 in chips)
6f8f726b: posts small blind $0.02
e364483e: posts big blind $0.05
*** HOLE CARDS ***
Dealt to fecbabe7 
Dealt to 6f8f726b 
Dealt to e364483e 
Dealt to b1b3930a 
Dealt to 665d5285 
Dealt to Hero [Kc Jd]
b1b3930a: folds
665d5285: folds
Hero: raises $0.05 to $0.1
fecbabe7: folds
6f8f726b: folds
e364483e: folds
Uncalled bet ($0.05) returned to Hero
*** SHOWDOWN ***
Hero collected $0.12 from pot
*** SUMMARY ***
Total pot $0.12 | Rake $0 | Jackpot $0 | Bingo $0 | Fortune $0 | Tax $0
Seat 1: fecbabe7 (button) folded before Flop (didn't bet)
Seat 2: 6f8f726b (small blind) folded before Flop
Seat 3: e364483e (big blind) folded before Flop
Seat 4: b1b3930a folded before Flop (didn't bet)
Seat 5: 665d5285 folded before Flop (didn't bet)
Seat 6: Hero collected ($0.12)


Poker Hand #RC3795924988: Hold'em No Limit ($0.02/$0.05) - 2025/08/10 07:59:41
Table 'RushAndCash11060248' 6-max Seat #1 is the button
Seat 1: Hero ($4.87 in chips)
Seat 2: 999a0f96 ($6.47 in chips)
Seat 3: d84c0cb ($7.09 in chips)
Seat 4: a413a473 ($8.19 in chips)
Seat 5: d7fd8492 ($9.39 in chips)
Seat 6: 779ef097 ($7.04 in chips)
999a0f96: posts small blind $0.02
d84c0cb: posts big blind $0.05
*** HOLE CARDS ***
Dealt to Hero [5c 5h]
Dealt to 999a0f96 
Dealt to d84c0cb 
Dealt to a413a473 
Dealt to d7fd8492 
Dealt to 779ef097 
a413a473: raises $0.08 to $0.13
d7fd8492: folds
779ef097: raises $0.37 to $0.5
Hero: folds
999a0f96: folds
d84c0cb: folds
a413a473: folds
Uncalled bet ($0.37) returned to 779ef097
*** SHOWDOWN ***
779ef097 collected $0.32 from pot
*** SUMMARY ***
Total pot $0.33 | Rake $0.01 | Jackpot $0 | Bingo $0 | Fortune $0 | Tax $0
Seat 1: Hero (button) folded before Flop (didn't bet)
Seat 2: 999a0f96 (small blind) folded before Flop
Seat 3: d84c0cb (big blind) folded before Flop
Seat 4: a413a473 folded before Flop
Seat 5: d7fd8492 folded before Flop (didn't bet)
Seat 6: 779ef097 collected ($0.32)


Poker Hand #RC3795924869: Hold'em No Limit ($0.02/$0.05) - 2025/08/10 07:59:08
Table 'RushAndCash11060129' 6-max Seat #1 is the button
Seat 1: fd12bd66 ($3.07 in chips)
Seat 2: Hero ($4.95 in chips)
Seat 3: e9f334c0 ($5 in chips)
Seat 4: 5f0e6d7 ($4.74 in chips)
Seat 5: d84c0cb ($6.9 in chips)
Seat 6: d6a2912 ($5.36 in chips)
Hero: posts small blind $0.02
e9f334c0: posts big blind $0.05
*** HOLE CARDS ***
Dealt to fd12bd66 
Dealt to Hero [3h 3d]
Dealt to e9f334c0 
Dealt to 5f0e6d7 
Dealt to d84c0cb 
Dealt to d6a2912 
5f0e6d7: folds
d84c0cb: raises $0.1 to $0.15
d6a2912: folds
fd12bd66: folds
Hero: calls $0.13
e9f334c0: folds
*** FLOP *** [7s 8h As]
Hero: checks
d84c0cb: bets $0.21
Hero: folds
Uncalled bet ($0.21) returned to d84c0cb
*** SHOWDOWN ***
d84c0cb collected $0.34 from pot
*** SUMMARY ***
Total pot $0.35 | Rake $0.01 | Jackpot $0 | Bingo $0 | Fortune $0 | Tax $0
Board [7s 8h As]
Seat 1: fd12bd66 (button) folded before Flop (didn't bet)
Seat 2: Hero (small blind) folded on the Flop
Seat 3: e9f334c0 (big blind) folded before Flop
Seat 4: 5f0e6d7 folded before Flop (didn't bet)
Seat 5: d84c0cb won ($0.34)
Seat 6: d6a2912 folded before Flop (didn't bet)


Poker Hand #RC3795924849: Hold'em No Limit ($0.02/$0.05) - 2025/08/10 07:59:04
Table 'RushAndCash11060109' 6-max Seat #1 is the button
Seat 1: 336dc8b4 ($7.25 in chips)
Seat 2: fa1b15ba ($14.2 in chips)
Seat 3: Hero ($2.83 in chips)
Seat 4: 391d0c67 ($5 in chips)
Seat 5: cbcdcf93 ($6.82 in chips)
Seat 6: ac3a4080 ($5 in chips)
fa1b15ba: posts small blind $0.02
Hero: posts big blind $0.05
*** HOLE CARDS ***
Dealt to 336dc8b4 
Dealt to fa1b15ba 
Dealt to Hero [6d Ah]
Dealt to 391d0c67 
Dealt to cbcdcf93 
Dealt to ac3a4080 
391d0c67: folds
cbcdcf93: folds
ac3a4080: folds
336dc8b4: folds
fa1b15ba: folds
Uncalled bet ($0.03) returned to Hero
*** SHOWDOWN ***
Hero collected $0.04 from pot
*** SUMMARY ***
Total pot $0.04 | Rake $0 | Jackpot $0 | Bingo $0 | Fortune $0 | Tax $0
Seat 1: 336dc8b4 (button) folded before Flop (didn't bet)
Seat 2: fa1b15ba (small blind) folded before Flop
Seat 3: Hero (big blind) collected ($0.04)
Seat 4: 391d0c67 folded before Flop (didn't bet)
Seat 5: cbcdcf93 folded before Flop (didn't bet)
Seat 6: ac3a4080 folded before Flop (didn't bet)


Poker Hand #RC3795894462: Hold'em No Limit ($0.02/$0.05) - 2025/08/10 07:57:29
Table 'RushAndCash11059722' 6-max Seat #1 is the button
Seat 1: 65914450 ($27.69 in chips)
Seat 2: 713716af ($6.78 in chips)
Seat 3: aba6f339 ($9.36 in chips)
Seat 4: 2319781 ($9.85 in chips)
Seat 5: Hero ($4.93 in chips)
Seat 6: cb83453e ($5 in chips)
713716af: posts small blind $0.02
aba6f339: posts big blind $0.05
*** HOLE CARDS ***
Dealt to 65914450 
Dealt to 713716af 
Dealt to aba6f339 
Dealt to 2319781 
Dealt to Hero [Qs Ac]
Dealt to cb83453e 
2319781: folds
Hero: raises $0.05 to $0.1
cb83453e: calls $0.1
65914450: calls $0.1
713716af: folds
aba6f339: folds
*** FLOP *** [9c 4s 4c]
Hero: checks
cb83453e: checks
65914450: checks
*** TURN *** [9c 4s 4c] [Jc]
Hero: bets $0.44
cb83453e: folds
65914450: calls $0.44
*** RIVER *** [9c 4s 4c Jc] [Th]
Hero: bets $1.56
65914450: calls $1.56
Hero: shows [Qs Ac] (a pair of Fours)
65914450: shows [Ks Jd] (two pair, Jacks and Fours)
*** SHOWDOWN ***
65914450 collected $4.15 from pot
*** SUMMARY ***
Total pot $4.37 | Rake $0.15 | Jackpot $0.07 | Bingo $0 | Fortune $0 | Tax $0
Board [9c 4s 4c Jc Th]
Seat 1: 65914450 (button) showed [Ks Jd] and won ($4.15) with two pair, Jacks and Fours
Seat 2: 713716af (small blind) folded before Flop
Seat 3: aba6f339 (big blind) folded before Flop
Seat 4: 2319781 folded before Flop (didn't bet)
Seat 5: Hero showed [Qs Ac] and lost with a pair of Fours
Seat 6: cb83453e folded on the Turn


Poker Hand #RC3795894446: Hold'em No Limit ($0.02/$0.05) - 2025/08/10 07:57:26
Table 'RushAndCash11059706' 6-max Seat #1 is the button
Seat 1: aba6f339 ($9.36 in chips)
Seat 2: e8380f03 ($5 in chips)
Seat 3: 9a120dc3 ($9.63 in chips)
Seat 4: Hero ($4.93 in chips)
Seat 5: 62b442f2 ($7.49 in chips)
Seat 6: 52682b66 ($5.19 in chips)
e8380f03: posts small blind $0.02
9a120dc3: posts big blind $0.05
*** HOLE CARDS ***
Dealt to aba6f339 
Dealt to e8380f03 
Dealt to 9a120dc3 
Dealt to Hero [Qs 6c]
Dealt to 62b442f2 
Dealt to 52682b66 
Hero: folds
62b442f2: folds
52682b66: calls $0.05
aba6f339: folds
e8380f03: folds
9a120dc3: checks
*** FLOP *** [Tc 4s Ah]
9a120dc3: checks
52682b66: bets $0.09
9a120dc3: folds
Uncalled bet ($0.09) returned to 52682b66
*** SHOWDOWN ***
52682b66 collected $0.12 from pot
*** SUMMARY ***
Total pot $0.12 | Rake $0 | Jackpot $0 | Bingo $0 | Fortune $0 | Tax $0
Board [Tc 4s Ah]
Seat 1: aba6f339 (button) folded before Flop (didn't bet)
Seat 2: e8380f03 (small blind) folded before Flop
Seat 3: 9a120dc3 (big blind) folded on the Flop
Seat 4: Hero folded before Flop (didn't bet)
Seat 5: 62b442f2 folded before Flop (didn't bet)
Seat 6: 52682b66 won ($0.12)


Poker Hand #RC3795894434: Hold'em No Limit ($0.02/$0.05) - 2025/08/10 07:57:22
Table 'RushAndCash11059694' 6-max Seat #1 is the button
Seat 1: 7729d8 ($4.3 in chips)
Seat 2: cbcdcf93 ($7.3 in chips)
Seat 3: 42c31e1a ($6.69 in chips)
Seat 4: Hero ($4.93 in chips)
Seat 5: 41ed372d ($5.48 in chips)
Seat 6: 17597972 ($5 in chips)
cbcdcf93: posts small blind $0.02
42c31e1a: posts big blind $0.05
*** HOLE CARDS ***
Dealt to 7729d8 
Dealt to cbcdcf93 
Dealt to 42c31e1a 
Dealt to Hero [Jd 7s]
Dealt to 41ed372d 
Dealt to 17597972 
Hero: folds
41ed372d: raises $0.08 to $0.13
17597972: folds
7729d8: folds
cbcdcf93: calls $0.11
42c31e1a: folds
*** FLOP *** [Ks 8s 9s]
cbcdcf93: checks
41ed372d: bets $0.11
cbcdcf93: folds
Uncalled bet ($0.11) returned to 41ed372d
*** SHOWDOWN ***
41ed372d collected $0.3 from pot
*** SUMMARY ***
Total pot $0.31 | Rake $0.01 | Jackpot $0 | Bingo $0 | Fortune $0 | Tax $0
Board [Ks 8s 9s]
Seat 1: 7729d8 (button) folded before Flop (didn't bet)
Seat 2: cbcdcf93 (small blind) folded on the Flop
Seat 3: 42c31e1a (big blind) folded before Flop
Seat 4: Hero folded before Flop (didn't bet)
Seat 5: 41ed372d won ($0.3)
Seat 6: 17597972 folded before Flop (didn't bet)


Poker Hand #RC3795894403: Hold'em No Limit ($0.02/$0.05) - 2025/08/10 07:57:14
Table 'RushAndCash11059663' 6-max Seat #1 is the button
Seat 1: Hero ($4.93 in chips)
Seat 2: d287584 ($9.28 in chips)
Seat 3: ccfdc965 ($5 in chips)
Seat 4: 9091f5 ($13.87 in chips)
Seat 5: 2443981e ($14.68 in chips)
Seat 6: 5ab0b835 ($7 in chips)
d287584: posts small blind $0.02
ccfdc965: posts big blind $0.05
*** HOLE CARDS ***
Dealt to Hero [4s 2h]
Dealt to d287584 
Dealt to ccfdc965 
Dealt to 9091f5 
Dealt to 2443981e 
Dealt to 5ab0b835 
9091f5: folds
2443981e: raises $0.05 to $0.1
5ab0b835: calls $0.1
Hero: folds
d287584: folds
ccfdc965: folds
*** FLOP *** [8h Jh Ks]
2443981e: bets $0.11
5ab0b835: calls $0.11
*** TURN *** [8h Jh Ks] [8s]
2443981e: checks
5ab0b835: checks
*** RIVER *** [8h Jh Ks 8s] [9d]
2443981e: checks
5ab0b835: checks
2443981e: shows [7d Qd] (a pair of Eights)
5ab0b835: shows [9h Ah] (two pair, Nines and Eights)
*** SHOWDOWN ***
5ab0b835 collected $0.47 from pot
*** SUMMARY ***
Total pot $0.49 | Rake $0.02 | Jackpot $0 | Bingo $0 | Fortune $0 | Tax $0
Board [8h Jh Ks 8s 9d]
Seat 1: Hero (button) folded before Flop (didn't bet)
Seat 2: d287584 (small blind) folded before Flop
Seat 3: ccfdc965 (big blind) folded before Flop
Seat 4: 9091f5 folded before Flop (didn't bet)
Seat 5: 2443981e showed [7d Qd] and lost with a pair of Eights
Seat 6: 5ab0b835 showed [9h Ah] and won ($0.47) with two pair, Nines and Eights


Poker Hand #RC3795894308: Hold'em No Limit ($0.02/$0.05) - 2025/08/10 07:56:47
Table 'RushAndCash11059568' 6-max Seat #1 is the button
Seat 1: fc1e46cd ($5.96 in chips)
Seat 2: Hero ($4.88 in chips)
Seat 3: 999a0f96 ($5.9 in chips)
Seat 4: 18ca1e6b ($7.81 in chips)
Seat 5: edfd9c9a ($8.52 in chips)
Seat 6: 483f17c3 ($12.88 in chips)
Hero: posts small blind $0.02
999a0f96: posts big blind $0.05
*** HOLE CARDS ***
Dealt to fc1e46cd 
Dealt to Hero [8h Th]
Dealt to 999a0f96 
Dealt to 18ca1e6b 
Dealt to edfd9c9a 
Dealt to 483f17c3 
18ca1e6b: folds
edfd9c9a: folds
483f17c3: folds
fc1e46cd: folds
Hero: calls $0.03
999a0f96: checks
*** FLOP *** [6d 8d 7h]
Hero: bets $0.05
999a0f96: folds
Uncalled bet ($0.05) returned to Hero
*** SHOWDOWN ***
Hero collected $0.1 from pot
*** SUMMARY ***
Total pot $0.1 | Rake $0 | Jackpot $0 | Bingo $0 | Fortune $0 | Tax $0
Board [6d 8d 7h]
Seat 1: fc1e46cd (button) folded before Flop (didn't bet)
Seat 2: Hero (small blind) won ($0.1)
Seat 3: 999a0f96 (big blind) folded on the Flop
Seat 4: 18ca1e6b folded before Flop (didn't bet)
Seat 5: edfd9c9a folded before Flop (didn't bet)
Seat 6: 483f17c3 folded before Flop (didn't bet)


Poker Hand #RC3795894252: Hold'em No Limit ($0.02/$0.05) - 2025/08/10 07:56:32
Table 'RushAndCash11059512' 6-max Seat #1 is the button
Seat 1: d5b42329 ($5.01 in chips)
Seat 2: 779ef097 ($5 in chips)
Seat 3: Hero ($4.93 in chips)
Seat 4: 9fd1d64c ($5.42 in chips)
Seat 5: 95a8436b ($10.32 in chips)
Seat 6: 18ca1e6b ($7.81 in chips)
779ef097: posts small blind $0.02
Hero: posts big blind $0.05
*** HOLE CARDS ***
Dealt to d5b42329 
Dealt to 779ef097 
Dealt to Hero [Ah 3d]
Dealt to 9fd1d64c 
Dealt to 95a8436b 
Dealt to 18ca1e6b 
9fd1d64c: folds
95a8436b: folds
18ca1e6b: folds
d5b42329: folds
779ef097: raises $0.1 to $0.15
Hero: folds
Uncalled bet ($0.1) returned to 779ef097
*** SHOWDOWN ***
779ef097 collected $0.1 from pot
*** SUMMARY ***
Total pot $0.1 | Rake $0 | Jackpot $0 | Bingo $0 | Fortune $0 | Tax $0
Seat 1: d5b42329 (button) folded before Flop (didn't bet)
Seat 2: 779ef097 (small blind) collected ($0.1)
Seat 3: Hero (big blind) folded before Flop
Seat 4: 9fd1d64c folded before Flop (didn't bet)
Seat 5: 95a8436b folded before Flop (didn't bet)
Seat 6: 18ca1e6b folded before Flop (didn't bet)


Poker Hand #RC3795894239: Hold'em No Limit ($0.02/$0.05) - 2025/08/10 07:56:28
Table 'RushAndCash11059499' 6-max Seat #1 is the button
Seat 1: 1ba97228 ($5.23 in chips)
Seat 2: d3b2bf87 ($9.43 in chips)
Seat 3: 8afb6429 ($5 in chips)
Seat 4: 6bfc0170 ($5.13 in chips)
Seat 5: Hero ($4.93 in chips)
Seat 6: ac25def9 ($8.06 in chips)
d3b2bf87: posts small blind $0.02
8afb6429: posts big blind $0.05
*** HOLE CARDS ***
Dealt to 1ba97228 
Dealt to d3b2bf87 
Dealt to 8afb6429 
Dealt to 6bfc0170 
Dealt to Hero [Kc 8d]
Dealt to ac25def9 
6bfc0170: raises $0.05 to $0.1
Hero: folds
ac25def9: folds
1ba97228: raises $0.22 to $0.32
d3b2bf87: folds
8afb6429: folds
6bfc0170: folds
Uncalled bet ($0.22) returned to 1ba97228
*** SHOWDOWN ***
1ba97228 collected $0.26 from pot
*** SUMMARY ***
Total pot $0.27 | Rake $0.01 | Jackpot $0 | Bingo $0 | Fortune $0 | Tax $0
Seat 1: 1ba97228 (button) collected ($0.26)
Seat 2: d3b2bf87 (small blind) folded before Flop
Seat 3: 8afb6429 (big blind) folded before Flop
Seat 4: 6bfc0170 folded before Flop
Seat 5: Hero folded before Flop (didn't bet)
Seat 6: ac25def9 folded before Flop (didn't bet)


Poker Hand #RC3795894221: Hold'em No Limit ($0.02/$0.05) - 2025/08/10 07:56:23
Table 'RushAndCash11059481' 6-max Seat #1 is the button
Seat 1: 6f47abe1 ($5.11 in chips)
Seat 2: accb3720 ($6.24 in chips)
Seat 3: 483f17c3 ($12.95 in chips)
Seat 4: 848c5954 ($6.12 in chips)
Seat 5: Hero ($4.93 in chips)
Seat 6: c1d96785 ($5.61 in chips)
accb3720: posts small blind $0.02
483f17c3: posts big blind $0.05
*** HOLE CARDS ***
Dealt to 6f47abe1 
Dealt to accb3720 
Dealt to 483f17c3 
Dealt to 848c5954 
Dealt to Hero [2c Kc]
Dealt to c1d96785 
848c5954: raises $0.05 to $0.1
Hero: folds
c1d96785: raises $0.27 to $0.37
6f47abe1: folds
accb3720: folds
483f17c3: folds
848c5954: raises $0.63 to $1
c1d96785: calls $0.63
*** FIRST FLOP *** [As Qc 5s]
848c5954: bets $0.69
c1d96785: calls $0.69
*** FIRST TURN *** [As Qc 5s] [Td]
848c5954: checks
c1d96785: bets $1.73
848c5954: raises $2.7 to $4.43 and is all-in
c1d96785: calls $2.19 and is all-in
Uncalled bet ($0.51) returned to 848c5954
848c5954: shows [Kd Ac] (a pair of Aces)
c1d96785: shows [Ad Ah] (three of a kind, Aces)
*** FIRST RIVER *** [As Qc 5s Td] [Th]
*** SECOND RIVER *** [As Qc 5s Td] [8s]
*** FIRST SHOWDOWN ***
c1d96785 collected $5.54 from pot
*** SECOND SHOWDOWN ***
c1d96785 collected $5.54 from pot
*** SUMMARY ***
Total pot $11.29 | Rake $0.14 | Jackpot $0.07 | Bingo $0 | Fortune $0 | Tax $0
Hand was run two times
FIRST Board [As Qc 5s Td Th]
SECOND Board [8s]
Seat 1: 6f47abe1 (button) folded before Flop (didn't bet)
Seat 2: accb3720 (small blind) folded before Flop
Seat 3: 483f17c3 (big blind) folded before Flop
Seat 4: 848c5954 showed [Kd Ac] and lost with two pair, Aces and Tens, and lost
Seat 5: Hero folded before Flop (didn't bet)
Seat 6: c1d96785 showed [Ad Ah] and won ($5.54) with a full house, Aces full of Tens, and won ($5.54)


Poker Hand #RC3795894202: Hold'em No Limit ($0.02/$0.05) - 2025/08/10 07:56:18
Table 'RushAndCash11059462' 6-max Seat #1 is the button
Seat 1: 26231614 ($3.14 in chips)
Seat 2: 637628c5 ($6.65 in chips)
Seat 3: 808ba0fa ($5.94 in chips)
Seat 4: Hero ($4.93 in chips)
Seat 5: 491f4216 ($12.96 in chips)
Seat 6: 2bd5a8b ($5.29 in chips)
637628c5: posts small blind $0.02
808ba0fa: posts big blind $0.05
*** HOLE CARDS ***
Dealt to 26231614 
Dealt to 637628c5 
Dealt to 808ba0fa 
Dealt to Hero [7c 9s]
Dealt to 491f4216 
Dealt to 2bd5a8b 
Hero: folds
491f4216: folds
2bd5a8b: raises $0.05 to $0.1
26231614: folds
637628c5: raises $0.29 to $0.39
808ba0fa: folds
2bd5a8b: folds
Uncalled bet ($0.29) returned to 637628c5
*** SHOWDOWN ***
637628c5 collected $0.24 from pot
*** SUMMARY ***
Total pot $0.25 | Rake $0.01 | Jackpot $0 | Bingo $0 | Fortune $0 | Tax $0
Seat 1: 26231614 (button) folded before Flop (didn't bet)
Seat 2: 637628c5 (small blind) collected ($0.24)
Seat 3: 808ba0fa (big blind) folded before Flop
Seat 4: Hero folded before Flop (didn't bet)
Seat 5: 491f4216 folded before Flop (didn't bet)
Seat 6: 2bd5a8b folded before Flop


Poker Hand #RC3795894186: Hold'em No Limit ($0.02/$0.05) - 2025/08/10 07:56:14
Table 'RushAndCash11059446' 6-max Seat #1 is the button
Seat 1: 65376f32 ($3.82 in chips)
Seat 2: 4b9df3fe ($5 in chips)
Seat 3: 8a1cdc04 ($5.17 in chips)
Seat 4: 607e31a1 ($11.79 in chips)
Seat 5: 5c5d4a8d ($10.37 in chips)
Seat 6: Hero ($4.93 in chips)
4b9df3fe: posts small blind $0.02
8a1cdc04: posts big blind $0.05
*** HOLE CARDS ***
Dealt to 65376f32 
Dealt to 4b9df3fe 
Dealt to 8a1cdc04 
Dealt to 607e31a1 
Dealt to 5c5d4a8d 
Dealt to Hero [8d Ks]
607e31a1: folds
5c5d4a8d: folds
Hero: folds
65376f32: raises $0.1 to $0.15
4b9df3fe: raises $0.35 to $0.5
8a1cdc04: folds
65376f32: folds
Uncalled bet ($0.35) returned to 4b9df3fe
*** SHOWDOWN ***
4b9df3fe collected $0.34 from pot
*** SUMMARY ***
Total pot $0.35 | Rake $0.01 | Jackpot $0 | Bingo $0 | Fortune $0 | Tax $0
Seat 1: 65376f32 (button) folded before Flop
Seat 2: 4b9df3fe (small blind) collected ($0.34)
Seat 3: 8a1cdc04 (big blind) folded before Flop
Seat 4: 607e31a1 folded before Flop (didn't bet)
Seat 5: 5c5d4a8d folded before Flop (didn't bet)
Seat 6: Hero folded before Flop (didn't bet)


Poker Hand #RC3795894159: Hold'em No Limit ($0.02/$0.05) - 2025/08/10 07:56:06
Table 'RushAndCash11059419' 6-max Seat #1 is the button
Seat 1: Hero ($4.93 in chips)
Seat 2: bbe9b1b1 ($6.68 in chips)
Seat 3: 63f3fdb ($5.79 in chips)
Seat 4: 9999c04f ($4.2 in chips)
Seat 5: 1982f140 ($8.71 in chips)
Seat 6: 6ac064ee ($5.14 in chips)
bbe9b1b1: posts small blind $0.02
63f3fdb: posts big blind $0.05
*** HOLE CARDS ***
Dealt to Hero [5c 7s]
Dealt to bbe9b1b1 
Dealt to 63f3fdb 
Dealt to 9999c04f 
Dealt to 1982f140 
Dealt to 6ac064ee 
9999c04f: folds
1982f140: folds
6ac064ee: folds
Hero: folds
bbe9b1b1: folds
Uncalled bet ($0.03) returned to 63f3fdb
*** SHOWDOWN ***
63f3fdb collected $0.04 from pot
*** SUMMARY ***
Total pot $0.04 | Rake $0 | Jackpot $0 | Bingo $0 | Fortune $0 | Tax $0
Seat 1: Hero (button) folded before Flop (didn't bet)
Seat 2: bbe9b1b1 (small blind) folded before Flop
Seat 3: 63f3fdb (big blind) collected ($0.04)
Seat 4: 9999c04f folded before Flop (didn't bet)
Seat 5: 1982f140 folded before Flop (didn't bet)
Seat 6: 6ac064ee folded before Flop (didn't bet)


Poker Hand #RC3795894134: Hold'em No Limit ($0.02/$0.05) - 2025/08/10 07:55:58
Table 'RushAndCash11059394' 6-max Seat #1 is the button
Seat 1: 24ad71c7 ($1.48 in chips)
Seat 2: Hero ($4.95 in chips)
Seat 3: 69e805cf ($5.53 in chips)
Seat 4: f802204 ($5 in chips)
Seat 5: 196a508f ($6.56 in chips)
Seat 6: a63176ef ($8.15 in chips)
Hero: posts small blind $0.02
69e805cf: posts big blind $0.05
*** HOLE CARDS ***
Dealt to 24ad71c7 
Dealt to Hero [Kc 3h]
Dealt to 69e805cf 
Dealt to f802204 
Dealt to 196a508f 
Dealt to a63176ef 
f802204: folds
196a508f: folds
a63176ef: folds
24ad71c7: folds
Hero: folds
Uncalled bet ($0.03) returned to 69e805cf
*** SHOWDOWN ***
69e805cf collected $0.04 from pot
*** SUMMARY ***
Total pot $0.04 | Rake $0 | Jackpot $0 | Bingo $0 | Fortune $0 | Tax $0
Seat 1: 24ad71c7 (button) folded before Flop (didn't bet)
Seat 2: Hero (small blind) folded before Flop
Seat 3: 69e805cf (big blind) collected ($0.04)
Seat 4: f802204 folded before Flop (didn't bet)
Seat 5: 196a508f folded before Flop (didn't bet)
Seat 6: a63176ef folded before Flop (didn't bet)


Poker Hand #RC3795894094: Hold'em No Limit ($0.02/$0.05) - 2025/08/10 07:55:47
Table 'RushAndCash11059354' 6-max Seat #1 is the button
Seat 1: cbcdcf93 ($7.43 in chips)
Seat 2: 8afb6429 ($5 in chips)
Seat 3: Hero ($5 in chips)
Seat 4: d3b2bf87 ($9.09 in chips)
Seat 5: 9a343d90 ($9.8 in chips)
Seat 6: 6412bd28 ($4.93 in chips)
8afb6429: posts small blind $0.02
Hero: posts big blind $0.05
*** HOLE CARDS ***
Dealt to cbcdcf93 
Dealt to 8afb6429 
Dealt to Hero [3h 6s]
Dealt to d3b2bf87 
Dealt to 9a343d90 
Dealt to 6412bd28 
d3b2bf87: raises $0.06 to $0.11
9a343d90: folds
6412bd28: folds
cbcdcf93: folds
8afb6429: calls $0.09
Hero: folds
*** FLOP *** [8d Th Jc]
8afb6429: checks
d3b2bf87: bets $0.21
8afb6429: calls $0.21
*** TURN *** [8d Th Jc] [Kh]
8afb6429: checks
d3b2bf87: bets $0.56
8afb6429: folds
Uncalled bet ($0.56) returned to d3b2bf87
*** SHOWDOWN ***
d3b2bf87 collected $0.66 from pot
*** SUMMARY ***
Total pot $0.69 | Rake $0.03 | Jackpot $0 | Bingo $0 | Fortune $0 | Tax $0
Board [8d Th Jc Kh]
Seat 1: cbcdcf93 (button) folded before Flop (didn't bet)
Seat 2: 8afb6429 (small blind) folded on the Turn
Seat 3: Hero (big blind) folded before Flop
Seat 4: d3b2bf87 won ($0.66)
Seat 5: 9a343d90 folded before Flop (didn't bet)
Seat 6: 6412bd28 folded before Flop (didn't bet)


