Poker Hand #RC3811289173: Hold'em No Limit ($0.02/$0.05) - 2025/08/16 13:58:10
Table 'RushAndCash864433' 6-max Seat #1 is the button
Seat 1: 570328bb ($6.98 in chips)
Seat 2: f6ceed6 ($9.48 in chips)
Seat 3: 2c24d22e ($4.95 in chips)
Seat 4: fdba6534 ($14.52 in chips)
Seat 5: a3d0f02e ($5.25 in chips)
Seat 6: Hero ($15.65 in chips)
f6ceed6: posts small blind $0.02
2c24d22e: posts big blind $0.05
*** HOLE CARDS ***
Dealt to 570328bb 
Dealt to f6ceed6 
Dealt to 2c24d22e 
Dealt to fdba6534 
Dealt to a3d0f02e 
Dealt to Hero [Jh Th]
fdba6534: folds
a3d0f02e: folds
Hero: raises $0.05 to $0.1
570328bb: raises $0.24 to $0.34
f6ceed6: folds
2c24d22e: folds
Hero: calls $0.24
*** FLOP *** [Qd Ad 8h]
Hero: checks
570328bb: bets $0.25
Hero: calls $0.25
*** TURN *** [Qd Ad 8h] [Ts]
Hero: checks
570328bb: checks
*** RIVER *** [Qd Ad 8h Ts] [Js]
Hero: checks
570328bb: bets $0.16
Hero: calls $0.16
570328bb: shows [Ac Jd] (two pair, Aces and Jacks)
Hero: shows [Jh Th] (two pair, Jacks and Tens)
*** SHOWDOWN ***
570328bb collected $1.43 from pot
*** SUMMARY ***
Total pot $1.57 | Rake $0.07 | Jackpot $0.07 | Bingo $0 | Fortune $0 | Tax $0
Board [Qd Ad 8h Ts Js]
Seat 1: 570328bb (button) showed [Ac Jd] and won ($1.43) with two pair, Aces and Jacks
Seat 2: f6ceed6 (small blind) folded before Flop
Seat 3: 2c24d22e (big blind) folded before Flop
Seat 4: fdba6534 folded before Flop (didn't bet)
Seat 5: a3d0f02e folded before Flop (didn't bet)
Seat 6: Hero showed [Jh Th] and lost with two pair, Jacks and Tens


Poker Hand #RC3811289154: Hold'em No Limit ($0.02/$0.05) - 2025/08/16 13:58:06
Table 'RushAndCash864414' 6-max Seat #1 is the button
Seat 1: df82d671 ($5.71 in chips)
Seat 2: 62a72ede ($4.95 in chips)
Seat 3: 570328bb ($7.03 in chips)
Seat 4: Hero ($15.65 in chips)
Seat 5: 2abc0574 ($6.13 in chips)
Seat 6: 917f3e19 ($9 in chips)
62a72ede: posts small blind $0.02
570328bb: posts big blind $0.05
*** HOLE CARDS ***
Dealt to df82d671 
Dealt to 62a72ede 
Dealt to 570328bb 
Dealt to Hero [7c Th]
Dealt to 2abc0574 
Dealt to 917f3e19 
Hero: folds
2abc0574: folds
917f3e19: folds
df82d671: folds
62a72ede: folds
Uncalled bet ($0.03) returned to 570328bb
*** SHOWDOWN ***
570328bb collected $0.04 from pot
*** SUMMARY ***
Total pot $0.04 | Rake $0 | Jackpot $0 | Bingo $0 | Fortune $0 | Tax $0
Seat 1: df82d671 (button) folded before Flop (didn't bet)
Seat 2: 62a72ede (small blind) folded before Flop
Seat 3: 570328bb (big blind) collected ($0.04)
Seat 4: Hero folded before Flop (didn't bet)
Seat 5: 2abc0574 folded before Flop (didn't bet)
Seat 6: 917f3e19 folded before Flop (didn't bet)


Poker Hand #RC3811289135: Hold'em No Limit ($0.02/$0.05) - 2025/08/16 13:58:03
Table 'RushAndCash864395' 6-max Seat #1 is the button
Seat 1: 52d7f205 ($5.36 in chips)
Seat 2: 570328bb ($7.05 in chips)
Seat 3: cef5d9ff ($5 in chips)
Seat 4: a178a7ae ($3.35 in chips)
Seat 5: Hero ($15.65 in chips)
Seat 6: 4b2b7b69 ($5.67 in chips)
570328bb: posts small blind $0.02
cef5d9ff: posts big blind $0.05
*** HOLE CARDS ***
Dealt to 52d7f205 
Dealt to 570328bb 
Dealt to cef5d9ff 
Dealt to a178a7ae 
Dealt to Hero [Ks 4d]
Dealt to 4b2b7b69 
a178a7ae: raises $0.05 to $0.1
Hero: folds
4b2b7b69: raises $0.21 to $0.31
52d7f205: folds
570328bb: folds
cef5d9ff: folds
a178a7ae: calls $0.21
*** FLOP *** [8d Td 9d]
a178a7ae: checks
4b2b7b69: bets $0.52
a178a7ae: folds
Uncalled bet ($0.52) returned to 4b2b7b69
*** SHOWDOWN ***
4b2b7b69 collected $0.66 from pot
*** SUMMARY ***
Total pot $0.69 | Rake $0.03 | Jackpot $0 | Bingo $0 | Fortune $0 | Tax $0
Board [8d Td 9d]
Seat 1: 52d7f205 (button) folded before Flop (didn't bet)
Seat 2: 570328bb (small blind) folded before Flop
Seat 3: cef5d9ff (big blind) folded before Flop
Seat 4: a178a7ae folded on the Flop
Seat 5: Hero folded before Flop (didn't bet)
Seat 6: 4b2b7b69 won ($0.66)


Poker Hand #RC3811289106: Hold'em No Limit ($0.02/$0.05) - 2025/08/16 13:57:57
Table 'RushAndCash864366' 6-max Seat #1 is the button
Seat 1: 85e0a327 ($5.71 in chips)
Seat 2: e6780e8f ($13.38 in chips)
Seat 3: c09afc51 ($12.99 in chips)
Seat 4: 1598f3d ($5 in chips)
Seat 5: 21582d9 ($5.78 in chips)
Seat 6: Hero ($15.65 in chips)
e6780e8f: posts small blind $0.02
c09afc51: posts big blind $0.05
*** HOLE CARDS ***
Dealt to 85e0a327 
Dealt to e6780e8f 
Dealt to c09afc51 
Dealt to 1598f3d 
Dealt to 21582d9 
Dealt to Hero [9d Qh]
1598f3d: folds
21582d9: folds
Hero: folds
85e0a327: raises $0.07 to $0.12
e6780e8f: folds
c09afc51: raises $0.26 to $0.38
85e0a327: calls $0.26
*** FLOP *** [5h 9h Js]
c09afc51: checks
85e0a327: checks
*** TURN *** [5h 9h Js] [3c]
c09afc51: bets $0.26
85e0a327: calls $0.26
*** RIVER *** [5h 9h Js 3c] [5d]
c09afc51: checks
85e0a327: checks
c09afc51: shows [Kc As] (a pair of Fives)
85e0a327: shows [Ah Kh] (a pair of Fives)
*** SHOWDOWN ***
c09afc51 collected $0.62 from pot
85e0a327 collected $0.62 from pot
*** SUMMARY ***
Total pot $1.3 | Rake $0.06 | Jackpot $0 | Bingo $0 | Fortune $0 | Tax $0
Board [5h 9h Js 3c 5d]
Seat 1: 85e0a327 (button) showed [Ah Kh] and won ($0.62) with a pair of Fives
Seat 2: e6780e8f (small blind) folded before Flop
Seat 3: c09afc51 (big blind) showed [Kc As] and won ($0.62) with a pair of Fives
Seat 4: 1598f3d folded before Flop (didn't bet)
Seat 5: 21582d9 folded before Flop (didn't bet)
Seat 6: Hero folded before Flop (didn't bet)


Poker Hand #RC3811289034: Hold'em No Limit ($0.02/$0.05) - 2025/08/16 13:57:42
Table 'RushAndCash864294' 6-max Seat #1 is the button
Seat 1: Hero ($15.65 in chips)
Seat 2: c4851d2c ($5 in chips)
Seat 3: 94afcc3f ($5.35 in chips)
Seat 4: 90db5865 ($5.99 in chips)
Seat 5: 76a11f55 ($3.44 in chips)
Seat 6: 108b6408 ($5.95 in chips)
c4851d2c: posts small blind $0.02
94afcc3f: posts big blind $0.05
*** HOLE CARDS ***
Dealt to Hero [2d 9c]
Dealt to c4851d2c 
Dealt to 94afcc3f 
Dealt to 90db5865 
Dealt to 76a11f55 
Dealt to 108b6408 
90db5865: folds
76a11f55: folds
108b6408: folds
Hero: folds
c4851d2c: folds
Uncalled bet ($0.03) returned to 94afcc3f
*** SHOWDOWN ***
94afcc3f collected $0.04 from pot
*** SUMMARY ***
Total pot $0.04 | Rake $0 | Jackpot $0 | Bingo $0 | Fortune $0 | Tax $0
Seat 1: Hero (button) folded before Flop (didn't bet)
Seat 2: c4851d2c (small blind) folded before Flop
Seat 3: 94afcc3f (big blind) collected ($0.04)
Seat 4: 90db5865 folded before Flop (didn't bet)
Seat 5: 76a11f55 folded before Flop (didn't bet)
Seat 6: 108b6408 folded before Flop (didn't bet)


Poker Hand #RC3811288987: Hold'em No Limit ($0.02/$0.05) - 2025/08/16 13:57:31
Table 'RushAndCash864247' 6-max Seat #1 is the button
Seat 1: 3c2c4bff ($6.86 in chips)
Seat 2: Hero ($15.67 in chips)
Seat 3: ff147aa2 ($6.99 in chips)
Seat 4: 2412a8a4 ($11.33 in chips)
Seat 5: c036491e ($5 in chips)
Seat 6: dfd89234 ($5 in chips)
Hero: posts small blind $0.02
ff147aa2: posts big blind $0.05
*** HOLE CARDS ***
Dealt to 3c2c4bff 
Dealt to Hero [3h Qs]
Dealt to ff147aa2 
Dealt to 2412a8a4 
Dealt to c036491e 
Dealt to dfd89234 
2412a8a4: folds
c036491e: folds
dfd89234: raises $0.05 to $0.1
3c2c4bff: folds
Hero: folds
ff147aa2: calls $0.05
*** FLOP *** [7h Qh 8c]
ff147aa2: checks
dfd89234: bets $0.1
ff147aa2: folds
Uncalled bet ($0.1) returned to dfd89234
*** SHOWDOWN ***
dfd89234 collected $0.21 from pot
*** SUMMARY ***
Total pot $0.22 | Rake $0.01 | Jackpot $0 | Bingo $0 | Fortune $0 | Tax $0
Board [7h Qh 8c]
Seat 1: 3c2c4bff (button) folded before Flop (didn't bet)
Seat 2: Hero (small blind) folded before Flop
Seat 3: ff147aa2 (big blind) folded on the Flop
Seat 4: 2412a8a4 folded before Flop (didn't bet)
Seat 5: c036491e folded before Flop (didn't bet)
Seat 6: dfd89234 won ($0.21)


Poker Hand #RC3811288971: Hold'em No Limit ($0.02/$0.05) - 2025/08/16 13:57:27
Table 'RushAndCash864231' 6-max Seat #1 is the button
Seat 1: 41c92275 ($6.34 in chips)
Seat 2: e65c5e52 ($5.34 in chips)
Seat 3: db318243 ($5.3 in chips)
Seat 4: c923a998 ($8.04 in chips)
Seat 5: d5a856e7 ($5 in chips)
Seat 6: Hero ($15.67 in chips)
e65c5e52: posts small blind $0.02
db318243: posts big blind $0.05
*** HOLE CARDS ***
Dealt to 41c92275 
Dealt to e65c5e52 
Dealt to db318243 
Dealt to c923a998 
Dealt to d5a856e7 
Dealt to Hero [6d 7s]
c923a998: folds
d5a856e7: folds
Hero: folds
41c92275: folds
e65c5e52: folds
Uncalled bet ($0.03) returned to db318243
*** SHOWDOWN ***
db318243 collected $0.04 from pot
*** SUMMARY ***
Total pot $0.04 | Rake $0 | Jackpot $0 | Bingo $0 | Fortune $0 | Tax $0
Seat 1: 41c92275 (button) folded before Flop (didn't bet)
Seat 2: e65c5e52 (small blind) folded before Flop
Seat 3: db318243 (big blind) collected ($0.04)
Seat 4: c923a998 folded before Flop (didn't bet)
Seat 5: d5a856e7 folded before Flop (didn't bet)
Seat 6: Hero folded before Flop (didn't bet)


Poker Hand #RC3811288952: Hold'em No Limit ($0.02/$0.05) - 2025/08/16 13:57:24
Table 'RushAndCash864212' 6-max Seat #1 is the button
Seat 1: cb8db60e ($6.02 in chips)
Seat 2: db318243 ($5.32 in chips)
Seat 3: fcc3bb7d ($5 in chips)
Seat 4: 9d39f851 ($5 in chips)
Seat 5: 130fb066 ($5 in chips)
Seat 6: Hero ($15.67 in chips)
db318243: posts small blind $0.02
fcc3bb7d: posts big blind $0.05
*** HOLE CARDS ***
Dealt to cb8db60e 
Dealt to db318243 
Dealt to fcc3bb7d 
Dealt to 9d39f851 
Dealt to 130fb066 
Dealt to Hero [5d 4h]
9d39f851: folds
130fb066: folds
Hero: folds
cb8db60e: folds
db318243: folds
Uncalled bet ($0.03) returned to fcc3bb7d
*** SHOWDOWN ***
fcc3bb7d collected $0.04 from pot
*** SUMMARY ***
Total pot $0.04 | Rake $0 | Jackpot $0 | Bingo $0 | Fortune $0 | Tax $0
Seat 1: cb8db60e (button) folded before Flop (didn't bet)
Seat 2: db318243 (small blind) folded before Flop
Seat 3: fcc3bb7d (big blind) collected ($0.04)
Seat 4: 9d39f851 folded before Flop (didn't bet)
Seat 5: 130fb066 folded before Flop (didn't bet)
Seat 6: Hero folded before Flop (didn't bet)


Poker Hand #RC3811288909: Hold'em No Limit ($0.02/$0.05) - 2025/08/16 13:57:15
Table 'RushAndCash864169' 6-max Seat #1 is the button
Seat 1: Hero ($15.67 in chips)
Seat 2: 1b34b380 ($11.65 in chips)
Seat 3: ccf13b30 ($12.02 in chips)
Seat 4: c31e283f ($6.29 in chips)
Seat 5: f6b37fae ($1.95 in chips)
Seat 6: ceb78569 ($4 in chips)
1b34b380: posts small blind $0.02
ccf13b30: posts big blind $0.05
*** HOLE CARDS ***
Dealt to Hero [5c 9h]
Dealt to 1b34b380 
Dealt to ccf13b30 
Dealt to c31e283f 
Dealt to f6b37fae 
Dealt to ceb78569 
c31e283f: folds
f6b37fae: raises $0.05 to $0.1
ceb78569: folds
Hero: folds
1b34b380: folds
ccf13b30: folds
Uncalled bet ($0.05) returned to f6b37fae
*** SHOWDOWN ***
f6b37fae collected $0.12 from pot
*** SUMMARY ***
Total pot $0.12 | Rake $0 | Jackpot $0 | Bingo $0 | Fortune $0 | Tax $0
Seat 1: Hero (button) folded before Flop (didn't bet)
Seat 2: 1b34b380 (small blind) folded before Flop
Seat 3: ccf13b30 (big blind) folded before Flop
Seat 4: c31e283f folded before Flop (didn't bet)
Seat 5: f6b37fae collected ($0.12)
Seat 6: ceb78569 folded before Flop (didn't bet)


Poker Hand #RC3811288888: Hold'em No Limit ($0.02/$0.05) - 2025/08/16 13:57:12
Table 'RushAndCash864148' 6-max Seat #1 is the button
Seat 1: Hero ($15.67 in chips)
Seat 2: c923a998 ($8.06 in chips)
Seat 3: 51b49e46 ($5 in chips)
Seat 4: b3b554ce ($5.25 in chips)
Seat 5: 8f7e8e2d ($5.44 in chips)
Seat 6: 37795d36 ($5.72 in chips)
c923a998: posts small blind $0.02
51b49e46: posts big blind $0.05
*** HOLE CARDS ***
Dealt to Hero [5s 9d]
Dealt to c923a998 
Dealt to 51b49e46 
Dealt to b3b554ce 
Dealt to 8f7e8e2d 
Dealt to 37795d36 
b3b554ce: folds
8f7e8e2d: folds
37795d36: raises $0.05 to $0.1
Hero: folds
c923a998: folds
51b49e46: folds
Uncalled bet ($0.05) returned to 37795d36
*** SHOWDOWN ***
37795d36 collected $0.12 from pot
*** SUMMARY ***
Total pot $0.12 | Rake $0 | Jackpot $0 | Bingo $0 | Fortune $0 | Tax $0
Seat 1: Hero (button) folded before Flop (didn't bet)
Seat 2: c923a998 (small blind) folded before Flop
Seat 3: 51b49e46 (big blind) folded before Flop
Seat 4: b3b554ce folded before Flop (didn't bet)
Seat 5: 8f7e8e2d folded before Flop (didn't bet)
Seat 6: 37795d36 collected ($0.12)


Poker Hand #RC3811288848: Hold'em No Limit ($0.02/$0.05) - 2025/08/16 13:57:03
Table 'RushAndCash864108' 6-max Seat #1 is the button
Seat 1: 75a945c ($5.85 in chips)
Seat 2: Hero ($15.69 in chips)
Seat 3: 745a5d64 ($6.99 in chips)
Seat 4: 33810466 ($5.7 in chips)
Seat 5: 3ba637cb ($7.97 in chips)
Seat 6: b3b554ce ($5.25 in chips)
Hero: posts small blind $0.02
745a5d64: posts big blind $0.05
*** HOLE CARDS ***
Dealt to 75a945c 
Dealt to Hero [Ah 3s]
Dealt to 745a5d64 
Dealt to 33810466 
Dealt to 3ba637cb 
Dealt to b3b554ce 
33810466: folds
3ba637cb: raises $0.1 to $0.15
b3b554ce: folds
75a945c: folds
Hero: folds
745a5d64: folds
Uncalled bet ($0.1) returned to 3ba637cb
*** SHOWDOWN ***
3ba637cb collected $0.12 from pot
*** SUMMARY ***
Total pot $0.12 | Rake $0 | Jackpot $0 | Bingo $0 | Fortune $0 | Tax $0
Seat 1: 75a945c (button) folded before Flop (didn't bet)
Seat 2: Hero (small blind) folded before Flop
Seat 3: 745a5d64 (big blind) folded before Flop
Seat 4: 33810466 folded before Flop (didn't bet)
Seat 5: 3ba637cb collected ($0.12)
Seat 6: b3b554ce folded before Flop (didn't bet)


Poker Hand #RC3811288790: Hold'em No Limit ($0.02/$0.05) - 2025/08/16 13:56:50
Table 'RushAndCash864050' 6-max Seat #1 is the button
Seat 1: fffa937b ($5.44 in chips)
Seat 2: bf5d4747 ($5 in chips)
Seat 3: Hero ($15.74 in chips)
Seat 4: 3c2c4bff ($6.93 in chips)
Seat 5: fc90aecc ($6.79 in chips)
Seat 6: cda1ccc8 ($9.4 in chips)
bf5d4747: posts small blind $0.02
Hero: posts big blind $0.05
*** HOLE CARDS ***
Dealt to fffa937b 
Dealt to bf5d4747 
Dealt to Hero [8s Kd]
Dealt to 3c2c4bff 
Dealt to fc90aecc 
Dealt to cda1ccc8 
3c2c4bff: folds
fc90aecc: folds
cda1ccc8: folds
fffa937b: raises $0.05 to $0.1
bf5d4747: folds
Hero: folds
Uncalled bet ($0.05) returned to fffa937b
*** SHOWDOWN ***
fffa937b collected $0.12 from pot
*** SUMMARY ***
Total pot $0.12 | Rake $0 | Jackpot $0 | Bingo $0 | Fortune $0 | Tax $0
Seat 1: fffa937b (button) collected ($0.12)
Seat 2: bf5d4747 (small blind) folded before Flop
Seat 3: Hero (big blind) folded before Flop
Seat 4: 3c2c4bff folded before Flop (didn't bet)
Seat 5: fc90aecc folded before Flop (didn't bet)
Seat 6: cda1ccc8 folded before Flop (didn't bet)


Poker Hand #RC3811288774: Hold'em No Limit ($0.02/$0.05) - 2025/08/16 13:56:47
Table 'RushAndCash864034' 6-max Seat #1 is the button
Seat 1: df9acea2 ($5.26 in chips)
Seat 2: 83b0adf7 ($5.57 in chips)
Seat 3: 5153266b ($5.18 in chips)
Seat 4: Hero ($15.74 in chips)
Seat 5: e6e1a23a ($7.84 in chips)
Seat 6: c09afc51 ($11.07 in chips)
83b0adf7: posts small blind $0.02
5153266b: posts big blind $0.05
*** HOLE CARDS ***
Dealt to df9acea2 
Dealt to 83b0adf7 
Dealt to 5153266b 
Dealt to Hero [Kd 2d]
Dealt to e6e1a23a 
Dealt to c09afc51 
Hero: folds
e6e1a23a: folds
c09afc51: folds
df9acea2: folds
83b0adf7: folds
Uncalled bet ($0.03) returned to 5153266b
*** SHOWDOWN ***
5153266b collected $0.04 from pot
*** SUMMARY ***
Total pot $0.04 | Rake $0 | Jackpot $0 | Bingo $0 | Fortune $0 | Tax $0
Seat 1: df9acea2 (button) folded before Flop (didn't bet)
Seat 2: 83b0adf7 (small blind) folded before Flop
Seat 3: 5153266b (big blind) collected ($0.04)
Seat 4: Hero folded before Flop (didn't bet)
Seat 5: e6e1a23a folded before Flop (didn't bet)
Seat 6: c09afc51 folded before Flop (didn't bet)


Poker Hand #RC3811288757: Hold'em No Limit ($0.02/$0.05) - 2025/08/16 13:56:43
Table 'RushAndCash864017' 6-max Seat #1 is the button
Seat 1: b006f9d4 ($5.98 in chips)
Seat 2: 4238d3f9 ($6.03 in chips)
Seat 3: e79e3465 ($5.56 in chips)
Seat 4: 197f74b5 ($6.72 in chips)
Seat 5: 6b0663c4 ($5.32 in chips)
Seat 6: Hero ($15.74 in chips)
4238d3f9: posts small blind $0.02
e79e3465: posts big blind $0.05
*** HOLE CARDS ***
Dealt to b006f9d4 
Dealt to 4238d3f9 
Dealt to e79e3465 
Dealt to 197f74b5 
Dealt to 6b0663c4 
Dealt to Hero [Ah 6s]
197f74b5: folds
6b0663c4: folds
Hero: folds
b006f9d4: raises $0.08 to $0.13
4238d3f9: raises $0.37 to $0.5
e79e3465: folds
b006f9d4: folds
Uncalled bet ($0.37) returned to 4238d3f9
*** SHOWDOWN ***
4238d3f9 collected $0.3 from pot
*** SUMMARY ***
Total pot $0.31 | Rake $0.01 | Jackpot $0 | Bingo $0 | Fortune $0 | Tax $0
Seat 1: b006f9d4 (button) folded before Flop
Seat 2: 4238d3f9 (small blind) collected ($0.3)
Seat 3: e79e3465 (big blind) folded before Flop
Seat 4: 197f74b5 folded before Flop (didn't bet)
Seat 5: 6b0663c4 folded before Flop (didn't bet)
Seat 6: Hero folded before Flop (didn't bet)


Poker Hand #RC3811288502: Hold'em No Limit ($0.02/$0.05) - 2025/08/16 13:55:50
Table 'RushAndCash863762' 6-max Seat #1 is the button
Seat 1: 197f74b5 ($5.1 in chips)
Seat 2: Hero ($17.53 in chips)
Seat 3: a2af6671 ($5.65 in chips)
Seat 4: 8076250f ($7.29 in chips)
Seat 5: ccb367a6 ($7.22 in chips)
Seat 6: edeef0b6 ($5.37 in chips)
Hero: posts small blind $0.02
a2af6671: posts big blind $0.05
*** HOLE CARDS ***
Dealt to 197f74b5 
Dealt to Hero [5c 6c]
Dealt to a2af6671 
Dealt to 8076250f 
Dealt to ccb367a6 
Dealt to edeef0b6 
8076250f: folds
ccb367a6: folds
edeef0b6: folds
197f74b5: raises $0.08 to $0.13
Hero: raises $0.08 to $0.21
a2af6671: folds
197f74b5: raises $0.16 to $0.37
Hero: calls $0.16
*** FLOP *** [Qd 3d Kd]
Hero: bets $0.05
197f74b5: raises $0.23 to $0.28
Hero: raises $1.14 to $1.42
197f74b5: raises $1.14 to $2.56
Hero: folds
Uncalled bet ($1.14) returned to 197f74b5
*** SHOWDOWN ***
197f74b5 collected $3.41 from pot
*** SUMMARY ***
Total pot $3.63 | Rake $0.15 | Jackpot $0.07 | Bingo $0 | Fortune $0 | Tax $0
Board [Qd 3d Kd]
Seat 1: 197f74b5 (button) won ($3.41)
Seat 2: Hero (small blind) folded on the Flop
Seat 3: a2af6671 (big blind) folded before Flop
Seat 4: 8076250f folded before Flop (didn't bet)
Seat 5: ccb367a6 folded before Flop (didn't bet)
Seat 6: edeef0b6 folded before Flop (didn't bet)


Poker Hand #RC3811288489: Hold'em No Limit ($0.02/$0.05) - 2025/08/16 13:55:46
Table 'RushAndCash863749' 6-max Seat #1 is the button
Seat 1: 48d5583 ($6.17 in chips)
Seat 2: 304edd6a ($5.87 in chips)
Seat 3: Hero ($17.58 in chips)
Seat 4: 8076250f ($7.29 in chips)
Seat 5: 77637562 ($5.79 in chips)
Seat 6: 9e00d057 ($5.44 in chips)
304edd6a: posts small blind $0.02
Hero: posts big blind $0.05
*** HOLE CARDS ***
Dealt to 48d5583 
Dealt to 304edd6a 
Dealt to Hero [4c 9s]
Dealt to 8076250f 
Dealt to 77637562 
Dealt to 9e00d057 
8076250f: folds
77637562: folds
9e00d057: raises $0.06 to $0.11
48d5583: folds
304edd6a: folds
Hero: folds
Uncalled bet ($0.06) returned to 9e00d057
*** SHOWDOWN ***
9e00d057 collected $0.12 from pot
*** SUMMARY ***
Total pot $0.12 | Rake $0 | Jackpot $0 | Bingo $0 | Fortune $0 | Tax $0
Seat 1: 48d5583 (button) folded before Flop (didn't bet)
Seat 2: 304edd6a (small blind) folded before Flop
Seat 3: Hero (big blind) folded before Flop
Seat 4: 8076250f folded before Flop (didn't bet)
Seat 5: 77637562 folded before Flop (didn't bet)
Seat 6: 9e00d057 collected ($0.12)


Poker Hand #RC3811288473: Hold'em No Limit ($0.02/$0.05) - 2025/08/16 13:55:43
Table 'RushAndCash863733' 6-max Seat #1 is the button
Seat 1: d1414690 ($5.29 in chips)
Seat 2: ff147aa2 ($6.89 in chips)
Seat 3: 3014992f ($7.22 in chips)
Seat 4: 48d5583 ($6.17 in chips)
Seat 5: b7d6c1a5 ($9.55 in chips)
Seat 6: Hero ($17.58 in chips)
ff147aa2: posts small blind $0.02
3014992f: posts big blind $0.05
*** HOLE CARDS ***
Dealt to d1414690 
Dealt to ff147aa2 
Dealt to 3014992f 
Dealt to 48d5583 
Dealt to b7d6c1a5 
Dealt to Hero [Ah 6s]
48d5583: folds
b7d6c1a5: folds
Hero: folds
d1414690: raises $0.05 to $0.1
ff147aa2: folds
3014992f: folds
Uncalled bet ($0.05) returned to d1414690
*** SHOWDOWN ***
d1414690 collected $0.12 from pot
*** SUMMARY ***
Total pot $0.12 | Rake $0 | Jackpot $0 | Bingo $0 | Fortune $0 | Tax $0
Seat 1: d1414690 (button) collected ($0.12)
Seat 2: ff147aa2 (small blind) folded before Flop
Seat 3: 3014992f (big blind) folded before Flop
Seat 4: 48d5583 folded before Flop (didn't bet)
Seat 5: b7d6c1a5 folded before Flop (didn't bet)
Seat 6: Hero folded before Flop (didn't bet)


Poker Hand #RC3811288455: Hold'em No Limit ($0.02/$0.05) - 2025/08/16 13:55:39
Table 'RushAndCash863715' 6-max Seat #1 is the button
Seat 1: 3e0919a ($5.66 in chips)
Seat 2: 834f0d09 ($5.19 in chips)
Seat 3: 10d871b9 ($7.87 in chips)
Seat 4: Hero ($17.58 in chips)
Seat 5: 43a9ac7f ($6.29 in chips)
Seat 6: c923a998 ($7.88 in chips)
834f0d09: posts small blind $0.02
10d871b9: posts big blind $0.05
*** HOLE CARDS ***
Dealt to 3e0919a 
Dealt to 834f0d09 
Dealt to 10d871b9 
Dealt to Hero [8d 2c]
Dealt to 43a9ac7f 
Dealt to c923a998 
Hero: folds
43a9ac7f: folds
c923a998: folds
3e0919a: folds
834f0d09: raises $0.05 to $0.1
10d871b9: calls $0.05
*** FLOP *** [Ks Ad 7h]
834f0d09: bets $0.07
10d871b9: calls $0.07
*** TURN *** [Ks Ad 7h] [8c]
834f0d09: bets $0.4
10d871b9: folds
Uncalled bet ($0.4) returned to 834f0d09
*** SHOWDOWN ***
834f0d09 collected $0.33 from pot
*** SUMMARY ***
Total pot $0.34 | Rake $0.01 | Jackpot $0 | Bingo $0 | Fortune $0 | Tax $0
Board [Ks Ad 7h 8c]
Seat 1: 3e0919a (button) folded before Flop (didn't bet)
Seat 2: 834f0d09 (small blind) won ($0.33)
Seat 3: 10d871b9 (big blind) folded on the Turn
Seat 4: Hero folded before Flop (didn't bet)
Seat 5: 43a9ac7f folded before Flop (didn't bet)
Seat 6: c923a998 folded before Flop (didn't bet)


Poker Hand #RC3811288110: Hold'em No Limit ($0.02/$0.05) - 2025/08/16 13:54:19
Table 'RushAndCash863370' 6-max Seat #1 is the button
Seat 1: Hero ($17.12 in chips)
Seat 2: c923a998 ($8.33 in chips)
Seat 3: 9fc2ba60 ($5 in chips)
Seat 4: 47ae55d1 ($12.43 in chips)
Seat 5: d6982f15 ($6.23 in chips)
Seat 6: b79dccc7 ($6.35 in chips)
c923a998: posts small blind $0.02
9fc2ba60: posts big blind $0.05
*** HOLE CARDS ***
Dealt to Hero [Jd 8d]
Dealt to c923a998 
Dealt to 9fc2ba60 
Dealt to 47ae55d1 
Dealt to d6982f15 
Dealt to b79dccc7 
47ae55d1: folds
d6982f15: folds
b79dccc7: folds
Hero: raises $0.05 to $0.1
c923a998: raises $0.35 to $0.45
9fc2ba60: folds
Hero: calls $0.35
*** FLOP *** [2d 4c Kd]
c923a998: checks
Hero: bets $0.75
c923a998: folds
Uncalled bet ($0.75) returned to Hero
*** SHOWDOWN ***
Hero collected $0.91 from pot
*** SUMMARY ***
Total pot $0.95 | Rake $0.04 | Jackpot $0 | Bingo $0 | Fortune $0 | Tax $0
Board [2d 4c Kd]
Seat 1: Hero (button) won ($0.91)
Seat 2: c923a998 (small blind) folded on the Flop
Seat 3: 9fc2ba60 (big blind) folded before Flop
Seat 4: 47ae55d1 folded before Flop (didn't bet)
Seat 5: d6982f15 folded before Flop (didn't bet)
Seat 6: b79dccc7 folded before Flop (didn't bet)


Poker Hand #RC3811288089: Hold'em No Limit ($0.02/$0.05) - 2025/08/16 13:54:14
Table 'RushAndCash863349' 6-max Seat #1 is the button
Seat 1: 11490e3f ($7.12 in chips)
Seat 2: d6982f15 ($6.25 in chips)
Seat 3: 1ce9f29d ($8.88 in chips)
Seat 4: c701c942 ($6.9 in chips)
Seat 5: c923a998 ($8.33 in chips)
Seat 6: Hero ($17.12 in chips)
d6982f15: posts small blind $0.02
1ce9f29d: posts big blind $0.05
*** HOLE CARDS ***
Dealt to 11490e3f 
Dealt to d6982f15 
Dealt to 1ce9f29d 
Dealt to c701c942 
Dealt to c923a998 
Dealt to Hero [4d 6h]
c701c942: folds
c923a998: folds
Hero: folds
11490e3f: folds
d6982f15: folds
Uncalled bet ($0.03) returned to 1ce9f29d
*** SHOWDOWN ***
1ce9f29d collected $0.04 from pot
*** SUMMARY ***
Total pot $0.04 | Rake $0 | Jackpot $0 | Bingo $0 | Fortune $0 | Tax $0
Seat 1: 11490e3f (button) folded before Flop (didn't bet)
Seat 2: d6982f15 (small blind) folded before Flop
Seat 3: 1ce9f29d (big blind) collected ($0.04)
Seat 4: c701c942 folded before Flop (didn't bet)
Seat 5: c923a998 folded before Flop (didn't bet)
Seat 6: Hero folded before Flop (didn't bet)


Poker Hand #RC3811287895: Hold'em No Limit ($0.02/$0.05) - 2025/08/16 13:53:31
Table 'RushAndCash863155' 6-max Seat #1 is the button
Seat 1: 7dec114f ($8.12 in chips)
Seat 2: 11490e3f ($6.05 in chips)
Seat 3: Hero ($18.38 in chips)
Seat 4: a6467606 ($5.21 in chips)
Seat 5: 1699364e ($12.35 in chips)
Seat 6: 2f05e2fb ($5 in chips)
11490e3f: posts small blind $0.02
Hero: posts big blind $0.05
*** HOLE CARDS ***
Dealt to 7dec114f 
Dealt to 11490e3f 
Dealt to Hero [Ad Jd]
Dealt to a6467606 
Dealt to 1699364e 
Dealt to 2f05e2fb 
a6467606: folds
1699364e: folds
2f05e2fb: folds
7dec114f: folds
11490e3f: raises $0.08 to $0.13
Hero: calls $0.08
*** FLOP *** [2c 5h 8d]
11490e3f: bets $0.13
Hero: calls $0.13
*** TURN *** [2c 5h 8d] [Qd]
11490e3f: bets $0.39
Hero: raises $0.61 to $1
11490e3f: calls $0.61
*** RIVER *** [2c 5h 8d Qd] [Kc]
11490e3f: checks
Hero: checks
11490e3f: shows [9h Qh] (a pair of Queens)
Hero: shows [Ad Jd] (Ace high)
*** SHOWDOWN ***
11490e3f collected $2.33 from pot
*** SUMMARY ***
Total pot $2.52 | Rake $0.12 | Jackpot $0.07 | Bingo $0 | Fortune $0 | Tax $0
Board [2c 5h 8d Qd Kc]
Seat 1: 7dec114f (button) folded before Flop (didn't bet)
Seat 2: 11490e3f (small blind) showed [9h Qh] and won ($2.33) with a pair of Queens
Seat 3: Hero (big blind) showed [Ad Jd] and lost with Ace high
Seat 4: a6467606 folded before Flop (didn't bet)
Seat 5: 1699364e folded before Flop (didn't bet)
Seat 6: 2f05e2fb folded before Flop (didn't bet)


Poker Hand #RC3811287628: Hold'em No Limit ($0.02/$0.05) - 2025/08/16 13:52:30
Table 'RushAndCash862888' 6-max Seat #1 is the button
Seat 1: a6467606 ($5 in chips)
Seat 2: 94701484 ($5 in chips)
Seat 3: 3a645dfc ($5.39 in chips)
Seat 4: Hero ($18.53 in chips)
Seat 5: 5e52dcbd ($7.49 in chips)
Seat 6: 38dd435b ($11.81 in chips)
94701484: posts small blind $0.02
3a645dfc: posts big blind $0.05
*** HOLE CARDS ***
Dealt to a6467606 
Dealt to 94701484 
Dealt to 3a645dfc 
Dealt to Hero [Ts Ks]
Dealt to 5e52dcbd 
Dealt to 38dd435b 
Hero: raises $0.05 to $0.1
5e52dcbd: folds
38dd435b: folds
a6467606: raises $0.05 to $0.15
94701484: folds
3a645dfc: folds
Hero: calls $0.05
*** FLOP *** [Td 3h 4d]
Hero: checks
a6467606: checks
*** TURN *** [Td 3h 4d] [8s]
Hero: checks
a6467606: bets $0.5
Hero: folds
Uncalled bet ($0.5) returned to a6467606
*** SHOWDOWN ***
a6467606 collected $0.36 from pot
*** SUMMARY ***
Total pot $0.37 | Rake $0.01 | Jackpot $0 | Bingo $0 | Fortune $0 | Tax $0
Board [Td 3h 4d 8s]
Seat 1: a6467606 (button) won ($0.36)
Seat 2: 94701484 (small blind) folded before Flop
Seat 3: 3a645dfc (big blind) folded before Flop
Seat 4: Hero folded on the Turn
Seat 5: 5e52dcbd folded before Flop (didn't bet)
Seat 6: 38dd435b folded before Flop (didn't bet)


Poker Hand #RC3811287611: Hold'em No Limit ($0.02/$0.05) - 2025/08/16 13:52:27
Table 'RushAndCash862871' 6-max Seat #1 is the button
Seat 1: 48e9176f ($22.09 in chips)
Seat 2: 3e0919a ($1.71 in chips)
Seat 3: 94701484 ($5.04 in chips)
Seat 4: Hero ($18.53 in chips)
Seat 5: 1b843684 ($4.72 in chips)
Seat 6: e0a0e5cd ($11.06 in chips)
3e0919a: posts small blind $0.02
94701484: posts big blind $0.05
*** HOLE CARDS ***
Dealt to 48e9176f 
Dealt to 3e0919a 
Dealt to 94701484 
Dealt to Hero [8h Qs]
Dealt to 1b843684 
Dealt to e0a0e5cd 
Hero: folds
1b843684: raises $0.05 to $0.1
e0a0e5cd: folds
48e9176f: folds
3e0919a: folds
94701484: folds
Uncalled bet ($0.05) returned to 1b843684
*** SHOWDOWN ***
1b843684 collected $0.12 from pot
*** SUMMARY ***
Total pot $0.12 | Rake $0 | Jackpot $0 | Bingo $0 | Fortune $0 | Tax $0
Seat 1: 48e9176f (button) folded before Flop (didn't bet)
Seat 2: 3e0919a (small blind) folded before Flop
Seat 3: 94701484 (big blind) folded before Flop
Seat 4: Hero folded before Flop (didn't bet)
Seat 5: 1b843684 collected ($0.12)
Seat 6: e0a0e5cd folded before Flop (didn't bet)


Poker Hand #RC3811287569: Hold'em No Limit ($0.02/$0.05) - 2025/08/16 13:52:17
Table 'RushAndCash862829' 6-max Seat #1 is the button
Seat 1: Hero ($18.53 in chips)
Seat 2: 872c9862 ($12.93 in chips)
Seat 3: 6b644717 ($9.46 in chips)
Seat 4: 455517e0 ($5.86 in chips)
Seat 5: f537abc0 ($5 in chips)
Seat 6: 4fda73cd ($5.49 in chips)
872c9862: posts small blind $0.02
6b644717: posts big blind $0.05
*** HOLE CARDS ***
Dealt to Hero [As 7s]
Dealt to 872c9862 
Dealt to 6b644717 
Dealt to 455517e0 
Dealt to f537abc0 
Dealt to 4fda73cd 
455517e0: raises $0.08 to $0.13
f537abc0: folds
4fda73cd: folds
Hero: folds
872c9862: folds
6b644717: folds
Uncalled bet ($0.08) returned to 455517e0
*** SHOWDOWN ***
455517e0 collected $0.12 from pot
*** SUMMARY ***
Total pot $0.12 | Rake $0 | Jackpot $0 | Bingo $0 | Fortune $0 | Tax $0
Seat 1: Hero (button) folded before Flop (didn't bet)
Seat 2: 872c9862 (small blind) folded before Flop
Seat 3: 6b644717 (big blind) folded before Flop
Seat 4: 455517e0 collected ($0.12)
Seat 5: f537abc0 folded before Flop (didn't bet)
Seat 6: 4fda73cd folded before Flop (didn't bet)


Poker Hand #RC3811287512: Hold'em No Limit ($0.02/$0.05) - 2025/08/16 13:52:05
Table 'RushAndCash862772' 6-max Seat #1 is the button
Seat 1: Hero ($18.46 in chips)
Seat 2: 7dec114f ($5.72 in chips)
Seat 3: 40c391c8 ($4.25 in chips)
Seat 4: 29f07c5 ($16.2 in chips)
Seat 5: 41c92275 ($7.42 in chips)
Seat 6: 70981ed ($5.17 in chips)
7dec114f: posts small blind $0.02
40c391c8: posts big blind $0.05
*** HOLE CARDS ***
Dealt to Hero [6h 4h]
Dealt to 7dec114f 
Dealt to 40c391c8 
Dealt to 29f07c5 
Dealt to 41c92275 
Dealt to 70981ed 
29f07c5: folds
41c92275: folds
70981ed: folds
Hero: raises $0.05 to $0.1
7dec114f: folds
40c391c8: folds
Uncalled bet ($0.05) returned to Hero
*** SHOWDOWN ***
Hero collected $0.12 from pot
*** SUMMARY ***
Total pot $0.12 | Rake $0 | Jackpot $0 | Bingo $0 | Fortune $0 | Tax $0
Seat 1: Hero (button) collected ($0.12)
Seat 2: 7dec114f (small blind) folded before Flop
Seat 3: 40c391c8 (big blind) folded before Flop
Seat 4: 29f07c5 folded before Flop (didn't bet)
Seat 5: 41c92275 folded before Flop (didn't bet)
Seat 6: 70981ed folded before Flop (didn't bet)


Poker Hand #RC3811287476: Hold'em No Limit ($0.02/$0.05) - 2025/08/16 13:51:57
Table 'RushAndCash862736' 6-max Seat #1 is the button
Seat 1: 3d0999e5 ($4.5 in chips)
Seat 2: Hero ($18.48 in chips)
Seat 3: a2af6671 ($5.78 in chips)
Seat 4: 225abea7 ($6.59 in chips)
Seat 5: 1ce9f29d ($8.97 in chips)
Seat 6: 11584718 ($8.44 in chips)
Hero: posts small blind $0.02
a2af6671: posts big blind $0.05
*** HOLE CARDS ***
Dealt to 3d0999e5 
Dealt to Hero [9h Js]
Dealt to a2af6671 
Dealt to 225abea7 
Dealt to 1ce9f29d 
Dealt to 11584718 
225abea7: folds
1ce9f29d: folds
11584718: folds
3d0999e5: raises $0.08 to $0.13
Hero: folds
a2af6671: folds
Uncalled bet ($0.08) returned to 3d0999e5
*** SHOWDOWN ***
3d0999e5 collected $0.12 from pot
*** SUMMARY ***
Total pot $0.12 | Rake $0 | Jackpot $0 | Bingo $0 | Fortune $0 | Tax $0
Seat 1: 3d0999e5 (button) collected ($0.12)
Seat 2: Hero (small blind) folded before Flop
Seat 3: a2af6671 (big blind) folded before Flop
Seat 4: 225abea7 folded before Flop (didn't bet)
Seat 5: 1ce9f29d folded before Flop (didn't bet)
Seat 6: 11584718 folded before Flop (didn't bet)


Poker Hand #RC3811287461: Hold'em No Limit ($0.02/$0.05) - 2025/08/16 13:51:54
Table 'RushAndCash862721' 6-max Seat #1 is the button
Seat 1: e3772412 ($5 in chips)
Seat 2: c0d1f133 ($6.86 in chips)
Seat 3: dce7f224 ($22.85 in chips)
Seat 4: Hero ($18.48 in chips)
Seat 5: 18ac57a5 ($5.71 in chips)
Seat 6: 9c466e0e ($6 in chips)
c0d1f133: posts small blind $0.02
dce7f224: posts big blind $0.05
*** HOLE CARDS ***
Dealt to e3772412 
Dealt to c0d1f133 
Dealt to dce7f224 
Dealt to Hero [5c Jd]
Dealt to 18ac57a5 
Dealt to 9c466e0e 
Hero: folds
18ac57a5: folds
9c466e0e: folds
e3772412: folds
c0d1f133: calls $0.03
dce7f224: checks
*** FLOP *** [3c Jc 8s]
c0d1f133: bets $0.05
dce7f224: folds
Uncalled bet ($0.05) returned to c0d1f133
*** SHOWDOWN ***
c0d1f133 collected $0.1 from pot
*** SUMMARY ***
Total pot $0.1 | Rake $0 | Jackpot $0 | Bingo $0 | Fortune $0 | Tax $0
Board [3c Jc 8s]
Seat 1: e3772412 (button) folded before Flop (didn't bet)
Seat 2: c0d1f133 (small blind) won ($0.1)
Seat 3: dce7f224 (big blind) folded on the Flop
Seat 4: Hero folded before Flop (didn't bet)
Seat 5: 18ac57a5 folded before Flop (didn't bet)
Seat 6: 9c466e0e folded before Flop (didn't bet)


Poker Hand #RC3811287442: Hold'em No Limit ($0.02/$0.05) - 2025/08/16 13:51:50
Table 'RushAndCash862702' 6-max Seat #1 is the button
Seat 1: dc4b476b ($6.62 in chips)
Seat 2: 5c5f6f86 ($16.13 in chips)
Seat 3: ebfca2f0 ($5.5 in chips)
Seat 4: 7dec114f ($5.77 in chips)
Seat 5: Hero ($18.48 in chips)
Seat 6: 80347999 ($1.92 in chips)
5c5f6f86: posts small blind $0.02
ebfca2f0: posts big blind $0.05
*** HOLE CARDS ***
Dealt to dc4b476b 
Dealt to 5c5f6f86 
Dealt to ebfca2f0 
Dealt to 7dec114f 
Dealt to Hero [4d 9s]
Dealt to 80347999 
7dec114f: folds
Hero: folds
80347999: folds
dc4b476b: folds
5c5f6f86: raises $0.05 to $0.1
ebfca2f0: raises $0.2 to $0.3
5c5f6f86: calls $0.2
*** FLOP *** [2d 6c Jc]
5c5f6f86: checks
ebfca2f0: checks
*** TURN *** [2d 6c Jc] [7h]
5c5f6f86: bets $0.2
ebfca2f0: raises $0.45 to $0.65
5c5f6f86: calls $0.45
*** RIVER *** [2d 6c Jc 7h] [Ks]
5c5f6f86: checks
ebfca2f0: bets $0.86
5c5f6f86: folds
Uncalled bet ($0.86) returned to ebfca2f0
*** SHOWDOWN ***
ebfca2f0 collected $1.74 from pot
*** SUMMARY ***
Total pot $1.9 | Rake $0.09 | Jackpot $0.07 | Bingo $0 | Fortune $0 | Tax $0
Board [2d 6c Jc 7h Ks]
Seat 1: dc4b476b (button) folded before Flop (didn't bet)
Seat 2: 5c5f6f86 (small blind) folded on the River
Seat 3: ebfca2f0 (big blind) won ($1.74)
Seat 4: 7dec114f folded before Flop (didn't bet)
Seat 5: Hero folded before Flop (didn't bet)
Seat 6: 80347999 folded before Flop (didn't bet)


Poker Hand #RC3811287421: Hold'em No Limit ($0.02/$0.05) - 2025/08/16 13:51:46
Table 'RushAndCash862681' 6-max Seat #1 is the button
Seat 1: db318243 ($5 in chips)
Seat 2: 197f74b5 ($5.43 in chips)
Seat 3: 175b5c79 ($6.14 in chips)
Seat 4: 55ba361c ($5 in chips)
Seat 5: Hero ($18.48 in chips)
Seat 6: dc4b476b ($6.62 in chips)
197f74b5: posts small blind $0.02
175b5c79: posts big blind $0.05
*** HOLE CARDS ***
Dealt to db318243 
Dealt to 197f74b5 
Dealt to 175b5c79 
Dealt to 55ba361c 
Dealt to Hero [7c 9h]
Dealt to dc4b476b 
55ba361c: raises $0.05 to $0.1
Hero: folds
dc4b476b: folds
db318243: folds
197f74b5: folds
175b5c79: calls $0.05
*** FLOP *** [9s 8d Qc]
175b5c79: checks
55ba361c: bets $0.11
175b5c79: calls $0.11
*** TURN *** [9s 8d Qc] [As]
175b5c79: checks
55ba361c: bets $0.4
175b5c79: raises $0.62 to $1.02
55ba361c: raises $3.77 to $4.79 and is all-in
175b5c79: calls $3.77
55ba361c: shows [Td Jh] (a straight, Queen to Eight)
175b5c79: shows [9c Qh] (two pair, Queens and Nines)
*** RIVER *** [9s 8d Qc As] [Kh]
*** SHOWDOWN ***
55ba361c collected $9.8 from pot
*** SUMMARY ***
Total pot $10.02 | Rake $0.15 | Jackpot $0.07 | Bingo $0 | Fortune $0 | Tax $0
Board [9s 8d Qc As Kh]
Seat 1: db318243 (button) folded before Flop (didn't bet)
Seat 2: 197f74b5 (small blind) folded before Flop
Seat 3: 175b5c79 (big blind) showed [9c Qh] and lost with two pair, Queens and Nines
Seat 4: 55ba361c showed [Td Jh] and won ($9.8) with a straight, Ace to Ten
Seat 5: Hero folded before Flop (didn't bet)
Seat 6: dc4b476b folded before Flop (didn't bet)


Poker Hand #RC3811287402: Hold'em No Limit ($0.02/$0.05) - 2025/08/16 13:51:42
Table 'RushAndCash862662' 6-max Seat #1 is the button
Seat 1: 1ce9f29d ($8.97 in chips)
Seat 2: 495abc44 ($5.54 in chips)
Seat 3: b79dccc7 ($6.45 in chips)
Seat 4: 80347999 ($1.92 in chips)
Seat 5: 8523f7e ($7 in chips)
Seat 6: Hero ($18.48 in chips)
495abc44: posts small blind $0.02
b79dccc7: posts big blind $0.05
*** HOLE CARDS ***
Dealt to 1ce9f29d 
Dealt to 495abc44 
Dealt to b79dccc7 
Dealt to 80347999 
Dealt to 8523f7e 
Dealt to Hero [9s Kd]
80347999: folds
8523f7e: folds
Hero: folds
1ce9f29d: folds
495abc44: raises $0.1 to $0.15
b79dccc7: folds
Uncalled bet ($0.1) returned to 495abc44
*** SHOWDOWN ***
495abc44 collected $0.1 from pot
*** SUMMARY ***
Total pot $0.1 | Rake $0 | Jackpot $0 | Bingo $0 | Fortune $0 | Tax $0
Seat 1: 1ce9f29d (button) folded before Flop (didn't bet)
Seat 2: 495abc44 (small blind) collected ($0.1)
Seat 3: b79dccc7 (big blind) folded before Flop
Seat 4: 80347999 folded before Flop (didn't bet)
Seat 5: 8523f7e folded before Flop (didn't bet)
Seat 6: Hero folded before Flop (didn't bet)


Poker Hand #RC3811287345: Hold'em No Limit ($0.02/$0.05) - 2025/08/16 13:51:31
Table 'RushAndCash862605' 6-max Seat #1 is the button
Seat 1: 52304a28 ($4.72 in chips)
Seat 2: fffa937b ($6.66 in chips)
Seat 3: Hero ($18.46 in chips)
Seat 4: b79dccc7 ($6.47 in chips)
Seat 5: d1595e43 ($3.31 in chips)
Seat 6: 3ccbf3d2 ($5.96 in chips)
fffa937b: posts small blind $0.02
Hero: posts big blind $0.05
*** HOLE CARDS ***
Dealt to 52304a28 
Dealt to fffa937b 
Dealt to Hero [4d Qs]
Dealt to b79dccc7 
Dealt to d1595e43 
Dealt to 3ccbf3d2 
b79dccc7: folds
d1595e43: folds
3ccbf3d2: folds
52304a28: folds
fffa937b: folds
Uncalled bet ($0.03) returned to Hero
*** SHOWDOWN ***
Hero collected $0.04 from pot
*** SUMMARY ***
Total pot $0.04 | Rake $0 | Jackpot $0 | Bingo $0 | Fortune $0 | Tax $0
Seat 1: 52304a28 (button) folded before Flop (didn't bet)
Seat 2: fffa937b (small blind) folded before Flop
Seat 3: Hero (big blind) collected ($0.04)
Seat 4: b79dccc7 folded before Flop (didn't bet)
Seat 5: d1595e43 folded before Flop (didn't bet)
Seat 6: 3ccbf3d2 folded before Flop (didn't bet)


Poker Hand #RC3811287304: Hold'em No Limit ($0.02/$0.05) - 2025/08/16 13:51:22
Table 'RushAndCash862564' 6-max Seat #1 is the button
Seat 1: 570328bb ($6.38 in chips)
Seat 2: Hero ($18.48 in chips)
Seat 3: f2e793b1 ($5.07 in chips)
Seat 4: 1e12b0ac ($4.07 in chips)
Seat 5: 18ac57a5 ($5.69 in chips)
Seat 6: 21582d9 ($5.82 in chips)
Hero: posts small blind $0.02
f2e793b1: posts big blind $0.05
*** HOLE CARDS ***
Dealt to 570328bb 
Dealt to Hero [6d Jh]
Dealt to f2e793b1 
Dealt to 1e12b0ac 
Dealt to 18ac57a5 
Dealt to 21582d9 
1e12b0ac: folds
18ac57a5: folds
21582d9: folds
570328bb: raises $0.05 to $0.1
Hero: folds
f2e793b1: folds
Uncalled bet ($0.05) returned to 570328bb
*** SHOWDOWN ***
570328bb collected $0.12 from pot
*** SUMMARY ***
Total pot $0.12 | Rake $0 | Jackpot $0 | Bingo $0 | Fortune $0 | Tax $0
Seat 1: 570328bb (button) collected ($0.12)
Seat 2: Hero (small blind) folded before Flop
Seat 3: f2e793b1 (big blind) folded before Flop
Seat 4: 1e12b0ac folded before Flop (didn't bet)
Seat 5: 18ac57a5 folded before Flop (didn't bet)
Seat 6: 21582d9 folded before Flop (didn't bet)


Poker Hand #RC3811287060: Hold'em No Limit ($0.02/$0.05) - 2025/08/16 13:50:27
Table 'RushAndCash862320' 6-max Seat #1 is the button
Seat 1: 8b3d6303 ($11.92 in chips)
Seat 2: fc90aecc ($6.93 in chips)
Seat 3: cb8db60e ($6.8 in chips)
Seat 4: 18ac57a5 ($5.86 in chips)
Seat 5: Hero ($18.79 in chips)
Seat 6: f2e793b1 ($4.72 in chips)
fc90aecc: posts small blind $0.02
cb8db60e: posts big blind $0.05
*** HOLE CARDS ***
Dealt to 8b3d6303 
Dealt to fc90aecc 
Dealt to cb8db60e 
Dealt to 18ac57a5 
Dealt to Hero [Jc Ad]
Dealt to f2e793b1 
18ac57a5: folds
Hero: raises $0.05 to $0.1
f2e793b1: raises $0.21 to $0.31
8b3d6303: folds
fc90aecc: folds
cb8db60e: folds
Hero: calls $0.21
*** FLOP *** [8c 7s 4d]
Hero: checks
f2e793b1: bets $0.52
Hero: folds
Uncalled bet ($0.52) returned to f2e793b1
*** SHOWDOWN ***
f2e793b1 collected $0.66 from pot
*** SUMMARY ***
Total pot $0.69 | Rake $0.03 | Jackpot $0 | Bingo $0 | Fortune $0 | Tax $0
Board [8c 7s 4d]
Seat 1: 8b3d6303 (button) folded before Flop (didn't bet)
Seat 2: fc90aecc (small blind) folded before Flop
Seat 3: cb8db60e (big blind) folded before Flop
Seat 4: 18ac57a5 folded before Flop (didn't bet)
Seat 5: Hero folded on the Flop
Seat 6: f2e793b1 won ($0.66)


Poker Hand #RC3811287011: Hold'em No Limit ($0.02/$0.05) - 2025/08/16 13:50:16
Table 'RushAndCash862271' 6-max Seat #1 is the button
Seat 1: Hero ($18.79 in chips)
Seat 2: a0391971 ($10.57 in chips)
Seat 3: 1b2883cb ($6.79 in chips)
Seat 4: 197f74b5 ($5.23 in chips)
Seat 5: ac36b2d5 ($5 in chips)
Seat 6: cf00cabc ($4.34 in chips)
a0391971: posts small blind $0.02
1b2883cb: posts big blind $0.05
*** HOLE CARDS ***
Dealt to Hero [5c 9h]
Dealt to a0391971 
Dealt to 1b2883cb 
Dealt to 197f74b5 
Dealt to ac36b2d5 
Dealt to cf00cabc 
197f74b5: raises $0.1 to $0.15
ac36b2d5: folds
cf00cabc: folds
Hero: folds
a0391971: folds
1b2883cb: folds
Uncalled bet ($0.1) returned to 197f74b5
*** SHOWDOWN ***
197f74b5 collected $0.12 from pot
*** SUMMARY ***
Total pot $0.12 | Rake $0 | Jackpot $0 | Bingo $0 | Fortune $0 | Tax $0
Seat 1: Hero (button) folded before Flop (didn't bet)
Seat 2: a0391971 (small blind) folded before Flop
Seat 3: 1b2883cb (big blind) folded before Flop
Seat 4: 197f74b5 collected ($0.12)
Seat 5: ac36b2d5 folded before Flop (didn't bet)
Seat 6: cf00cabc folded before Flop (didn't bet)


Poker Hand #RC3811286910: Hold'em No Limit ($0.02/$0.05) - 2025/08/16 13:49:53
Table 'RushAndCash862170' 6-max Seat #1 is the button
Seat 1: a2af6671 ($5.83 in chips)
Seat 2: Hero ($18.81 in chips)
Seat 3: 34586de3 ($3.35 in chips)
Seat 4: 319f9ef4 ($5.14 in chips)
Seat 5: dfd89234 ($6.98 in chips)
Seat 6: 43a9ac7f ($5.74 in chips)
Hero: posts small blind $0.02
34586de3: posts big blind $0.05
*** HOLE CARDS ***
Dealt to a2af6671 
Dealt to Hero [4c Qs]
Dealt to 34586de3 
Dealt to 319f9ef4 
Dealt to dfd89234 
Dealt to 43a9ac7f 
319f9ef4: folds
dfd89234: folds
43a9ac7f: raises $0.08 to $0.13
a2af6671: raises $0.25 to $0.38
Hero: folds
34586de3: folds
43a9ac7f: folds
Uncalled bet ($0.25) returned to a2af6671
*** SHOWDOWN ***
a2af6671 collected $0.32 from pot
*** SUMMARY ***
Total pot $0.33 | Rake $0.01 | Jackpot $0 | Bingo $0 | Fortune $0 | Tax $0
Seat 1: a2af6671 (button) collected ($0.32)
Seat 2: Hero (small blind) folded before Flop
Seat 3: 34586de3 (big blind) folded before Flop
Seat 4: 319f9ef4 folded before Flop (didn't bet)
Seat 5: dfd89234 folded before Flop (didn't bet)
Seat 6: 43a9ac7f folded before Flop


Poker Hand #RC3811286843: Hold'em No Limit ($0.02/$0.05) - 2025/08/16 13:49:39
Table 'RushAndCash862103' 6-max Seat #1 is the button
Seat 1: 9a543c48 ($10.6 in chips)
Seat 2: 48d5583 ($5.06 in chips)
Seat 3: Hero ($18.86 in chips)
Seat 4: 9d840439 ($5.09 in chips)
Seat 5: 4ab3551b ($6.15 in chips)
Seat 6: 1b843684 ($5 in chips)
48d5583: posts small blind $0.02
Hero: posts big blind $0.05
*** HOLE CARDS ***
Dealt to 9a543c48 
Dealt to 48d5583 
Dealt to Hero [5d 4h]
Dealt to 9d840439 
Dealt to 4ab3551b 
Dealt to 1b843684 
9d840439: folds
4ab3551b: folds
1b843684: folds
9a543c48: raises $0.06 to $0.11
48d5583: folds
Hero: folds
Uncalled bet ($0.06) returned to 9a543c48
*** SHOWDOWN ***
9a543c48 collected $0.12 from pot
*** SUMMARY ***
Total pot $0.12 | Rake $0 | Jackpot $0 | Bingo $0 | Fortune $0 | Tax $0
Seat 1: 9a543c48 (button) collected ($0.12)
Seat 2: 48d5583 (small blind) folded before Flop
Seat 3: Hero (big blind) folded before Flop
Seat 4: 9d840439 folded before Flop (didn't bet)
Seat 5: 4ab3551b folded before Flop (didn't bet)
Seat 6: 1b843684 folded before Flop (didn't bet)


Poker Hand #RC3811286825: Hold'em No Limit ($0.02/$0.05) - 2025/08/16 13:49:35
Table 'RushAndCash862085' 6-max Seat #1 is the button
Seat 1: 9d840439 ($5.09 in chips)
Seat 2: 435f5d75 ($3.2 in chips)
Seat 3: 6ad839b8 ($9.65 in chips)
Seat 4: Hero ($18.86 in chips)
Seat 5: 871be116 ($3.37 in chips)
Seat 6: 4ba2cf7 ($13.94 in chips)
435f5d75: posts small blind $0.02
6ad839b8: posts big blind $0.05
*** HOLE CARDS ***
Dealt to 9d840439 
Dealt to 435f5d75 
Dealt to 6ad839b8 
Dealt to Hero [6h Qh]
Dealt to 871be116 
Dealt to 4ba2cf7 
Hero: folds
871be116: folds
4ba2cf7: folds
9d840439: folds
435f5d75: folds
Uncalled bet ($0.03) returned to 6ad839b8
*** SHOWDOWN ***
6ad839b8 collected $0.04 from pot
*** SUMMARY ***
Total pot $0.04 | Rake $0 | Jackpot $0 | Bingo $0 | Fortune $0 | Tax $0
Seat 1: 9d840439 (button) folded before Flop (didn't bet)
Seat 2: 435f5d75 (small blind) folded before Flop
Seat 3: 6ad839b8 (big blind) collected ($0.04)
Seat 4: Hero folded before Flop (didn't bet)
Seat 5: 871be116 folded before Flop (didn't bet)
Seat 6: 4ba2cf7 folded before Flop (didn't bet)


Poker Hand #RC3811286783: Hold'em No Limit ($0.02/$0.05) - 2025/08/16 13:49:26
Table 'RushAndCash862043' 6-max Seat #1 is the button
Seat 1: Hero ($18.86 in chips)
Seat 2: b3b554ce ($5 in chips)
Seat 3: 48d5583 ($5.11 in chips)
Seat 4: 85e0a327 ($6 in chips)
Seat 5: 8012acf ($5.31 in chips)
Seat 6: 2955ec2b ($9.03 in chips)
b3b554ce: posts small blind $0.02
48d5583: posts big blind $0.05
*** HOLE CARDS ***
Dealt to Hero [8h Ks]
Dealt to b3b554ce 
Dealt to 48d5583 
Dealt to 85e0a327 
Dealt to 8012acf 
Dealt to 2955ec2b 
85e0a327: folds
8012acf: raises $0.05 to $0.1
2955ec2b: folds
Hero: folds
b3b554ce: folds
48d5583: folds
Uncalled bet ($0.05) returned to 8012acf
*** SHOWDOWN ***
8012acf collected $0.12 from pot
*** SUMMARY ***
Total pot $0.12 | Rake $0 | Jackpot $0 | Bingo $0 | Fortune $0 | Tax $0
Seat 1: Hero (button) folded before Flop (didn't bet)
Seat 2: b3b554ce (small blind) folded before Flop
Seat 3: 48d5583 (big blind) folded before Flop
Seat 4: 85e0a327 folded before Flop (didn't bet)
Seat 5: 8012acf collected ($0.12)
Seat 6: 2955ec2b folded before Flop (didn't bet)


Poker Hand #RC3811286461: Hold'em No Limit ($0.02/$0.05) - 2025/08/16 13:48:15
Table 'RushAndCash861721' 6-max Seat #1 is the button
Seat 1: 930ad1ac ($5.22 in chips)
Seat 2: Hero ($19.18 in chips)
Seat 3: 5e0898f8 ($4.18 in chips)
Seat 4: 1d9664c2 ($3.46 in chips)
Seat 5: f537abc0 ($5.06 in chips)
Seat 6: 2ff313f1 ($7.31 in chips)
Hero: posts small blind $0.02
5e0898f8: posts big blind $0.05
*** HOLE CARDS ***
Dealt to 930ad1ac 
Dealt to Hero [5c 5d]
Dealt to 5e0898f8 
Dealt to 1d9664c2 
Dealt to f537abc0 
Dealt to 2ff313f1 
1d9664c2: folds
f537abc0: folds
2ff313f1: folds
930ad1ac: raises $0.07 to $0.12
Hero: calls $0.1
5e0898f8: calls $0.07
*** FLOP *** [Th 7d 9s]
Hero: checks
5e0898f8: checks
930ad1ac: checks
*** TURN *** [Th 7d 9s] [9c]
Hero: checks
5e0898f8: bets $0.2
930ad1ac: folds
Hero: calls $0.2
*** RIVER *** [Th 7d 9s 9c] [Js]
Hero: checks
5e0898f8: checks
Hero: shows [5c 5d] (two pair, Nines and Fives)
5e0898f8: shows [Ah Ts] (two pair, Tens and Nines)
*** SHOWDOWN ***
5e0898f8 collected $0.73 from pot
*** SUMMARY ***
Total pot $0.76 | Rake $0.03 | Jackpot $0 | Bingo $0 | Fortune $0 | Tax $0
Board [Th 7d 9s 9c Js]
Seat 1: 930ad1ac (button) folded on the Turn
Seat 2: Hero (small blind) showed [5c 5d] and lost with two pair, Nines and Fives
Seat 3: 5e0898f8 (big blind) showed [Ah Ts] and won ($0.73) with two pair, Tens and Nines
Seat 4: 1d9664c2 folded before Flop (didn't bet)
Seat 5: f537abc0 folded before Flop (didn't bet)
Seat 6: 2ff313f1 folded before Flop (didn't bet)


Poker Hand #RC3811286448: Hold'em No Limit ($0.02/$0.05) - 2025/08/16 13:48:11
Table 'RushAndCash861708' 6-max Seat #1 is the button
Seat 1: 3dd958bc ($5.16 in chips)
Seat 2: d92d785f ($5.35 in chips)
Seat 3: 3ad9a194 ($10.87 in chips)
Seat 4: 7bf33a65 ($19.3 in chips)
Seat 5: f537abc0 ($5.06 in chips)
Seat 6: Hero ($19.18 in chips)
d92d785f: posts small blind $0.02
3ad9a194: posts big blind $0.05
*** HOLE CARDS ***
Dealt to 3dd958bc 
Dealt to d92d785f 
Dealt to 3ad9a194 
Dealt to 7bf33a65 
Dealt to f537abc0 
Dealt to Hero [7c Tc]
7bf33a65: folds
f537abc0: folds
Hero: folds
3dd958bc: raises $0.08 to $0.13
d92d785f: folds
3ad9a194: folds
Uncalled bet ($0.08) returned to 3dd958bc
*** SHOWDOWN ***
3dd958bc collected $0.12 from pot
*** SUMMARY ***
Total pot $0.12 | Rake $0 | Jackpot $0 | Bingo $0 | Fortune $0 | Tax $0
Seat 1: 3dd958bc (button) collected ($0.12)
Seat 2: d92d785f (small blind) folded before Flop
Seat 3: 3ad9a194 (big blind) folded before Flop
Seat 4: 7bf33a65 folded before Flop (didn't bet)
Seat 5: f537abc0 folded before Flop (didn't bet)
Seat 6: Hero folded before Flop (didn't bet)


Poker Hand #RC3811286105: Hold'em No Limit ($0.02/$0.05) - 2025/08/16 13:46:55
Table 'RushAndCash861365' 6-max Seat #1 is the button
Seat 1: Hero ($17.79 in chips)
Seat 2: cd221820 ($5.87 in chips)
Seat 3: a0ab84be ($3.59 in chips)
Seat 4: 37795d36 ($5 in chips)
Seat 5: 929de63c ($10.14 in chips)
Seat 6: d48d84fd ($5.07 in chips)
cd221820: posts small blind $0.02
a0ab84be: posts big blind $0.05
*** HOLE CARDS ***
Dealt to Hero [Ts Td]
Dealt to cd221820 
Dealt to a0ab84be 
Dealt to 37795d36 
Dealt to 929de63c 
Dealt to d48d84fd 
37795d36: folds
929de63c: folds
d48d84fd: raises $0.05 to $0.1
Hero: raises $0.32 to $0.42
cd221820: folds
a0ab84be: folds
d48d84fd: calls $0.32
*** FLOP *** [3s 4s 5d]
d48d84fd: checks
Hero: checks
*** TURN *** [3s 4s 5d] [8s]
d48d84fd: bets $0.31
Hero: raises $0.81 to $1.12
d48d84fd: calls $0.81
*** RIVER *** [3s 4s 5d 8s] [4d]
d48d84fd: checks
Hero: checks
d48d84fd: shows [7d 7s] (two pair, Sevens and Fours)
Hero: shows [Ts Td] (two pair, Tens and Fours)
*** SHOWDOWN ***
Hero collected $2.93 from pot
*** SUMMARY ***
Total pot $3.15 | Rake $0.15 | Jackpot $0.07 | Bingo $0 | Fortune $0 | Tax $0
Board [3s 4s 5d 8s 4d]
Seat 1: Hero (button) showed [Ts Td] and won ($2.93) with two pair, Tens and Fours
Seat 2: cd221820 (small blind) folded before Flop
Seat 3: a0ab84be (big blind) folded before Flop
Seat 4: 37795d36 folded before Flop (didn't bet)
Seat 5: 929de63c folded before Flop (didn't bet)
Seat 6: d48d84fd showed [7d 7s] and lost with two pair, Sevens and Fours


Poker Hand #RC3811286062: Hold'em No Limit ($0.02/$0.05) - 2025/08/16 13:46:45
Table 'RushAndCash861322' 6-max Seat #1 is the button
Seat 1: b3c0712c ($5 in chips)
Seat 2: 60ffc042 ($5 in chips)
Seat 3: Hero ($17.77 in chips)
Seat 4: 7e9765df ($5.01 in chips)
Seat 5: 1b766e4 ($5.45 in chips)
Seat 6: 47ae55d1 ($12.91 in chips)
60ffc042: posts small blind $0.02
Hero: posts big blind $0.05
*** HOLE CARDS ***
Dealt to b3c0712c 
Dealt to 60ffc042 
Dealt to Hero [Jc 9s]
Dealt to 7e9765df 
Dealt to 1b766e4 
Dealt to 47ae55d1 
7e9765df: folds
1b766e4: folds
47ae55d1: folds
b3c0712c: folds
60ffc042: folds
Uncalled bet ($0.03) returned to Hero
*** SHOWDOWN ***
Hero collected $0.04 from pot
*** SUMMARY ***
Total pot $0.04 | Rake $0 | Jackpot $0 | Bingo $0 | Fortune $0 | Tax $0
Seat 1: b3c0712c (button) folded before Flop (didn't bet)
Seat 2: 60ffc042 (small blind) folded before Flop
Seat 3: Hero (big blind) collected ($0.04)
Seat 4: 7e9765df folded before Flop (didn't bet)
Seat 5: 1b766e4 folded before Flop (didn't bet)
Seat 6: 47ae55d1 folded before Flop (didn't bet)


Poker Hand #RC3811286044: Hold'em No Limit ($0.02/$0.05) - 2025/08/16 13:46:42
Table 'RushAndCash861304' 6-max Seat #1 is the button
Seat 1: 3c2c4bff ($5.21 in chips)
Seat 2: a178a7ae ($4.34 in chips)
Seat 3: b94644f5 ($6.1 in chips)
Seat 4: 7ec4706e ($8.38 in chips)
Seat 5: 7e9765df ($5.01 in chips)
Seat 6: Hero ($17.77 in chips)
a178a7ae: posts small blind $0.02
b94644f5: posts big blind $0.05
*** HOLE CARDS ***
Dealt to 3c2c4bff 
Dealt to a178a7ae 
Dealt to b94644f5 
Dealt to 7ec4706e 
Dealt to 7e9765df 
Dealt to Hero [4d As]
7ec4706e: folds
7e9765df: folds
Hero: folds
3c2c4bff: folds
a178a7ae: folds
Uncalled bet ($0.03) returned to b94644f5
*** SHOWDOWN ***
b94644f5 collected $0.04 from pot
*** SUMMARY ***
Total pot $0.04 | Rake $0 | Jackpot $0 | Bingo $0 | Fortune $0 | Tax $0
Seat 1: 3c2c4bff (button) folded before Flop (didn't bet)
Seat 2: a178a7ae (small blind) folded before Flop
Seat 3: b94644f5 (big blind) collected ($0.04)
Seat 4: 7ec4706e folded before Flop (didn't bet)
Seat 5: 7e9765df folded before Flop (didn't bet)
Seat 6: Hero folded before Flop (didn't bet)


Poker Hand #RC3811286026: Hold'em No Limit ($0.02/$0.05) - 2025/08/16 13:46:38
Table 'RushAndCash861286' 6-max Seat #1 is the button
Seat 1: a0ab84be ($3.59 in chips)
Seat 2: 4ba2cf7 ($13.57 in chips)
Seat 3: cb8db60e ($6.62 in chips)
Seat 4: df91ffd8 ($19.45 in chips)
Seat 5: Hero ($17.77 in chips)
Seat 6: f82aab0a ($4.74 in chips)
4ba2cf7: posts small blind $0.02
cb8db60e: posts big blind $0.05
*** HOLE CARDS ***
Dealt to a0ab84be 
Dealt to 4ba2cf7 
Dealt to cb8db60e 
Dealt to df91ffd8 
Dealt to Hero [9c 6s]
Dealt to f82aab0a 
df91ffd8: raises $0.05 to $0.1
Hero: folds
f82aab0a: folds
a0ab84be: folds
4ba2cf7: folds
cb8db60e: folds
Uncalled bet ($0.05) returned to df91ffd8
*** SHOWDOWN ***
df91ffd8 collected $0.12 from pot
*** SUMMARY ***
Total pot $0.12 | Rake $0 | Jackpot $0 | Bingo $0 | Fortune $0 | Tax $0
Seat 1: a0ab84be (button) folded before Flop (didn't bet)
Seat 2: 4ba2cf7 (small blind) folded before Flop
Seat 3: cb8db60e (big blind) folded before Flop
Seat 4: df91ffd8 collected ($0.12)
Seat 5: Hero folded before Flop (didn't bet)
Seat 6: f82aab0a folded before Flop (didn't bet)


Poker Hand #RC3811286009: Hold'em No Limit ($0.02/$0.05) - 2025/08/16 13:46:35
Table 'RushAndCash861269' 6-max Seat #1 is the button
Seat 1: cf00cabc ($4.21 in chips)
Seat 2: 8f9067f4 ($9.8 in chips)
Seat 3: d73e29e7 ($10.55 in chips)
Seat 4: Hero ($17.77 in chips)
Seat 5: 45eea39e ($11.34 in chips)
Seat 6: 8012acf ($5.54 in chips)
8f9067f4: posts small blind $0.02
d73e29e7: posts big blind $0.05
*** HOLE CARDS ***
Dealt to cf00cabc 
Dealt to 8f9067f4 
Dealt to d73e29e7 
Dealt to Hero [5d 6h]
Dealt to 45eea39e 
Dealt to 8012acf 
Hero: folds
45eea39e: folds
8012acf: folds
cf00cabc: raises $0.05 to $0.1
8f9067f4: folds
d73e29e7: folds
Uncalled bet ($0.05) returned to cf00cabc
*** SHOWDOWN ***
cf00cabc collected $0.12 from pot
*** SUMMARY ***
Total pot $0.12 | Rake $0 | Jackpot $0 | Bingo $0 | Fortune $0 | Tax $0
Seat 1: cf00cabc (button) collected ($0.12)
Seat 2: 8f9067f4 (small blind) folded before Flop
Seat 3: d73e29e7 (big blind) folded before Flop
Seat 4: Hero folded before Flop (didn't bet)
Seat 5: 45eea39e folded before Flop (didn't bet)
Seat 6: 8012acf folded before Flop (didn't bet)


Poker Hand #RC3811285993: Hold'em No Limit ($0.02/$0.05) - 2025/08/16 13:46:31
Table 'RushAndCash861253' 6-max Seat #1 is the button
Seat 1: d5a856e7 ($5.62 in chips)
Seat 2: d73e29e7 ($10.57 in chips)
Seat 3: af513a68 ($40.5 in chips)
Seat 4: cf00cabc ($4.21 in chips)
Seat 5: 9a543c48 ($9.55 in chips)
Seat 6: Hero ($17.77 in chips)
d73e29e7: posts small blind $0.02
af513a68: posts big blind $0.05
*** HOLE CARDS ***
Dealt to d5a856e7 
Dealt to d73e29e7 
Dealt to af513a68 
Dealt to cf00cabc 
Dealt to 9a543c48 
Dealt to Hero [4d Kh]
cf00cabc: folds
9a543c48: folds
Hero: folds
d5a856e7: folds
d73e29e7: folds
Uncalled bet ($0.03) returned to af513a68
*** SHOWDOWN ***
af513a68 collected $0.04 from pot
*** SUMMARY ***
Total pot $0.04 | Rake $0 | Jackpot $0 | Bingo $0 | Fortune $0 | Tax $0
Seat 1: d5a856e7 (button) folded before Flop (didn't bet)
Seat 2: d73e29e7 (small blind) folded before Flop
Seat 3: af513a68 (big blind) collected ($0.04)
Seat 4: cf00cabc folded before Flop (didn't bet)
Seat 5: 9a543c48 folded before Flop (didn't bet)
Seat 6: Hero folded before Flop (didn't bet)


Poker Hand #RC3811285939: Hold'em No Limit ($0.02/$0.05) - 2025/08/16 13:46:19
Table 'RushAndCash861199' 6-max Seat #1 is the button
Seat 1: cd221820 ($5.54 in chips)
Seat 2: Hero ($17.79 in chips)
Seat 3: f3ffb67 ($4.81 in chips)
Seat 4: 2209ab16 ($5.03 in chips)
Seat 5: 237f6cbd ($5.26 in chips)
Seat 6: ae2a48c9 ($5.08 in chips)
Hero: posts small blind $0.02
f3ffb67: posts big blind $0.05
*** HOLE CARDS ***
Dealt to cd221820 
Dealt to Hero [7c 5s]
Dealt to f3ffb67 
Dealt to 2209ab16 
Dealt to 237f6cbd 
Dealt to ae2a48c9 
2209ab16: folds
237f6cbd: folds
ae2a48c9: raises $0.05 to $0.1
cd221820: raises $0.24 to $0.34
Hero: folds
f3ffb67: folds
ae2a48c9: calls $0.24
*** FLOP *** [Ks 3d Kh]
ae2a48c9: checks
cd221820: bets $0.19
ae2a48c9: folds
Uncalled bet ($0.19) returned to cd221820
*** SHOWDOWN ***
cd221820 collected $0.72 from pot
*** SUMMARY ***
Total pot $0.75 | Rake $0.03 | Jackpot $0 | Bingo $0 | Fortune $0 | Tax $0
Board [Ks 3d Kh]
Seat 1: cd221820 (button) won ($0.72)
Seat 2: Hero (small blind) folded before Flop
Seat 3: f3ffb67 (big blind) folded before Flop
Seat 4: 2209ab16 folded before Flop (didn't bet)
Seat 5: 237f6cbd folded before Flop (didn't bet)
Seat 6: ae2a48c9 folded on the Flop


Poker Hand #RC3811285923: Hold'em No Limit ($0.02/$0.05) - 2025/08/16 13:46:15
Table 'RushAndCash861183' 6-max Seat #1 is the button
Seat 1: b05cbd91 ($3.99 in chips)
Seat 2: 3ccbf3d2 ($5.64 in chips)
Seat 3: 36ce12e3 ($5.86 in chips)
Seat 4: 917f3e19 ($8.99 in chips)
Seat 5: df91ffd8 ($19.5 in chips)
Seat 6: Hero ($17.79 in chips)
3ccbf3d2: posts small blind $0.02
36ce12e3: posts big blind $0.05
*** HOLE CARDS ***
Dealt to b05cbd91 
Dealt to 3ccbf3d2 
Dealt to 36ce12e3 
Dealt to 917f3e19 
Dealt to df91ffd8 
Dealt to Hero [3h 6c]
917f3e19: raises $0.07 to $0.12
df91ffd8: folds
Hero: folds
b05cbd91: folds
3ccbf3d2: folds
36ce12e3: folds
Uncalled bet ($0.07) returned to 917f3e19
*** SHOWDOWN ***
917f3e19 collected $0.12 from pot
*** SUMMARY ***
Total pot $0.12 | Rake $0 | Jackpot $0 | Bingo $0 | Fortune $0 | Tax $0
Seat 1: b05cbd91 (button) folded before Flop (didn't bet)
Seat 2: 3ccbf3d2 (small blind) folded before Flop
Seat 3: 36ce12e3 (big blind) folded before Flop
Seat 4: 917f3e19 collected ($0.12)
Seat 5: df91ffd8 folded before Flop (didn't bet)
Seat 6: Hero folded before Flop (didn't bet)


Poker Hand #RC3811285807: Hold'em No Limit ($0.02/$0.05) - 2025/08/16 13:45:50
Table 'RushAndCash861067' 6-max Seat #1 is the button
Seat 1: 4d636d6a ($5 in chips)
Seat 2: cf00cabc ($4.28 in chips)
Seat 3: Hero ($17.68 in chips)
Seat 4: b05cbd91 ($4.04 in chips)
Seat 5: 6fab6733 ($5.21 in chips)
Seat 6: 36ce12e3 ($5.96 in chips)
cf00cabc: posts small blind $0.02
Hero: posts big blind $0.05
*** HOLE CARDS ***
Dealt to 4d636d6a 
Dealt to cf00cabc 
Dealt to Hero [Ah Jd]
Dealt to b05cbd91 
Dealt to 6fab6733 
Dealt to 36ce12e3 
b05cbd91: folds
6fab6733: folds
36ce12e3: raises $0.05 to $0.1
4d636d6a: folds
cf00cabc: folds
Hero: raises $0.22 to $0.32
36ce12e3: folds
Uncalled bet ($0.22) returned to Hero
*** SHOWDOWN ***
Hero collected $0.21 from pot
*** SUMMARY ***
Total pot $0.22 | Rake $0.01 | Jackpot $0 | Bingo $0 | Fortune $0 | Tax $0
Seat 1: 4d636d6a (button) folded before Flop (didn't bet)
Seat 2: cf00cabc (small blind) folded before Flop
Seat 3: Hero (big blind) collected ($0.21)
Seat 4: b05cbd91 folded before Flop (didn't bet)
Seat 5: 6fab6733 folded before Flop (didn't bet)
Seat 6: 36ce12e3 folded before Flop


Poker Hand #RC3811285789: Hold'em No Limit ($0.02/$0.05) - 2025/08/16 13:45:46
Table 'RushAndCash861049' 6-max Seat #1 is the button
Seat 1: b094641b ($5.07 in chips)
Seat 2: 5dbb35e2 ($5.98 in chips)
Seat 3: cf00cabc ($4.33 in chips)
Seat 4: f537abc0 ($5.14 in chips)
Seat 5: Hero ($17.68 in chips)
Seat 6: 58f42367 ($6.06 in chips)
5dbb35e2: posts small blind $0.02
cf00cabc: posts big blind $0.05
*** HOLE CARDS ***
Dealt to b094641b 
Dealt to 5dbb35e2 
Dealt to cf00cabc 
Dealt to f537abc0 
Dealt to Hero [8s 4s]
Dealt to 58f42367 
f537abc0: folds
Hero: folds
58f42367: folds
b094641b: raises $0.08 to $0.13
5dbb35e2: folds
cf00cabc: folds
Uncalled bet ($0.08) returned to b094641b
*** SHOWDOWN ***
b094641b collected $0.12 from pot
*** SUMMARY ***
Total pot $0.12 | Rake $0 | Jackpot $0 | Bingo $0 | Fortune $0 | Tax $0
Seat 1: b094641b (button) collected ($0.12)
Seat 2: 5dbb35e2 (small blind) folded before Flop
Seat 3: cf00cabc (big blind) folded before Flop
Seat 4: f537abc0 folded before Flop (didn't bet)
Seat 5: Hero folded before Flop (didn't bet)
Seat 6: 58f42367 folded before Flop (didn't bet)


Poker Hand #RC3811285762: Hold'em No Limit ($0.02/$0.05) - 2025/08/16 13:45:39
Table 'RushAndCash861022' 6-max Seat #1 is the button
Seat 1: a400c85f ($5.07 in chips)
Seat 2: Hero ($17.7 in chips)
Seat 3: fad7a12d ($5.93 in chips)
Seat 4: 18ee0b33 ($6.1 in chips)
Seat 5: 52d7f205 ($5.03 in chips)
Seat 6: 58f42367 ($6.06 in chips)
Hero: posts small blind $0.02
fad7a12d: posts big blind $0.05
*** HOLE CARDS ***
Dealt to a400c85f 
Dealt to Hero [Jh 2h]
Dealt to fad7a12d 
Dealt to 18ee0b33 
Dealt to 52d7f205 
Dealt to 58f42367 
18ee0b33: folds
52d7f205: folds
58f42367: folds
a400c85f: folds
Hero: folds
Uncalled bet ($0.03) returned to fad7a12d
*** SHOWDOWN ***
fad7a12d collected $0.04 from pot
*** SUMMARY ***
Total pot $0.04 | Rake $0 | Jackpot $0 | Bingo $0 | Fortune $0 | Tax $0
Seat 1: a400c85f (button) folded before Flop (didn't bet)
Seat 2: Hero (small blind) folded before Flop
Seat 3: fad7a12d (big blind) collected ($0.04)
Seat 4: 18ee0b33 folded before Flop (didn't bet)
Seat 5: 52d7f205 folded before Flop (didn't bet)
Seat 6: 58f42367 folded before Flop (didn't bet)


Poker Hand #RC3811285744: Hold'em No Limit ($0.02/$0.05) - 2025/08/16 13:45:36
Table 'RushAndCash861004' 6-max Seat #1 is the button
Seat 1: 52d7f205 ($5.03 in chips)
Seat 2: bd1bf91e ($5.02 in chips)
Seat 3: 359a07d4 ($5.05 in chips)
Seat 4: fad7a12d ($5.93 in chips)
Seat 5: de1af803 ($4.65 in chips)
Seat 6: Hero ($17.7 in chips)
bd1bf91e: posts small blind $0.02
359a07d4: posts big blind $0.05
*** HOLE CARDS ***
Dealt to 52d7f205 
Dealt to bd1bf91e 
Dealt to 359a07d4 
Dealt to fad7a12d 
Dealt to de1af803 
Dealt to Hero [Jh 5h]
fad7a12d: folds
de1af803: folds
Hero: folds
52d7f205: folds
bd1bf91e: folds
Uncalled bet ($0.03) returned to 359a07d4
*** SHOWDOWN ***
359a07d4 collected $0.04 from pot
*** SUMMARY ***
Total pot $0.04 | Rake $0 | Jackpot $0 | Bingo $0 | Fortune $0 | Tax $0
Seat 1: 52d7f205 (button) folded before Flop (didn't bet)
Seat 2: bd1bf91e (small blind) folded before Flop
Seat 3: 359a07d4 (big blind) collected ($0.04)
Seat 4: fad7a12d folded before Flop (didn't bet)
Seat 5: de1af803 folded before Flop (didn't bet)
Seat 6: Hero folded before Flop (didn't bet)


Poker Hand #RC3811285697: Hold'em No Limit ($0.02/$0.05) - 2025/08/16 13:45:26
Table 'RushAndCash860957' 6-max Seat #1 is the button
Seat 1: 6b644717 ($9.74 in chips)
Seat 2: 2004182d ($9.88 in chips)
Seat 3: Hero ($17.75 in chips)
Seat 4: bacbc16f ($6.15 in chips)
Seat 5: 18ee0b33 ($6.03 in chips)
Seat 6: ed530cde ($7.69 in chips)
2004182d: posts small blind $0.02
Hero: posts big blind $0.05
*** HOLE CARDS ***
Dealt to 6b644717 
Dealt to 2004182d 
Dealt to Hero [5d Qd]
Dealt to bacbc16f 
Dealt to 18ee0b33 
Dealt to ed530cde 
bacbc16f: folds
18ee0b33: raises $0.05 to $0.1
ed530cde: folds
6b644717: folds
2004182d: folds
Hero: folds
Uncalled bet ($0.05) returned to 18ee0b33
*** SHOWDOWN ***
18ee0b33 collected $0.12 from pot
*** SUMMARY ***
Total pot $0.12 | Rake $0 | Jackpot $0 | Bingo $0 | Fortune $0 | Tax $0
Seat 1: 6b644717 (button) folded before Flop (didn't bet)
Seat 2: 2004182d (small blind) folded before Flop
Seat 3: Hero (big blind) folded before Flop
Seat 4: bacbc16f folded before Flop (didn't bet)
Seat 5: 18ee0b33 collected ($0.12)
Seat 6: ed530cde folded before Flop (didn't bet)


Poker Hand #RC3811285676: Hold'em No Limit ($0.02/$0.05) - 2025/08/16 13:45:22
Table 'RushAndCash860936' 6-max Seat #1 is the button
Seat 1: 5dbb35e2 ($5.96 in chips)
Seat 2: 6b644717 ($9.76 in chips)
Seat 3: 46d1c38e ($5.06 in chips)
Seat 4: cd710d91 ($5 in chips)
Seat 5: 2bb6b6c9 ($6.18 in chips)
Seat 6: Hero ($17.75 in chips)
6b644717: posts small blind $0.02
46d1c38e: posts big blind $0.05
*** HOLE CARDS ***
Dealt to 5dbb35e2 
Dealt to 6b644717 
Dealt to 46d1c38e 
Dealt to cd710d91 
Dealt to 2bb6b6c9 
Dealt to Hero [9c Td]
cd710d91: folds
2bb6b6c9: raises $0.05 to $0.1
Hero: folds
5dbb35e2: folds
6b644717: folds
46d1c38e: folds
Uncalled bet ($0.05) returned to 2bb6b6c9
*** SHOWDOWN ***
2bb6b6c9 collected $0.12 from pot
*** SUMMARY ***
Total pot $0.12 | Rake $0 | Jackpot $0 | Bingo $0 | Fortune $0 | Tax $0
Seat 1: 5dbb35e2 (button) folded before Flop (didn't bet)
Seat 2: 6b644717 (small blind) folded before Flop
Seat 3: 46d1c38e (big blind) folded before Flop
Seat 4: cd710d91 folded before Flop (didn't bet)
Seat 5: 2bb6b6c9 collected ($0.12)
Seat 6: Hero folded before Flop (didn't bet)


Poker Hand #RC3811285658: Hold'em No Limit ($0.02/$0.05) - 2025/08/16 13:45:19
Table 'RushAndCash860918' 6-max Seat #1 is the button
Seat 1: ebfca2f0 ($5 in chips)
Seat 2: 6b533e63 ($5 in chips)
Seat 3: cb8db60e ($6.82 in chips)
Seat 4: Hero ($17.75 in chips)
Seat 5: fdba6534 ($15.54 in chips)
Seat 6: dea7046b ($5 in chips)
6b533e63: posts small blind $0.02
cb8db60e: posts big blind $0.05
*** HOLE CARDS ***
Dealt to ebfca2f0 
Dealt to 6b533e63 
Dealt to cb8db60e 
Dealt to Hero [Td 6d]
Dealt to fdba6534 
Dealt to dea7046b 
Hero: folds
fdba6534: folds
dea7046b: raises $0.06 to $0.11
ebfca2f0: folds
6b533e63: calls $0.09
cb8db60e: calls $0.06
*** FLOP *** [9d Th Kc]
6b533e63: checks
cb8db60e: checks
dea7046b: bets $0.14
6b533e63: folds
cb8db60e: folds
Uncalled bet ($0.14) returned to dea7046b
*** SHOWDOWN ***
dea7046b collected $0.32 from pot
*** SUMMARY ***
Total pot $0.33 | Rake $0.01 | Jackpot $0 | Bingo $0 | Fortune $0 | Tax $0
Board [9d Th Kc]
Seat 1: ebfca2f0 (button) folded before Flop (didn't bet)
Seat 2: 6b533e63 (small blind) folded on the Flop
Seat 3: cb8db60e (big blind) folded on the Flop
Seat 4: Hero folded before Flop (didn't bet)
Seat 5: fdba6534 folded before Flop (didn't bet)
Seat 6: dea7046b won ($0.32)


Poker Hand #RC3811285630: Hold'em No Limit ($0.02/$0.05) - 2025/08/16 13:45:12
Table 'RushAndCash860890' 6-max Seat #1 is the button
Seat 1: Hero ($17.75 in chips)
Seat 2: f82aab0a ($4.01 in chips)
Seat 3: 4101fbff ($4.23 in chips)
Seat 4: cb6a0e23 ($6.01 in chips)
Seat 5: df82d671 ($5.44 in chips)
Seat 6: 60ffc042 ($5.07 in chips)
f82aab0a: posts small blind $0.02
4101fbff: posts big blind $0.05
*** HOLE CARDS ***
Dealt to Hero [4d 9c]
Dealt to f82aab0a 
Dealt to 4101fbff 
Dealt to cb6a0e23 
Dealt to df82d671 
Dealt to 60ffc042 
cb6a0e23: folds
df82d671: folds
60ffc042: folds
Hero: folds
f82aab0a: raises $0.1 to $0.15
4101fbff: folds
Uncalled bet ($0.1) returned to f82aab0a
*** SHOWDOWN ***
f82aab0a collected $0.1 from pot
*** SUMMARY ***
Total pot $0.1 | Rake $0 | Jackpot $0 | Bingo $0 | Fortune $0 | Tax $0
Seat 1: Hero (button) folded before Flop (didn't bet)
Seat 2: f82aab0a (small blind) collected ($0.1)
Seat 3: 4101fbff (big blind) folded before Flop
Seat 4: cb6a0e23 folded before Flop (didn't bet)
Seat 5: df82d671 folded before Flop (didn't bet)
Seat 6: 60ffc042 folded before Flop (didn't bet)


Poker Hand #RC3811285611: Hold'em No Limit ($0.02/$0.05) - 2025/08/16 13:45:09
Table 'RushAndCash860871' 6-max Seat #1 is the button
Seat 1: dc6b3f2e ($17.86 in chips)
Seat 2: 12327aaf ($5.25 in chips)
Seat 3: bacbc16f ($6.2 in chips)
Seat 4: Hero ($17.75 in chips)
Seat 5: 3fee27f9 ($12.49 in chips)
Seat 6: e0a0e5cd ($8.4 in chips)
12327aaf: posts small blind $0.02
bacbc16f: posts big blind $0.05
*** HOLE CARDS ***
Dealt to dc6b3f2e 
Dealt to 12327aaf 
Dealt to bacbc16f 
Dealt to Hero [Qh 7c]
Dealt to 3fee27f9 
Dealt to e0a0e5cd 
Hero: folds
3fee27f9: folds
e0a0e5cd: raises $0.1 to $0.15
dc6b3f2e: folds
12327aaf: folds
bacbc16f: folds
Uncalled bet ($0.1) returned to e0a0e5cd
*** SHOWDOWN ***
e0a0e5cd collected $0.12 from pot
*** SUMMARY ***
Total pot $0.12 | Rake $0 | Jackpot $0 | Bingo $0 | Fortune $0 | Tax $0
Seat 1: dc6b3f2e (button) folded before Flop (didn't bet)
Seat 2: 12327aaf (small blind) folded before Flop
Seat 3: bacbc16f (big blind) folded before Flop
Seat 4: Hero folded before Flop (didn't bet)
Seat 5: 3fee27f9 folded before Flop (didn't bet)
Seat 6: e0a0e5cd collected ($0.12)


Poker Hand #RC3811285388: Hold'em No Limit ($0.02/$0.05) - 2025/08/16 13:44:20
Table 'RushAndCash860648' 6-max Seat #1 is the button
Seat 1: fc81e7eb ($4.82 in chips)
Seat 2: d876bedd ($5.02 in chips)
Seat 3: e0a0e5cd ($8.29 in chips)
Seat 4: a98f555a ($6.45 in chips)
Seat 5: Hero ($17.85 in chips)
Seat 6: 6b644717 ($9.51 in chips)
d876bedd: posts small blind $0.02
e0a0e5cd: posts big blind $0.05
*** HOLE CARDS ***
Dealt to fc81e7eb 
Dealt to d876bedd 
Dealt to e0a0e5cd 
Dealt to a98f555a 
Dealt to Hero [Th Jc]
Dealt to 6b644717 
a98f555a: folds
Hero: raises $0.05 to $0.1
6b644717: folds
fc81e7eb: folds
d876bedd: folds
e0a0e5cd: calls $0.05
*** FLOP *** [8h 7c Kh]
e0a0e5cd: checks
Hero: checks
*** TURN *** [8h 7c Kh] [2c]
e0a0e5cd: checks
Hero: checks
*** RIVER *** [8h 7c Kh 2c] [Qs]
e0a0e5cd: bets $0.11
Hero: folds
Uncalled bet ($0.11) returned to e0a0e5cd
*** SHOWDOWN ***
e0a0e5cd collected $0.21 from pot
*** SUMMARY ***
Total pot $0.22 | Rake $0.01 | Jackpot $0 | Bingo $0 | Fortune $0 | Tax $0
Board [8h 7c Kh 2c Qs]
Seat 1: fc81e7eb (button) folded before Flop (didn't bet)
Seat 2: d876bedd (small blind) folded before Flop
Seat 3: e0a0e5cd (big blind) won ($0.21)
Seat 4: a98f555a folded before Flop (didn't bet)
Seat 5: Hero folded on the River
Seat 6: 6b644717 folded before Flop (didn't bet)


Poker Hand #RC3811285328: Hold'em No Limit ($0.02/$0.05) - 2025/08/16 13:44:07
Table 'RushAndCash860588' 6-max Seat #1 is the button
Seat 1: 5e0898f8 ($4 in chips)
Seat 2: 7f061a59 ($6.56 in chips)
Seat 3: Hero ($17.83 in chips)
Seat 4: c5052b8d ($7.26 in chips)
Seat 5: 2c813695 ($5.09 in chips)
Seat 6: e0a0e5cd ($8.31 in chips)
7f061a59: posts small blind $0.02
Hero: posts big blind $0.05
*** HOLE CARDS ***
Dealt to 5e0898f8 
Dealt to 7f061a59 
Dealt to Hero [5h 9c]
Dealt to c5052b8d 
Dealt to 2c813695 
Dealt to e0a0e5cd 
c5052b8d: folds
2c813695: folds
e0a0e5cd: folds
5e0898f8: folds
7f061a59: folds
Uncalled bet ($0.03) returned to Hero
*** SHOWDOWN ***
Hero collected $0.04 from pot
*** SUMMARY ***
Total pot $0.04 | Rake $0 | Jackpot $0 | Bingo $0 | Fortune $0 | Tax $0
Seat 1: 5e0898f8 (button) folded before Flop (didn't bet)
Seat 2: 7f061a59 (small blind) folded before Flop
Seat 3: Hero (big blind) collected ($0.04)
Seat 4: c5052b8d folded before Flop (didn't bet)
Seat 5: 2c813695 folded before Flop (didn't bet)
Seat 6: e0a0e5cd folded before Flop (didn't bet)


Poker Hand #RC3811285294: Hold'em No Limit ($0.02/$0.05) - 2025/08/16 13:43:59
Table 'RushAndCash860554' 6-max Seat #1 is the button
Seat 1: Hero ($17.83 in chips)
Seat 2: a885e6e7 ($5.78 in chips)
Seat 3: 430a9eb ($5.66 in chips)
Seat 4: 36ce12e3 ($5.52 in chips)
Seat 5: 4b2b7b69 ($4.61 in chips)
Seat 6: fdba6534 ($15.75 in chips)
a885e6e7: posts small blind $0.02
430a9eb: posts big blind $0.05
*** HOLE CARDS ***
Dealt to Hero [Kc 5h]
Dealt to a885e6e7 
Dealt to 430a9eb 
Dealt to 36ce12e3 
Dealt to 4b2b7b69 
Dealt to fdba6534 
36ce12e3: raises $0.05 to $0.1
4b2b7b69: calls $0.1
fdba6534: folds
Hero: folds
a885e6e7: folds
430a9eb: folds
*** FLOP *** [8c 6s 3c]
36ce12e3: checks
4b2b7b69: checks
*** TURN *** [8c 6s 3c] [Ah]
36ce12e3: checks
4b2b7b69: checks
*** RIVER *** [8c 6s 3c Ah] [9h]
36ce12e3: checks
4b2b7b69: checks
36ce12e3: shows [Jc Qh] (Ace high)
4b2b7b69: shows [Qs Ts] (Ace high)
*** SHOWDOWN ***
36ce12e3 collected $0.26 from pot
*** SUMMARY ***
Total pot $0.27 | Rake $0.01 | Jackpot $0 | Bingo $0 | Fortune $0 | Tax $0
Board [8c 6s 3c Ah 9h]
Seat 1: Hero (button) folded before Flop (didn't bet)
Seat 2: a885e6e7 (small blind) folded before Flop
Seat 3: 430a9eb (big blind) folded before Flop
Seat 4: 36ce12e3 showed [Jc Qh] and won ($0.26) with Ace high
Seat 5: 4b2b7b69 showed [Qs Ts] and lost with Ace high
Seat 6: fdba6534 folded before Flop (didn't bet)


Poker Hand #RC3811285244: Hold'em No Limit ($0.02/$0.05) - 2025/08/16 13:43:48
Table 'RushAndCash860504' 6-max Seat #1 is the button
Seat 1: c0d1f133 ($5 in chips)
Seat 2: Hero ($17.85 in chips)
Seat 3: ceb78569 ($4 in chips)
Seat 4: 225abea7 ($5.09 in chips)
Seat 5: 4ba2cf7 ($13.96 in chips)
Seat 6: 63def097 ($16.99 in chips)
Hero: posts small blind $0.02
ceb78569: posts big blind $0.05
*** HOLE CARDS ***
Dealt to c0d1f133 
Dealt to Hero [6c Qc]
Dealt to ceb78569 
Dealt to 225abea7 
Dealt to 4ba2cf7 
Dealt to 63def097 
225abea7: folds
4ba2cf7: folds
63def097: folds
c0d1f133: raises $0.05 to $0.1
Hero: folds
ceb78569: folds
Uncalled bet ($0.05) returned to c0d1f133
*** SHOWDOWN ***
c0d1f133 collected $0.12 from pot
*** SUMMARY ***
Total pot $0.12 | Rake $0 | Jackpot $0 | Bingo $0 | Fortune $0 | Tax $0
Seat 1: c0d1f133 (button) collected ($0.12)
Seat 2: Hero (small blind) folded before Flop
Seat 3: ceb78569 (big blind) folded before Flop
Seat 4: 225abea7 folded before Flop (didn't bet)
Seat 5: 4ba2cf7 folded before Flop (didn't bet)
Seat 6: 63def097 folded before Flop (didn't bet)


Poker Hand #RC3811285063: Hold'em No Limit ($0.02/$0.05) - 2025/08/16 13:43:04
Table 'RushAndCash860323' 6-max Seat #1 is the button
Seat 1: 4ba2cf7 ($14.03 in chips)
Seat 2: 63def097 ($16.74 in chips)
Seat 3: 7cc092a1 ($6.36 in chips)
Seat 4: be8735a3 ($5.42 in chips)
Seat 5: Hero ($18.07 in chips)
Seat 6: b6adb304 ($14.25 in chips)
63def097: posts small blind $0.02
7cc092a1: posts big blind $0.05
*** HOLE CARDS ***
Dealt to 4ba2cf7 
Dealt to 63def097 
Dealt to 7cc092a1 
Dealt to be8735a3 
Dealt to Hero [Jd 8d]
Dealt to b6adb304 
be8735a3: folds
Hero: raises $0.05 to $0.1
b6adb304: folds
4ba2cf7: folds
63def097: calls $0.08
7cc092a1: folds
*** FLOP *** [3c Kc 8h]
63def097: checks
Hero: bets $0.12
63def097: calls $0.12
*** TURN *** [3c Kc 8h] [3s]
63def097: checks
Hero: checks
*** RIVER *** [3c Kc 8h 3s] [As]
63def097: bets $0.17
Hero: folds
Uncalled bet ($0.17) returned to 63def097
*** SHOWDOWN ***
63def097 collected $0.47 from pot
*** SUMMARY ***
Total pot $0.49 | Rake $0.02 | Jackpot $0 | Bingo $0 | Fortune $0 | Tax $0
Board [3c Kc 8h 3s As]
Seat 1: 4ba2cf7 (button) folded before Flop (didn't bet)
Seat 2: 63def097 (small blind) won ($0.47)
Seat 3: 7cc092a1 (big blind) folded before Flop
Seat 4: be8735a3 folded before Flop (didn't bet)
Seat 5: Hero folded on the River
Seat 6: b6adb304 folded before Flop (didn't bet)


Poker Hand #RC3811285048: Hold'em No Limit ($0.02/$0.05) - 2025/08/16 13:43:00
Table 'RushAndCash860308' 6-max Seat #1 is the button
Seat 1: e6780e8f ($14.02 in chips)
Seat 2: cc07ca3a ($15.67 in chips)
Seat 3: 48e9176f ($23.65 in chips)
Seat 4: Hero ($18.07 in chips)
Seat 5: d54feeca ($5.3 in chips)
Seat 6: 3833aa82 ($6.28 in chips)
cc07ca3a: posts small blind $0.02
48e9176f: posts big blind $0.05
*** HOLE CARDS ***
Dealt to e6780e8f 
Dealt to cc07ca3a 
Dealt to 48e9176f 
Dealt to Hero [2c Ah]
Dealt to d54feeca 
Dealt to 3833aa82 
Hero: folds
d54feeca: folds
3833aa82: raises $0.05 to $0.1
e6780e8f: calls $0.1
cc07ca3a: folds
48e9176f: folds
*** FLOP *** [4c Js 2h]
3833aa82: checks
e6780e8f: bets $0.14
3833aa82: folds
Uncalled bet ($0.14) returned to e6780e8f
*** SHOWDOWN ***
e6780e8f collected $0.26 from pot
*** SUMMARY ***
Total pot $0.27 | Rake $0.01 | Jackpot $0 | Bingo $0 | Fortune $0 | Tax $0
Board [4c Js 2h]
Seat 1: e6780e8f (button) won ($0.26)
Seat 2: cc07ca3a (small blind) folded before Flop
Seat 3: 48e9176f (big blind) folded before Flop
Seat 4: Hero folded before Flop (didn't bet)
Seat 5: d54feeca folded before Flop (didn't bet)
Seat 6: 3833aa82 folded on the Flop


Poker Hand #RC3811234736: Hold'em No Limit ($0.02/$0.05) - 2025/08/16 13:41:53
Table 'RushAndCash859996' 6-max Seat #1 is the button
Seat 1: 3d5a8c54 ($5.93 in chips)
Seat 2: 391f296c ($5 in chips)
Seat 3: 5507ca74 ($11.09 in chips)
Seat 4: 319f9ef4 ($9.87 in chips)
Seat 5: d808aa45 ($9.67 in chips)
Seat 6: Hero ($17.47 in chips)
391f296c: posts small blind $0.02
5507ca74: posts big blind $0.05
*** HOLE CARDS ***
Dealt to 3d5a8c54 
Dealt to 391f296c 
Dealt to 5507ca74 
Dealt to 319f9ef4 
Dealt to d808aa45 
Dealt to Hero [Js Ac]
319f9ef4: folds
d808aa45: raises $0.06 to $0.11
Hero: calls $0.11
3d5a8c54: folds
391f296c: folds
5507ca74: calls $0.06
*** FLOP *** [Jh 6c 5c]
5507ca74: bets $0.18
d808aa45: folds
Hero: calls $0.18
*** TURN *** [Jh 6c 5c] [4s]
5507ca74: checks
Hero: checks
*** RIVER *** [Jh 6c 5c 4s] [7h]
5507ca74: bets $0.24
Hero: calls $0.24
5507ca74: shows [Jd Td] (a pair of Jacks)
Hero: shows [Js Ac] (a pair of Jacks)
*** SHOWDOWN ***
Hero collected $1.13 from pot
*** SUMMARY ***
Total pot $1.19 | Rake $0.06 | Jackpot $0 | Bingo $0 | Fortune $0 | Tax $0
Board [Jh 6c 5c 4s 7h]
Seat 1: 3d5a8c54 (button) folded before Flop (didn't bet)
Seat 2: 391f296c (small blind) folded before Flop
Seat 3: 5507ca74 (big blind) showed [Jd Td] and lost with a pair of Jacks
Seat 4: 319f9ef4 folded before Flop (didn't bet)
Seat 5: d808aa45 folded on the Flop
Seat 6: Hero showed [Js Ac] and won ($1.13) with a pair of Jacks


Poker Hand #RC3811234679: Hold'em No Limit ($0.02/$0.05) - 2025/08/16 13:41:40
Table 'RushAndCash859939' 6-max Seat #1 is the button
Seat 1: 56099b06 ($4.13 in chips)
Seat 2: Hero ($17.49 in chips)
Seat 3: be02a95d ($12.95 in chips)
Seat 4: 3ba637cb ($5 in chips)
Seat 5: 94476df0 ($8.88 in chips)
Seat 6: 1d9664c2 ($4.53 in chips)
Hero: posts small blind $0.02
be02a95d: posts big blind $0.05
*** HOLE CARDS ***
Dealt to 56099b06 
Dealt to Hero [Js 6h]
Dealt to be02a95d 
Dealt to 3ba637cb 
Dealt to 94476df0 
Dealt to 1d9664c2 
3ba637cb: folds
94476df0: folds
1d9664c2: folds
56099b06: raises $0.05 to $0.1
Hero: folds
be02a95d: folds
Uncalled bet ($0.05) returned to 56099b06
*** SHOWDOWN ***
56099b06 collected $0.12 from pot
*** SUMMARY ***
Total pot $0.12 | Rake $0 | Jackpot $0 | Bingo $0 | Fortune $0 | Tax $0
Seat 1: 56099b06 (button) collected ($0.12)
Seat 2: Hero (small blind) folded before Flop
Seat 3: be02a95d (big blind) folded before Flop
Seat 4: 3ba637cb folded before Flop (didn't bet)
Seat 5: 94476df0 folded before Flop (didn't bet)
Seat 6: 1d9664c2 folded before Flop (didn't bet)


Poker Hand #RC3811234646: Hold'em No Limit ($0.02/$0.05) - 2025/08/16 13:41:32
Table 'RushAndCash859906' 6-max Seat #1 is the button
Seat 1: 581acabe ($6.41 in chips)
Seat 2: c923a998 ($8.29 in chips)
Seat 3: Hero ($17.54 in chips)
Seat 4: eb415e98 ($5.39 in chips)
Seat 5: 79a9b477 ($5.54 in chips)
Seat 6: 917f3e19 ($9.11 in chips)
c923a998: posts small blind $0.02
Hero: posts big blind $0.05
*** HOLE CARDS ***
Dealt to 581acabe 
Dealt to c923a998 
Dealt to Hero [5c Ts]
Dealt to eb415e98 
Dealt to 79a9b477 
Dealt to 917f3e19 
eb415e98: folds
79a9b477: folds
917f3e19: raises $0.07 to $0.12
581acabe: folds
c923a998: folds
Hero: folds
Uncalled bet ($0.07) returned to 917f3e19
*** SHOWDOWN ***
917f3e19 collected $0.12 from pot
*** SUMMARY ***
Total pot $0.12 | Rake $0 | Jackpot $0 | Bingo $0 | Fortune $0 | Tax $0
Seat 1: 581acabe (button) folded before Flop (didn't bet)
Seat 2: c923a998 (small blind) folded before Flop
Seat 3: Hero (big blind) folded before Flop
Seat 4: eb415e98 folded before Flop (didn't bet)
Seat 5: 79a9b477 folded before Flop (didn't bet)
Seat 6: 917f3e19 collected ($0.12)


Poker Hand #RC3811234599: Hold'em No Limit ($0.02/$0.05) - 2025/08/16 13:41:22
Table 'RushAndCash859859' 6-max Seat #1 is the button
Seat 1: afe822fe ($5 in chips)
Seat 2: Hero ($17.56 in chips)
Seat 3: 9dd71188 ($10.59 in chips)
Seat 4: dc1e1acc ($6.26 in chips)
Seat 5: 1c015352 ($5.63 in chips)
Seat 6: f2e793b1 ($5.63 in chips)
Hero: posts small blind $0.02
9dd71188: posts big blind $0.05
*** HOLE CARDS ***
Dealt to afe822fe 
Dealt to Hero [Ks 3s]
Dealt to 9dd71188 
Dealt to dc1e1acc 
Dealt to 1c015352 
Dealt to f2e793b1 
dc1e1acc: folds
1c015352: raises $0.05 to $0.1
f2e793b1: folds
afe822fe: folds
Hero: folds
9dd71188: folds
Uncalled bet ($0.05) returned to 1c015352
*** SHOWDOWN ***
1c015352 collected $0.12 from pot
*** SUMMARY ***
Total pot $0.12 | Rake $0 | Jackpot $0 | Bingo $0 | Fortune $0 | Tax $0
Seat 1: afe822fe (button) folded before Flop (didn't bet)
Seat 2: Hero (small blind) folded before Flop
Seat 3: 9dd71188 (big blind) folded before Flop
Seat 4: dc1e1acc folded before Flop (didn't bet)
Seat 5: 1c015352 collected ($0.12)
Seat 6: f2e793b1 folded before Flop (didn't bet)


Poker Hand #RC3811234585: Hold'em No Limit ($0.02/$0.05) - 2025/08/16 13:41:18
Table 'RushAndCash859845' 6-max Seat #1 is the button
Seat 1: dc1e1acc ($6.26 in chips)
Seat 2: 1d9664c2 ($4.55 in chips)
Seat 3: 2955ec2b ($5.91 in chips)
Seat 4: 94afcc3f ($5.51 in chips)
Seat 5: Hero ($17.56 in chips)
Seat 6: bbb45730 ($5 in chips)
1d9664c2: posts small blind $0.02
2955ec2b: posts big blind $0.05
*** HOLE CARDS ***
Dealt to dc1e1acc 
Dealt to 1d9664c2 
Dealt to 2955ec2b 
Dealt to 94afcc3f 
Dealt to Hero [4s Kd]
Dealt to bbb45730 
94afcc3f: calls $0.05
Hero: folds
bbb45730: folds
dc1e1acc: folds
1d9664c2: folds
2955ec2b: checks
*** FLOP *** [6c Ks Kc]
2955ec2b: checks
94afcc3f: bets $0.05
2955ec2b: folds
Uncalled bet ($0.05) returned to 94afcc3f
*** SHOWDOWN ***
94afcc3f collected $0.12 from pot
*** SUMMARY ***
Total pot $0.12 | Rake $0 | Jackpot $0 | Bingo $0 | Fortune $0 | Tax $0
Board [6c Ks Kc]
Seat 1: dc1e1acc (button) folded before Flop (didn't bet)
Seat 2: 1d9664c2 (small blind) folded before Flop
Seat 3: 2955ec2b (big blind) folded on the Flop
Seat 4: 94afcc3f won ($0.12)
Seat 5: Hero folded before Flop (didn't bet)
Seat 6: bbb45730 folded before Flop (didn't bet)


Poker Hand #RC3811234395: Hold'em No Limit ($0.02/$0.05) - 2025/08/16 13:40:30
Table 'RushAndCash859655' 6-max Seat #1 is the button
Seat 1: 63def097 ($17.06 in chips)
Seat 2: 25d0c293 ($5.11 in chips)
Seat 3: 1d9664c2 ($4.83 in chips)
Seat 4: Hero ($17.28 in chips)
Seat 5: 33810466 ($5.3 in chips)
Seat 6: 4101fbff ($5 in chips)
25d0c293: posts small blind $0.02
1d9664c2: posts big blind $0.05
*** HOLE CARDS ***
Dealt to 63def097 
Dealt to 25d0c293 
Dealt to 1d9664c2 
Dealt to Hero [6c 6h]
Dealt to 33810466 
Dealt to 4101fbff 
Hero: raises $0.05 to $0.1
33810466: folds
4101fbff: folds
63def097: folds
25d0c293: folds
1d9664c2: calls $0.05
*** FLOP *** [2d 5s 4d]
1d9664c2: checks
Hero: bets $0.18
1d9664c2: calls $0.18
*** TURN *** [2d 5s 4d] [2c]
1d9664c2: checks
Hero: checks
*** RIVER *** [2d 5s 4d 2c] [Ts]
1d9664c2: checks
Hero: bets $0.2
1d9664c2: folds
Uncalled bet ($0.2) returned to Hero
*** SHOWDOWN ***
Hero collected $0.56 from pot
*** SUMMARY ***
Total pot $0.58 | Rake $0.02 | Jackpot $0 | Bingo $0 | Fortune $0 | Tax $0
Board [2d 5s 4d 2c Ts]
Seat 1: 63def097 (button) folded before Flop (didn't bet)
Seat 2: 25d0c293 (small blind) folded before Flop
Seat 3: 1d9664c2 (big blind) folded on the River
Seat 4: Hero won ($0.56)
Seat 5: 33810466 folded before Flop (didn't bet)
Seat 6: 4101fbff folded before Flop (didn't bet)


Poker Hand #RC3811234310: Hold'em No Limit ($0.02/$0.05) - 2025/08/16 13:40:12
Table 'RushAndCash859570' 6-max Seat #1 is the button
Seat 1: Hero ($17.28 in chips)
Seat 2: 7ec4706e ($9.25 in chips)
Seat 3: bacbc16f ($6.33 in chips)
Seat 4: 1c637781 ($3.58 in chips)
Seat 5: c75b8d07 ($5.29 in chips)
Seat 6: c9800535 ($5 in chips)
7ec4706e: posts small blind $0.02
bacbc16f: posts big blind $0.05
*** HOLE CARDS ***
Dealt to Hero [2h Kd]
Dealt to 7ec4706e 
Dealt to bacbc16f 
Dealt to 1c637781 
Dealt to c75b8d07 
Dealt to c9800535 
1c637781: raises $0.06 to $0.11
c75b8d07: folds
c9800535: folds
Hero: folds
7ec4706e: folds
bacbc16f: calls $0.06
*** FLOP *** [Ah Ts Qd]
bacbc16f: checks
1c637781: bets $0.12
bacbc16f: folds
Uncalled bet ($0.12) returned to 1c637781
*** SHOWDOWN ***
1c637781 collected $0.23 from pot
*** SUMMARY ***
Total pot $0.24 | Rake $0.01 | Jackpot $0 | Bingo $0 | Fortune $0 | Tax $0
Board [Ah Ts Qd]
Seat 1: Hero (button) folded before Flop (didn't bet)
Seat 2: 7ec4706e (small blind) folded before Flop
Seat 3: bacbc16f (big blind) folded on the Flop
Seat 4: 1c637781 won ($0.23)
Seat 5: c75b8d07 folded before Flop (didn't bet)
Seat 6: c9800535 folded before Flop (didn't bet)


Poker Hand #RC3811234253: Hold'em No Limit ($0.02/$0.05) - 2025/08/16 13:40:00
Table 'RushAndCash859513' 6-max Seat #1 is the button
Seat 1: c923a998 ($8.32 in chips)
Seat 2: 4e1819fa ($1.35 in chips)
Seat 3: Hero ($17.33 in chips)
Seat 4: 4cb04e7a ($5.06 in chips)
Seat 5: 745a5d64 ($5 in chips)
Seat 6: 88134a34 ($5.14 in chips)
4e1819fa: posts small blind $0.02
Hero: posts big blind $0.05
*** HOLE CARDS ***
Dealt to c923a998 
Dealt to 4e1819fa 
Dealt to Hero [Qc 3h]
Dealt to 4cb04e7a 
Dealt to 745a5d64 
Dealt to 88134a34 
4cb04e7a: folds
745a5d64: raises $0.08 to $0.13
88134a34: folds
c923a998: folds
4e1819fa: folds
Hero: folds
Uncalled bet ($0.08) returned to 745a5d64
*** SHOWDOWN ***
745a5d64 collected $0.12 from pot
*** SUMMARY ***
Total pot $0.12 | Rake $0 | Jackpot $0 | Bingo $0 | Fortune $0 | Tax $0
Seat 1: c923a998 (button) folded before Flop (didn't bet)
Seat 2: 4e1819fa (small blind) folded before Flop
Seat 3: Hero (big blind) folded before Flop
Seat 4: 4cb04e7a folded before Flop (didn't bet)
Seat 5: 745a5d64 collected ($0.12)
Seat 6: 88134a34 folded before Flop (didn't bet)


Poker Hand #RC3811234233: Hold'em No Limit ($0.02/$0.05) - 2025/08/16 13:39:55
Table 'RushAndCash859493' 6-max Seat #1 is the button
Seat 1: 3ccbf3d2 ($5.07 in chips)
Seat 2: d1763fe4 ($9.48 in chips)
Seat 3: e6780e8f ($14.22 in chips)
Seat 4: e458bc9d ($6.4 in chips)
Seat 5: bacbc16f ($6.35 in chips)
Seat 6: Hero ($17.33 in chips)
d1763fe4: posts small blind $0.02
e6780e8f: posts big blind $0.05
*** HOLE CARDS ***
Dealt to 3ccbf3d2 
Dealt to d1763fe4 
Dealt to e6780e8f 
Dealt to e458bc9d 
Dealt to bacbc16f 
Dealt to Hero [5h 2d]
e458bc9d: folds
bacbc16f: folds
Hero: folds
3ccbf3d2: folds
d1763fe4: folds
Uncalled bet ($0.03) returned to e6780e8f
*** SHOWDOWN ***
e6780e8f collected $0.04 from pot
*** SUMMARY ***
Total pot $0.04 | Rake $0 | Jackpot $0 | Bingo $0 | Fortune $0 | Tax $0
Seat 1: 3ccbf3d2 (button) folded before Flop (didn't bet)
Seat 2: d1763fe4 (small blind) folded before Flop
Seat 3: e6780e8f (big blind) collected ($0.04)
Seat 4: e458bc9d folded before Flop (didn't bet)
Seat 5: bacbc16f folded before Flop (didn't bet)
Seat 6: Hero folded before Flop (didn't bet)


Poker Hand #RC3811234215: Hold'em No Limit ($0.02/$0.05) - 2025/08/16 13:39:52
Table 'RushAndCash859475' 6-max Seat #1 is the button
Seat 1: 4cb04e7a ($5.06 in chips)
Seat 2: 750cd3 ($5.61 in chips)
Seat 3: cb635fd7 ($6.5 in chips)
Seat 4: Hero ($17.33 in chips)
Seat 5: a98f555a ($5 in chips)
Seat 6: 73ff40f7 ($5 in chips)
750cd3: posts small blind $0.02
cb635fd7: posts big blind $0.05
*** HOLE CARDS ***
Dealt to 4cb04e7a 
Dealt to 750cd3 
Dealt to cb635fd7 
Dealt to Hero [9d 4h]
Dealt to a98f555a 
Dealt to 73ff40f7 
Hero: folds
a98f555a: raises $0.05 to $0.1
73ff40f7: folds
4cb04e7a: folds
750cd3: folds
cb635fd7: folds
Uncalled bet ($0.05) returned to a98f555a
*** SHOWDOWN ***
a98f555a collected $0.12 from pot
*** SUMMARY ***
Total pot $0.12 | Rake $0 | Jackpot $0 | Bingo $0 | Fortune $0 | Tax $0
Seat 1: 4cb04e7a (button) folded before Flop (didn't bet)
Seat 2: 750cd3 (small blind) folded before Flop
Seat 3: cb635fd7 (big blind) folded before Flop
Seat 4: Hero folded before Flop (didn't bet)
Seat 5: a98f555a collected ($0.12)
Seat 6: 73ff40f7 folded before Flop (didn't bet)


Poker Hand #RC3811233565: Hold'em No Limit ($0.02/$0.05) - 2025/08/16 13:37:14
Table 'RushAndCash858825' 6-max Seat #1 is the button
Seat 1: Hero ($17.33 in chips)
Seat 2: 75a945c ($6.17 in chips)
Seat 3: 56099b06 ($4.11 in chips)
Seat 4: 581acabe ($5 in chips)
Seat 5: 5340c595 ($17.93 in chips)
Seat 6: 7dec114f ($5.54 in chips)
75a945c: posts small blind $0.02
56099b06: posts big blind $0.05
*** HOLE CARDS ***
Dealt to Hero [4c 7s]
Dealt to 75a945c 
Dealt to 56099b06 
Dealt to 581acabe 
Dealt to 5340c595 
Dealt to 7dec114f 
581acabe: folds
5340c595: folds
7dec114f: raises $0.06 to $0.11
Hero: folds
75a945c: folds
56099b06: folds
Uncalled bet ($0.06) returned to 7dec114f
*** SHOWDOWN ***
7dec114f collected $0.12 from pot
*** SUMMARY ***
Total pot $0.12 | Rake $0 | Jackpot $0 | Bingo $0 | Fortune $0 | Tax $0
Seat 1: Hero (button) folded before Flop (didn't bet)
Seat 2: 75a945c (small blind) folded before Flop
Seat 3: 56099b06 (big blind) folded before Flop
Seat 4: 581acabe folded before Flop (didn't bet)
Seat 5: 5340c595 folded before Flop (didn't bet)
Seat 6: 7dec114f collected ($0.12)


Poker Hand #RC3811233543: Hold'em No Limit ($0.02/$0.05) - 2025/08/16 13:37:09
Table 'RushAndCash858803' 6-max Seat #1 is the button
Seat 1: 4b1c021d ($2.05 in chips)
Seat 2: Hero ($17.35 in chips)
Seat 3: 3fee27f9 ($11.49 in chips)
Seat 4: 4dde9102 ($6.8 in chips)
Seat 5: 3ad9a194 ($9.82 in chips)
Seat 6: b05cbd91 ($5.43 in chips)
Hero: posts small blind $0.02
3fee27f9: posts big blind $0.05
*** HOLE CARDS ***
Dealt to 4b1c021d 
Dealt to Hero [3s 6s]
Dealt to 3fee27f9 
Dealt to 4dde9102 
Dealt to 3ad9a194 
Dealt to b05cbd91 
4dde9102: folds
3ad9a194: folds
b05cbd91: folds
4b1c021d: raises $0.05 to $0.1
Hero: folds
3fee27f9: calls $0.05
*** FLOP *** [6d 9d 8h]
3fee27f9: checks
4b1c021d: checks
*** TURN *** [6d 9d 8h] [5h]
3fee27f9: bets $0.12
4b1c021d: folds
Uncalled bet ($0.12) returned to 3fee27f9
*** SHOWDOWN ***
3fee27f9 collected $0.21 from pot
*** SUMMARY ***
Total pot $0.22 | Rake $0.01 | Jackpot $0 | Bingo $0 | Fortune $0 | Tax $0
Board [6d 9d 8h 5h]
Seat 1: 4b1c021d (button) folded on the Turn
Seat 2: Hero (small blind) folded before Flop
Seat 3: 3fee27f9 (big blind) won ($0.21)
Seat 4: 4dde9102 folded before Flop (didn't bet)
Seat 5: 3ad9a194 folded before Flop (didn't bet)
Seat 6: b05cbd91 folded before Flop (didn't bet)


Poker Hand #RC3811233515: Hold'em No Limit ($0.02/$0.05) - 2025/08/16 13:37:03
Table 'RushAndCash858775' 6-max Seat #1 is the button
Seat 1: d73e29e7 ($8.33 in chips)
Seat 2: 2004182d ($9.51 in chips)
Seat 3: af513a68 ($39.67 in chips)
Seat 4: d8ef1268 ($6.78 in chips)
Seat 5: ec79c726 ($6.35 in chips)
Seat 6: Hero ($17.35 in chips)
2004182d: posts small blind $0.02
af513a68: posts big blind $0.05
*** HOLE CARDS ***
Dealt to d73e29e7 
Dealt to 2004182d 
Dealt to af513a68 
Dealt to d8ef1268 
Dealt to ec79c726 
Dealt to Hero [4h 2d]
d8ef1268: raises $0.05 to $0.1
ec79c726: calls $0.1
Hero: folds
d73e29e7: calls $0.1
2004182d: folds
af513a68: folds
*** FLOP *** [5c Ts Td]
d8ef1268: bets $0.13
ec79c726: folds
d73e29e7: folds
Uncalled bet ($0.13) returned to d8ef1268
*** SHOWDOWN ***
d8ef1268 collected $0.36 from pot
*** SUMMARY ***
Total pot $0.37 | Rake $0.01 | Jackpot $0 | Bingo $0 | Fortune $0 | Tax $0
Board [5c Ts Td]
Seat 1: d73e29e7 (button) folded on the Flop
Seat 2: 2004182d (small blind) folded before Flop
Seat 3: af513a68 (big blind) folded before Flop
Seat 4: d8ef1268 won ($0.36)
Seat 5: ec79c726 folded on the Flop
Seat 6: Hero folded before Flop (didn't bet)


Poker Hand #RC3811233476: Hold'em No Limit ($0.02/$0.05) - 2025/08/16 13:36:53
Table 'RushAndCash858736' 6-max Seat #1 is the button
Seat 1: d6982f15 ($5 in chips)
Seat 2: 402429e5 ($5 in chips)
Seat 3: Hero ($17.4 in chips)
Seat 4: e6e1a23a ($8.11 in chips)
Seat 5: 393048cb ($9.76 in chips)
Seat 6: 5340c595 ($17.98 in chips)
402429e5: posts small blind $0.02
Hero: posts big blind $0.05
*** HOLE CARDS ***
Dealt to d6982f15 
Dealt to 402429e5 
Dealt to Hero [6c Qh]
Dealt to e6e1a23a 
Dealt to 393048cb 
Dealt to 5340c595 
e6e1a23a: folds
393048cb: folds
5340c595: folds
d6982f15: raises $0.08 to $0.13
402429e5: folds
Hero: folds
Uncalled bet ($0.08) returned to d6982f15
*** SHOWDOWN ***
d6982f15 collected $0.12 from pot
*** SUMMARY ***
Total pot $0.12 | Rake $0 | Jackpot $0 | Bingo $0 | Fortune $0 | Tax $0
Seat 1: d6982f15 (button) collected ($0.12)
Seat 2: 402429e5 (small blind) folded before Flop
Seat 3: Hero (big blind) folded before Flop
Seat 4: e6e1a23a folded before Flop (didn't bet)
Seat 5: 393048cb folded before Flop (didn't bet)
Seat 6: 5340c595 folded before Flop (didn't bet)


Poker Hand #RC3811233462: Hold'em No Limit ($0.02/$0.05) - 2025/08/16 13:36:49
Table 'RushAndCash858722' 6-max Seat #1 is the button
Seat 1: ea8334af ($5 in chips)
Seat 2: 1699364e ($6.22 in chips)
Seat 3: 63def097 ($18.11 in chips)
Seat 4: 7dec114f ($5.47 in chips)
Seat 5: Hero ($17.4 in chips)
Seat 6: d1763fe4 ($10.46 in chips)
1699364e: posts small blind $0.02
63def097: posts big blind $0.05
*** HOLE CARDS ***
Dealt to ea8334af 
Dealt to 1699364e 
Dealt to 63def097 
Dealt to 7dec114f 
Dealt to Hero [9h As]
Dealt to d1763fe4 
7dec114f: folds
Hero: folds
d1763fe4: folds
ea8334af: raises $0.1 to $0.15
1699364e: folds
63def097: calls $0.1
*** FLOP *** [Js 7c 7s]
63def097: checks
ea8334af: bets $0.11
63def097: calls $0.11
*** TURN *** [Js 7c 7s] [2c]
63def097: checks
ea8334af: checks
*** RIVER *** [Js 7c 7s 2c] [Ac]
63def097: checks
ea8334af: bets $0.18
63def097: folds
Uncalled bet ($0.18) returned to ea8334af
*** SHOWDOWN ***
ea8334af collected $0.52 from pot
*** SUMMARY ***
Total pot $0.54 | Rake $0.02 | Jackpot $0 | Bingo $0 | Fortune $0 | Tax $0
Board [Js 7c 7s 2c Ac]
Seat 1: ea8334af (button) won ($0.52)
Seat 2: 1699364e (small blind) folded before Flop
Seat 3: 63def097 (big blind) folded on the River
Seat 4: 7dec114f folded before Flop (didn't bet)
Seat 5: Hero folded before Flop (didn't bet)
Seat 6: d1763fe4 folded before Flop (didn't bet)


Poker Hand #RC3811233447: Hold'em No Limit ($0.02/$0.05) - 2025/08/16 13:36:46
Table 'RushAndCash858707' 6-max Seat #1 is the button
Seat 1: c75b8d07 ($5.16 in chips)
Seat 2: d8ef1268 ($6.8 in chips)
Seat 3: 91087b75 ($5.44 in chips)
Seat 4: d67f9738 ($6.04 in chips)
Seat 5: 63def097 ($18.11 in chips)
Seat 6: Hero ($17.4 in chips)
d8ef1268: posts small blind $0.02
91087b75: posts big blind $0.05
*** HOLE CARDS ***
Dealt to c75b8d07 
Dealt to d8ef1268 
Dealt to 91087b75 
Dealt to d67f9738 
Dealt to 63def097 
Dealt to Hero [4h 3s]
d67f9738: folds
63def097: folds
Hero: folds
c75b8d07: folds
d8ef1268: folds
Uncalled bet ($0.03) returned to 91087b75
*** SHOWDOWN ***
91087b75 collected $0.04 from pot
*** SUMMARY ***
Total pot $0.04 | Rake $0 | Jackpot $0 | Bingo $0 | Fortune $0 | Tax $0
Seat 1: c75b8d07 (button) folded before Flop (didn't bet)
Seat 2: d8ef1268 (small blind) folded before Flop
Seat 3: 91087b75 (big blind) collected ($0.04)
Seat 4: d67f9738 folded before Flop (didn't bet)
Seat 5: 63def097 folded before Flop (didn't bet)
Seat 6: Hero folded before Flop (didn't bet)


Poker Hand #RC3811233404: Hold'em No Limit ($0.02/$0.05) - 2025/08/16 13:36:36
Table 'RushAndCash858664' 6-max Seat #1 is the button
Seat 1: Hero ($17.4 in chips)
Seat 2: be24990e ($5.86 in chips)
Seat 3: 3dd958bc ($5 in chips)
Seat 4: 4b713f2c ($5.1 in chips)
Seat 5: edeef0b6 ($5.98 in chips)
Seat 6: 6beec20b ($5.47 in chips)
be24990e: posts small blind $0.02
3dd958bc: posts big blind $0.05
*** HOLE CARDS ***
Dealt to Hero [2s 4h]
Dealt to be24990e 
Dealt to 3dd958bc 
Dealt to 4b713f2c 
Dealt to edeef0b6 
Dealt to 6beec20b 
4b713f2c: folds
edeef0b6: folds
6beec20b: folds
Hero: folds
be24990e: folds
Uncalled bet ($0.03) returned to 3dd958bc
*** SHOWDOWN ***
3dd958bc collected $0.04 from pot
*** SUMMARY ***
Total pot $0.04 | Rake $0 | Jackpot $0 | Bingo $0 | Fortune $0 | Tax $0
Seat 1: Hero (button) folded before Flop (didn't bet)
Seat 2: be24990e (small blind) folded before Flop
Seat 3: 3dd958bc (big blind) collected ($0.04)
Seat 4: 4b713f2c folded before Flop (didn't bet)
Seat 5: edeef0b6 folded before Flop (didn't bet)
Seat 6: 6beec20b folded before Flop (didn't bet)


Poker Hand #RC3811233354: Hold'em No Limit ($0.02/$0.05) - 2025/08/16 13:36:24
Table 'RushAndCash858614' 6-max Seat #1 is the button
Seat 1: Hero ($17.4 in chips)
Seat 2: 88134a34 ($5.07 in chips)
Seat 3: 9e53c5e6 ($8.03 in chips)
Seat 4: 393048cb ($9.62 in chips)
Seat 5: c0b3d5e0 ($5.28 in chips)
Seat 6: 1a55751a ($6.04 in chips)
88134a34: posts small blind $0.02
9e53c5e6: posts big blind $0.05
*** HOLE CARDS ***
Dealt to Hero [2h Kh]
Dealt to 88134a34 
Dealt to 9e53c5e6 
Dealt to 393048cb 
Dealt to c0b3d5e0 
Dealt to 1a55751a 
393048cb: folds
c0b3d5e0: folds
1a55751a: raises $0.08 to $0.13
Hero: folds
88134a34: folds
9e53c5e6: folds
Uncalled bet ($0.08) returned to 1a55751a
*** SHOWDOWN ***
1a55751a collected $0.12 from pot
*** SUMMARY ***
Total pot $0.12 | Rake $0 | Jackpot $0 | Bingo $0 | Fortune $0 | Tax $0
Seat 1: Hero (button) folded before Flop (didn't bet)
Seat 2: 88134a34 (small blind) folded before Flop
Seat 3: 9e53c5e6 (big blind) folded before Flop
Seat 4: 393048cb folded before Flop (didn't bet)
Seat 5: c0b3d5e0 folded before Flop (didn't bet)
Seat 6: 1a55751a collected ($0.12)


Poker Hand #RC3811232921: Hold'em No Limit ($0.02/$0.05) - 2025/08/16 13:34:37
Table 'RushAndCash858181' 6-max Seat #1 is the button
Seat 1: 495abc44 ($5.49 in chips)
Seat 2: 3dbd3479 ($5.45 in chips)
Seat 3: Hero ($17.5 in chips)
Seat 4: bbe74281 ($5 in chips)
Seat 5: 7bf33a65 ($17.87 in chips)
Seat 6: 4e37785d ($11.43 in chips)
3dbd3479: posts small blind $0.02
Hero: posts big blind $0.05
*** HOLE CARDS ***
Dealt to 495abc44 
Dealt to 3dbd3479 
Dealt to Hero [Qc Th]
Dealt to bbe74281 
Dealt to 7bf33a65 
Dealt to 4e37785d 
bbe74281: folds
7bf33a65: folds
4e37785d: raises $0.05 to $0.1
495abc44: folds
3dbd3479: calls $0.08
Hero: calls $0.05
*** FLOP *** [Jh 2c 3c]
3dbd3479: checks
Hero: checks
4e37785d: bets $0.15
3dbd3479: raises $0.3 to $0.45
Hero: folds
4e37785d: raises $0.7 to $1.15
3dbd3479: calls $0.7
*** TURN *** [Jh 2c 3c] [Ts]
3dbd3479: checks
4e37785d: bets $1.2
3dbd3479: calls $1.2
*** RIVER *** [Jh 2c 3c Ts] [8d]
3dbd3479: checks
4e37785d: bets $5
3dbd3479: folds
Uncalled bet ($5) returned to 4e37785d
*** SHOWDOWN ***
4e37785d collected $4.78 from pot
*** SUMMARY ***
Total pot $5 | Rake $0.15 | Jackpot $0.07 | Bingo $0 | Fortune $0 | Tax $0
Board [Jh 2c 3c Ts 8d]
Seat 1: 495abc44 (button) folded before Flop (didn't bet)
Seat 2: 3dbd3479 (small blind) folded on the River
Seat 3: Hero (big blind) folded on the Flop
Seat 4: bbe74281 folded before Flop (didn't bet)
Seat 5: 7bf33a65 folded before Flop (didn't bet)
Seat 6: 4e37785d won ($4.78)


Poker Hand #RC3811232905: Hold'em No Limit ($0.02/$0.05) - 2025/08/16 13:34:33
Table 'RushAndCash858165' 6-max Seat #1 is the button
Seat 1: fe38f94c ($5.17 in chips)
Seat 2: 721d5285 ($12.43 in chips)
Seat 3: d5fb4356 ($5.48 in chips)
Seat 4: 1c015352 ($5.28 in chips)
Seat 5: 4f349a14 ($1.8 in chips)
Seat 6: Hero ($17.5 in chips)
721d5285: posts small blind $0.02
d5fb4356: posts big blind $0.05
*** HOLE CARDS ***
Dealt to fe38f94c 
Dealt to 721d5285 
Dealt to d5fb4356 
Dealt to 1c015352 
Dealt to 4f349a14 
Dealt to Hero [Jh 8s]
1c015352: folds
4f349a14: raises $0.05 to $0.1
Hero: folds
fe38f94c: folds
721d5285: folds
d5fb4356: folds
Uncalled bet ($0.05) returned to 4f349a14
*** SHOWDOWN ***
4f349a14 collected $0.12 from pot
*** SUMMARY ***
Total pot $0.12 | Rake $0 | Jackpot $0 | Bingo $0 | Fortune $0 | Tax $0
Seat 1: fe38f94c (button) folded before Flop (didn't bet)
Seat 2: 721d5285 (small blind) folded before Flop
Seat 3: d5fb4356 (big blind) folded before Flop
Seat 4: 1c015352 folded before Flop (didn't bet)
Seat 5: 4f349a14 collected ($0.12)
Seat 6: Hero folded before Flop (didn't bet)


Poker Hand #RC3811232836: Hold'em No Limit ($0.02/$0.05) - 2025/08/16 13:34:16
Table 'RushAndCash858096' 6-max Seat #1 is the button
Seat 1: 3954240e ($5.02 in chips)
Seat 2: Hero ($17.45 in chips)
Seat 3: 74b4b4bd ($5.73 in chips)
Seat 4: 4c1cfb35 ($7.2 in chips)
Seat 5: 581acabe ($5.05 in chips)
Seat 6: 319f9ef4 ($11.59 in chips)
Hero: posts small blind $0.02
74b4b4bd: posts big blind $0.05
*** HOLE CARDS ***
Dealt to 3954240e 
Dealt to Hero [Td Jh]
Dealt to 74b4b4bd 
Dealt to 4c1cfb35 
Dealt to 581acabe 
Dealt to 319f9ef4 
4c1cfb35: folds
581acabe: folds
319f9ef4: folds
3954240e: folds
Hero: calls $0.03
74b4b4bd: checks
*** FLOP *** [Ac 7d 2c]
Hero: bets $0.05
74b4b4bd: folds
Uncalled bet ($0.05) returned to Hero
*** SHOWDOWN ***
Hero collected $0.1 from pot
*** SUMMARY ***
Total pot $0.1 | Rake $0 | Jackpot $0 | Bingo $0 | Fortune $0 | Tax $0
Board [Ac 7d 2c]
Seat 1: 3954240e (button) folded before Flop (didn't bet)
Seat 2: Hero (small blind) won ($0.1)
Seat 3: 74b4b4bd (big blind) folded on the Flop
Seat 4: 4c1cfb35 folded before Flop (didn't bet)
Seat 5: 581acabe folded before Flop (didn't bet)
Seat 6: 319f9ef4 folded before Flop (didn't bet)


Poker Hand #RC3811232775: Hold'em No Limit ($0.02/$0.05) - 2025/08/16 13:34:03
Table 'RushAndCash858035' 6-max Seat #1 is the button
Seat 1: Hero ($17.45 in chips)
Seat 2: 581acabe ($5.07 in chips)
Seat 3: 53a8645a ($5.8 in chips)
Seat 4: 9d39f851 ($5 in chips)
Seat 5: db6297f2 ($5.21 in chips)
Seat 6: 4aba04ef ($7.29 in chips)
581acabe: posts small blind $0.02
53a8645a: posts big blind $0.05
*** HOLE CARDS ***
Dealt to Hero [4c Js]
Dealt to 581acabe 
Dealt to 53a8645a 
Dealt to 9d39f851 
Dealt to db6297f2 
Dealt to 4aba04ef 
9d39f851: folds
db6297f2: folds
4aba04ef: raises $0.08 to $0.13
Hero: folds
581acabe: folds
53a8645a: calls $0.08
*** FLOP *** [8h Qh 7s]
53a8645a: checks
4aba04ef: bets $0.21
53a8645a: calls $0.21
*** TURN *** [8h Qh 7s] [6c]
53a8645a: checks
4aba04ef: checks
*** RIVER *** [8h Qh 7s 6c] [Ad]
53a8645a: checks
4aba04ef: checks
53a8645a: shows [Jc Ts] (Ace high)
4aba04ef: shows [Qc Kc] (a pair of Queens)
*** SHOWDOWN ***
4aba04ef collected $0.67 from pot
*** SUMMARY ***
Total pot $0.7 | Rake $0.03 | Jackpot $0 | Bingo $0 | Fortune $0 | Tax $0
Board [8h Qh 7s 6c Ad]
Seat 1: Hero (button) folded before Flop (didn't bet)
Seat 2: 581acabe (small blind) folded before Flop
Seat 3: 53a8645a (big blind) showed [Jc Ts] and lost with Ace high
Seat 4: 9d39f851 folded before Flop (didn't bet)
Seat 5: db6297f2 folded before Flop (didn't bet)
Seat 6: 4aba04ef showed [Qc Kc] and won ($0.67) with a pair of Queens


Poker Hand #RC3811232748: Hold'em No Limit ($0.02/$0.05) - 2025/08/16 13:33:58
Table 'RushAndCash858008' 6-max Seat #1 is the button
Seat 1: c699e730 ($4.91 in chips)
Seat 2: 1aeae9fc ($3.4 in chips)
Seat 3: bb00faac ($4.35 in chips)
Seat 4: d4bafd89 ($6.69 in chips)
Seat 5: 9b7ef7b0 ($6.75 in chips)
Seat 6: Hero ($17.45 in chips)
1aeae9fc: posts small blind $0.02
bb00faac: posts big blind $0.05
*** HOLE CARDS ***
Dealt to c699e730 
Dealt to 1aeae9fc 
Dealt to bb00faac 
Dealt to d4bafd89 
Dealt to 9b7ef7b0 
Dealt to Hero [2h Jh]
d4bafd89: raises $0.06 to $0.11
9b7ef7b0: folds
Hero: folds
c699e730: folds
1aeae9fc: calls $0.09
bb00faac: folds
*** FLOP *** [Th Ac 4d]
1aeae9fc: checks
d4bafd89: bets $0.14
1aeae9fc: calls $0.14
*** TURN *** [Th Ac 4d] [Qd]
1aeae9fc: checks
d4bafd89: bets $0.33
1aeae9fc: raises $1.21 to $1.54
d4bafd89: calls $1.21
*** RIVER *** [Th Ac 4d Qd] [9c]
1aeae9fc: bets $1.61 and is all-in
d4bafd89: calls $1.61
1aeae9fc: shows [Ah 6s] (a pair of Aces)
d4bafd89: shows [Ad Ks] (a pair of Aces)
*** SHOWDOWN ***
d4bafd89 collected $6.63 from pot
*** SUMMARY ***
Total pot $6.85 | Rake $0.15 | Jackpot $0.07 | Bingo $0 | Fortune $0 | Tax $0
Board [Th Ac 4d Qd 9c]
Seat 1: c699e730 (button) folded before Flop (didn't bet)
Seat 2: 1aeae9fc (small blind) showed [Ah 6s] and lost with a pair of Aces
Seat 3: bb00faac (big blind) folded before Flop
Seat 4: d4bafd89 showed [Ad Ks] and won ($6.63) with a pair of Aces
Seat 5: 9b7ef7b0 folded before Flop (didn't bet)
Seat 6: Hero folded before Flop (didn't bet)


Poker Hand #RC3811232689: Hold'em No Limit ($0.02/$0.05) - 2025/08/16 13:33:45
Table 'RushAndCash857949' 6-max Seat #1 is the button
Seat 1: b094641b ($5.37 in chips)
Seat 2: cb635fd7 ($6.43 in chips)
Seat 3: Hero ($17.5 in chips)
Seat 4: bbe74281 ($5 in chips)
Seat 5: d808aa45 ($8.73 in chips)
Seat 6: 9ff5c314 ($9.84 in chips)
cb635fd7: posts small blind $0.02
Hero: posts big blind $0.05
*** HOLE CARDS ***
Dealt to b094641b 
Dealt to cb635fd7 
Dealt to Hero [9h 3c]
Dealt to bbe74281 
Dealt to d808aa45 
Dealt to 9ff5c314 
bbe74281: raises $0.05 to $0.1
d808aa45: folds
9ff5c314: folds
b094641b: folds
cb635fd7: folds
Hero: folds
Uncalled bet ($0.05) returned to bbe74281
*** SHOWDOWN ***
bbe74281 collected $0.12 from pot
*** SUMMARY ***
Total pot $0.12 | Rake $0 | Jackpot $0 | Bingo $0 | Fortune $0 | Tax $0
Seat 1: b094641b (button) folded before Flop (didn't bet)
Seat 2: cb635fd7 (small blind) folded before Flop
Seat 3: Hero (big blind) folded before Flop
Seat 4: bbe74281 collected ($0.12)
Seat 5: d808aa45 folded before Flop (didn't bet)
Seat 6: 9ff5c314 folded before Flop (didn't bet)


Poker Hand #RC3811232674: Hold'em No Limit ($0.02/$0.05) - 2025/08/16 13:33:42
Table 'RushAndCash857934' 6-max Seat #1 is the button
Seat 1: 9ff5c314 ($9.84 in chips)
Seat 2: 5284e7b4 ($5.81 in chips)
Seat 3: 21582d9 ($4.98 in chips)
Seat 4: a597ffcf ($11.59 in chips)
Seat 5: Hero ($17.5 in chips)
Seat 6: 91e692ac ($5.42 in chips)
5284e7b4: posts small blind $0.02
21582d9: posts big blind $0.05
*** HOLE CARDS ***
Dealt to 9ff5c314 
Dealt to 5284e7b4 
Dealt to 21582d9 
Dealt to a597ffcf 
Dealt to Hero [6c 4c]
Dealt to 91e692ac 
a597ffcf: folds
Hero: folds
91e692ac: folds
9ff5c314: folds
5284e7b4: raises $0.05 to $0.1
21582d9: folds
Uncalled bet ($0.05) returned to 5284e7b4
*** SHOWDOWN ***
5284e7b4 collected $0.1 from pot
*** SUMMARY ***
Total pot $0.1 | Rake $0 | Jackpot $0 | Bingo $0 | Fortune $0 | Tax $0
Seat 1: 9ff5c314 (button) folded before Flop (didn't bet)
Seat 2: 5284e7b4 (small blind) collected ($0.1)
Seat 3: 21582d9 (big blind) folded before Flop
Seat 4: a597ffcf folded before Flop (didn't bet)
Seat 5: Hero folded before Flop (didn't bet)
Seat 6: 91e692ac folded before Flop (didn't bet)


Poker Hand #RC3811232657: Hold'em No Limit ($0.02/$0.05) - 2025/08/16 13:33:38
Table 'RushAndCash857917' 6-max Seat #1 is the button
Seat 1: 4468dd29 ($5.83 in chips)
Seat 2: bacbc16f ($5.77 in chips)
Seat 3: 6beec20b ($5.01 in chips)
Seat 4: Hero ($17.5 in chips)
Seat 5: 6599ff76 ($9.56 in chips)
Seat 6: c0d1f133 ($5.14 in chips)
bacbc16f: posts small blind $0.02
6beec20b: posts big blind $0.05
*** HOLE CARDS ***
Dealt to 4468dd29 
Dealt to bacbc16f 
Dealt to 6beec20b 
Dealt to Hero [Js 7h]
Dealt to 6599ff76 
Dealt to c0d1f133 
Hero: folds
6599ff76: folds
c0d1f133: raises $0.05 to $0.1
4468dd29: calls $0.1
bacbc16f: folds
6beec20b: folds
*** FLOP *** [Jh 5c 2c]
c0d1f133: checks
4468dd29: checks
*** TURN *** [Jh 5c 2c] [Ad]
c0d1f133: checks
4468dd29: checks
*** RIVER *** [Jh 5c 2c Ad] [3d]
c0d1f133: checks
4468dd29: checks
c0d1f133: shows [9h Kh] (Ace high)
4468dd29: shows [Qc Ts] (Ace high)
*** SHOWDOWN ***
c0d1f133 collected $0.26 from pot
*** SUMMARY ***
Total pot $0.27 | Rake $0.01 | Jackpot $0 | Bingo $0 | Fortune $0 | Tax $0
Board [Jh 5c 2c Ad 3d]
Seat 1: 4468dd29 (button) showed [Qc Ts] and lost with Ace high
Seat 2: bacbc16f (small blind) folded before Flop
Seat 3: 6beec20b (big blind) folded before Flop
Seat 4: Hero folded before Flop (didn't bet)
Seat 5: 6599ff76 folded before Flop (didn't bet)
Seat 6: c0d1f133 showed [9h Kh] and won ($0.26) with Ace high


Poker Hand #RC3811232640: Hold'em No Limit ($0.02/$0.05) - 2025/08/16 13:33:35
Table 'RushAndCash857900' 6-max Seat #1 is the button
Seat 1: cb635fd7 ($6.43 in chips)
Seat 2: a3bdcd1f ($6.87 in chips)
Seat 3: 75983753 ($5.16 in chips)
Seat 4: 9ff5c314 ($9.86 in chips)
Seat 5: Hero ($17.5 in chips)
Seat 6: 72f5f34a ($2.21 in chips)
a3bdcd1f: posts small blind $0.02
75983753: posts big blind $0.05
*** HOLE CARDS ***
Dealt to cb635fd7 
Dealt to a3bdcd1f 
Dealt to 75983753 
Dealt to 9ff5c314 
Dealt to Hero [9s Jh]
Dealt to 72f5f34a 
9ff5c314: folds
Hero: folds
72f5f34a: folds
cb635fd7: folds
a3bdcd1f: raises $0.1 to $0.15
75983753: folds
Uncalled bet ($0.1) returned to a3bdcd1f
*** SHOWDOWN ***
a3bdcd1f collected $0.1 from pot
*** SUMMARY ***
Total pot $0.1 | Rake $0 | Jackpot $0 | Bingo $0 | Fortune $0 | Tax $0
Seat 1: cb635fd7 (button) folded before Flop (didn't bet)
Seat 2: a3bdcd1f (small blind) collected ($0.1)
Seat 3: 75983753 (big blind) folded before Flop
Seat 4: 9ff5c314 folded before Flop (didn't bet)
Seat 5: Hero folded before Flop (didn't bet)
Seat 6: 72f5f34a folded before Flop (didn't bet)


Poker Hand #RC3811232587: Hold'em No Limit ($0.02/$0.05) - 2025/08/16 13:33:24
Table 'RushAndCash857847' 6-max Seat #1 is the button
Seat 1: b094641b ($5.37 in chips)
Seat 2: Hero ($17.52 in chips)
Seat 3: 85e0a327 ($5 in chips)
Seat 4: a61563b7 ($5.71 in chips)
Seat 5: 4b1c021d ($1.42 in chips)
Seat 6: 1b766e4 ($3.03 in chips)
Hero: posts small blind $0.02
85e0a327: posts big blind $0.05
*** HOLE CARDS ***
Dealt to b094641b 
Dealt to Hero [9s 6d]
Dealt to 85e0a327 
Dealt to a61563b7 
Dealt to 4b1c021d 
Dealt to 1b766e4 
a61563b7: raises $0.05 to $0.1
4b1c021d: folds
1b766e4: raises $0.27 to $0.37
b094641b: folds
Hero: folds
85e0a327: folds
a61563b7: calls $0.27
*** FLOP *** [Ks 8h 8c]
a61563b7: checks
1b766e4: bets $0.27
a61563b7: calls $0.27
*** TURN *** [Ks 8h 8c] [9h]
a61563b7: checks
1b766e4: checks
*** RIVER *** [Ks 8h 8c 9h] [Ad]
a61563b7: checks
1b766e4: bets $0.68
a61563b7: folds
Uncalled bet ($0.68) returned to 1b766e4
*** SHOWDOWN ***
1b766e4 collected $1.29 from pot
*** SUMMARY ***
Total pot $1.35 | Rake $0.06 | Jackpot $0 | Bingo $0 | Fortune $0 | Tax $0
Board [Ks 8h 8c 9h Ad]
Seat 1: b094641b (button) folded before Flop (didn't bet)
Seat 2: Hero (small blind) folded before Flop
Seat 3: 85e0a327 (big blind) folded before Flop
Seat 4: a61563b7 folded on the River
Seat 5: 4b1c021d folded before Flop (didn't bet)
Seat 6: 1b766e4 won ($1.29)


Poker Hand #RC3811232564: Hold'em No Limit ($0.02/$0.05) - 2025/08/16 13:33:19
Table 'RushAndCash857824' 6-max Seat #1 is the button
Seat 1: Hero ($17.52 in chips)
Seat 2: 468b87cb ($3.3 in chips)
Seat 3: 154c971f ($10.89 in chips)
Seat 4: 5340c595 ($17.13 in chips)
Seat 5: 5f770ea7 ($5.43 in chips)
Seat 6: b79dccc7 ($5.66 in chips)
468b87cb: posts small blind $0.02
154c971f: posts big blind $0.05
*** HOLE CARDS ***
Dealt to Hero [8h Qd]
Dealt to 468b87cb 
Dealt to 154c971f 
Dealt to 5340c595 
Dealt to 5f770ea7 
Dealt to b79dccc7 
5340c595: folds
5f770ea7: folds
b79dccc7: folds
Hero: folds
468b87cb: calls $0.03
154c971f: checks
*** FLOP *** [Qs Kd Ac]
468b87cb: bets $0.1
154c971f: folds
Uncalled bet ($0.1) returned to 468b87cb
*** SHOWDOWN ***
468b87cb collected $0.1 from pot
*** SUMMARY ***
Total pot $0.1 | Rake $0 | Jackpot $0 | Bingo $0 | Fortune $0 | Tax $0
Board [Qs Kd Ac]
Seat 1: Hero (button) folded before Flop (didn't bet)
Seat 2: 468b87cb (small blind) won ($0.1)
Seat 3: 154c971f (big blind) folded on the Flop
Seat 4: 5340c595 folded before Flop (didn't bet)
Seat 5: 5f770ea7 folded before Flop (didn't bet)
Seat 6: b79dccc7 folded before Flop (didn't bet)


Poker Hand #RC3811232549: Hold'em No Limit ($0.02/$0.05) - 2025/08/16 13:33:15
Table 'RushAndCash857809' 6-max Seat #1 is the button
Seat 1: 43a9ac7f ($5.19 in chips)
Seat 2: 661d2b18 ($8.95 in chips)
Seat 3: ed530cde ($9.26 in chips)
Seat 4: dda95519 ($17.32 in chips)
Seat 5: afe1730a ($2.08 in chips)
Seat 6: Hero ($17.52 in chips)
661d2b18: posts small blind $0.02
ed530cde: posts big blind $0.05
*** HOLE CARDS ***
Dealt to 43a9ac7f 
Dealt to 661d2b18 
Dealt to ed530cde 
Dealt to dda95519 
Dealt to afe1730a 
Dealt to Hero [Js 8d]
dda95519: folds
afe1730a: folds
Hero: folds
43a9ac7f: raises $0.08 to $0.13
661d2b18: folds
ed530cde: folds
Uncalled bet ($0.08) returned to 43a9ac7f
*** SHOWDOWN ***
43a9ac7f collected $0.12 from pot
*** SUMMARY ***
Total pot $0.12 | Rake $0 | Jackpot $0 | Bingo $0 | Fortune $0 | Tax $0
Seat 1: 43a9ac7f (button) collected ($0.12)
Seat 2: 661d2b18 (small blind) folded before Flop
Seat 3: ed530cde (big blind) folded before Flop
Seat 4: dda95519 folded before Flop (didn't bet)
Seat 5: afe1730a folded before Flop (didn't bet)
Seat 6: Hero folded before Flop (didn't bet)


Poker Hand #RC3811232532: Hold'em No Limit ($0.02/$0.05) - 2025/08/16 13:33:12
Table 'RushAndCash857792' 6-max Seat #1 is the button
Seat 1: 8ebce41a ($6.45 in chips)
Seat 2: d981cd10 ($5.02 in chips)
Seat 3: ab6c0fb8 ($5.19 in chips)
Seat 4: Hero ($17.52 in chips)
Seat 5: c31e283f ($5 in chips)
Seat 6: 4f349a14 ($2 in chips)
d981cd10: posts small blind $0.02
ab6c0fb8: posts big blind $0.05
*** HOLE CARDS ***
Dealt to 8ebce41a 
Dealt to d981cd10 
Dealt to ab6c0fb8 
Dealt to Hero [7h Qc]
Dealt to c31e283f 
Dealt to 4f349a14 
Hero: folds
c31e283f: folds
4f349a14: raises $0.05 to $0.1
8ebce41a: folds
d981cd10: folds
ab6c0fb8: calls $0.05
*** FLOP *** [3h 2s Qd]
ab6c0fb8: checks
4f349a14: bets $0.05
ab6c0fb8: calls $0.05
*** TURN *** [3h 2s Qd] [6h]
ab6c0fb8: checks
4f349a14: checks
*** RIVER *** [3h 2s Qd 6h] [9s]
ab6c0fb8: checks
4f349a14: bets $0.05
ab6c0fb8: calls $0.05
4f349a14: shows [Td 8d] (Queen high)
ab6c0fb8: shows [Tc Ah] (Ace high)
*** SHOWDOWN ***
ab6c0fb8 collected $0.4 from pot
*** SUMMARY ***
Total pot $0.42 | Rake $0.02 | Jackpot $0 | Bingo $0 | Fortune $0 | Tax $0
Board [3h 2s Qd 6h 9s]
Seat 1: 8ebce41a (button) folded before Flop (didn't bet)
Seat 2: d981cd10 (small blind) folded before Flop
Seat 3: ab6c0fb8 (big blind) showed [Tc Ah] and won ($0.4) with Ace high
Seat 4: Hero folded before Flop (didn't bet)
Seat 5: c31e283f folded before Flop (didn't bet)
Seat 6: 4f349a14 showed [Td 8d] and lost with Queen high


Poker Hand #RC3811232312: Hold'em No Limit ($0.02/$0.05) - 2025/08/16 13:32:20
Table 'RushAndCash857572' 6-max Seat #1 is the button
Seat 1: 58fd7293 ($8.81 in chips)
Seat 2: c31e283f ($5.07 in chips)
Seat 3: dc4b476b ($7.2 in chips)
Seat 4: 5f770ea7 ($5.23 in chips)
Seat 5: Hero ($17.27 in chips)
Seat 6: be02a95d ($12.89 in chips)
c31e283f: posts small blind $0.02
dc4b476b: posts big blind $0.05
*** HOLE CARDS ***
Dealt to 58fd7293 
Dealt to c31e283f 
Dealt to dc4b476b 
Dealt to 5f770ea7 
Dealt to Hero [Qs Kh]
Dealt to be02a95d 
5f770ea7: folds
Hero: raises $0.05 to $0.1
be02a95d: folds
58fd7293: folds
c31e283f: calls $0.08
dc4b476b: folds
*** FLOP *** [7s 2s Ts]
c31e283f: checks
Hero: bets $0.12
c31e283f: calls $0.12
*** TURN *** [7s 2s Ts] [4d]
c31e283f: checks
Hero: bets $0.58
c31e283f: folds
Uncalled bet ($0.58) returned to Hero
*** SHOWDOWN ***
Hero collected $0.47 from pot
*** SUMMARY ***
Total pot $0.49 | Rake $0.02 | Jackpot $0 | Bingo $0 | Fortune $0 | Tax $0
Board [7s 2s Ts 4d]
Seat 1: 58fd7293 (button) folded before Flop (didn't bet)
Seat 2: c31e283f (small blind) folded on the Turn
Seat 3: dc4b476b (big blind) folded before Flop
Seat 4: 5f770ea7 folded before Flop (didn't bet)
Seat 5: Hero won ($0.47)
Seat 6: be02a95d folded before Flop (didn't bet)


Poker Hand #RC3811232244: Hold'em No Limit ($0.02/$0.05) - 2025/08/16 13:32:06
Table 'RushAndCash857504' 6-max Seat #1 is the button
Seat 1: 8c9e3686 ($16.49 in chips)
Seat 2: Hero ($17.29 in chips)
Seat 3: 73d970a4 ($5 in chips)
Seat 4: e6780e8f ($11.31 in chips)
Seat 5: 593f18a4 ($5.07 in chips)
Seat 6: 721b1a93 ($5 in chips)
Hero: posts small blind $0.02
73d970a4: posts big blind $0.05
*** HOLE CARDS ***
Dealt to 8c9e3686 
Dealt to Hero [5s Jh]
Dealt to 73d970a4 
Dealt to e6780e8f 
Dealt to 593f18a4 
Dealt to 721b1a93 
e6780e8f: raises $0.07 to $0.12
593f18a4: folds
721b1a93: folds
8c9e3686: folds
Hero: folds
73d970a4: folds
Uncalled bet ($0.07) returned to e6780e8f
*** SHOWDOWN ***
e6780e8f collected $0.12 from pot
*** SUMMARY ***
Total pot $0.12 | Rake $0 | Jackpot $0 | Bingo $0 | Fortune $0 | Tax $0
Seat 1: 8c9e3686 (button) folded before Flop (didn't bet)
Seat 2: Hero (small blind) folded before Flop
Seat 3: 73d970a4 (big blind) folded before Flop
Seat 4: e6780e8f collected ($0.12)
Seat 5: 593f18a4 folded before Flop (didn't bet)
Seat 6: 721b1a93 folded before Flop (didn't bet)


Poker Hand #RC3811232228: Hold'em No Limit ($0.02/$0.05) - 2025/08/16 13:32:03
Table 'RushAndCash857488' 6-max Seat #1 is the button
Seat 1: 1aa8b56a ($8.97 in chips)
Seat 2: 37c2e948 ($9.54 in chips)
Seat 3: a3bdcd1f ($6.85 in chips)
Seat 4: Hero ($17.29 in chips)
Seat 5: 5340c595 ($16.73 in chips)
Seat 6: 56099b06 ($3.69 in chips)
37c2e948: posts small blind $0.02
a3bdcd1f: posts big blind $0.05
*** HOLE CARDS ***
Dealt to 1aa8b56a 
Dealt to 37c2e948 
Dealt to a3bdcd1f 
Dealt to Hero [Ks 4s]
Dealt to 5340c595 
Dealt to 56099b06 
Hero: folds
5340c595: folds
56099b06: folds
1aa8b56a: folds
37c2e948: raises $0.1 to $0.15
a3bdcd1f: calls $0.1
*** FLOP *** [3s 9d 6h]
37c2e948: bets $0.23
a3bdcd1f: folds
Uncalled bet ($0.23) returned to 37c2e948
*** SHOWDOWN ***
37c2e948 collected $0.29 from pot
*** SUMMARY ***
Total pot $0.3 | Rake $0.01 | Jackpot $0 | Bingo $0 | Fortune $0 | Tax $0
Board [3s 9d 6h]
Seat 1: 1aa8b56a (button) folded before Flop (didn't bet)
Seat 2: 37c2e948 (small blind) won ($0.29)
Seat 3: a3bdcd1f (big blind) folded on the Flop
Seat 4: Hero folded before Flop (didn't bet)
Seat 5: 5340c595 folded before Flop (didn't bet)
Seat 6: 56099b06 folded before Flop (didn't bet)


Poker Hand #RC3811232184: Hold'em No Limit ($0.02/$0.05) - 2025/08/16 13:31:54
Table 'RushAndCash857444' 6-max Seat #1 is the button
Seat 1: 593f18a4 ($5 in chips)
Seat 2: be02a95d ($12.88 in chips)
Seat 3: Hero ($17.34 in chips)
Seat 4: 64f7200e ($8.78 in chips)
Seat 5: 53a135ae ($5.25 in chips)
Seat 6: 78853799 ($5.71 in chips)
be02a95d: posts small blind $0.02
Hero: posts big blind $0.05
*** HOLE CARDS ***
Dealt to 593f18a4 
Dealt to be02a95d 
Dealt to Hero [Kd 2d]
Dealt to 64f7200e 
Dealt to 53a135ae 
Dealt to 78853799 
64f7200e: folds
53a135ae: folds
78853799: folds
593f18a4: raises $0.1 to $0.15
be02a95d: folds
Hero: folds
Uncalled bet ($0.1) returned to 593f18a4
*** SHOWDOWN ***
593f18a4 collected $0.12 from pot
*** SUMMARY ***
Total pot $0.12 | Rake $0 | Jackpot $0 | Bingo $0 | Fortune $0 | Tax $0
Seat 1: 593f18a4 (button) collected ($0.12)
Seat 2: be02a95d (small blind) folded before Flop
Seat 3: Hero (big blind) folded before Flop
Seat 4: 64f7200e folded before Flop (didn't bet)
Seat 5: 53a135ae folded before Flop (didn't bet)
Seat 6: 78853799 folded before Flop (didn't bet)


Poker Hand #RC3811232155: Hold'em No Limit ($0.02/$0.05) - 2025/08/16 13:31:47
Table 'RushAndCash857415' 6-max Seat #1 is the button
Seat 1: 4ef6f023 ($2.93 in chips)
Seat 2: 3ad9a194 ($10.26 in chips)
Seat 3: 917f3e19 ($7.05 in chips)
Seat 4: bda60576 ($5 in chips)
Seat 5: Hero ($17.34 in chips)
Seat 6: 175b5c79 ($5.49 in chips)
3ad9a194: posts small blind $0.02
917f3e19: posts big blind $0.05
*** HOLE CARDS ***
Dealt to 4ef6f023 
Dealt to 3ad9a194 
Dealt to 917f3e19 
Dealt to bda60576 
Dealt to Hero [Jc Td]
Dealt to 175b5c79 
bda60576: folds
Hero: folds
175b5c79: folds
4ef6f023: folds
3ad9a194: raises $0.1 to $0.15
917f3e19: folds
Uncalled bet ($0.1) returned to 3ad9a194
*** SHOWDOWN ***
3ad9a194 collected $0.1 from pot
*** SUMMARY ***
Total pot $0.1 | Rake $0 | Jackpot $0 | Bingo $0 | Fortune $0 | Tax $0
Seat 1: 4ef6f023 (button) folded before Flop (didn't bet)
Seat 2: 3ad9a194 (small blind) collected ($0.1)
Seat 3: 917f3e19 (big blind) folded before Flop
Seat 4: bda60576 folded before Flop (didn't bet)
Seat 5: Hero folded before Flop (didn't bet)
Seat 6: 175b5c79 folded before Flop (didn't bet)


Poker Hand #RC3811231658: Hold'em No Limit ($0.02/$0.05) - 2025/08/16 13:29:51
Table 'RushAndCash856918' 6-max Seat #1 is the button
Seat 1: 1699364e ($5.04 in chips)
Seat 2: af513a68 ($39.68 in chips)
Seat 3: Hero ($17.39 in chips)
Seat 4: 38dd435b ($5.2 in chips)
Seat 5: 19480dc1 ($5.05 in chips)
Seat 6: a3d0f02e ($5 in chips)
af513a68: posts small blind $0.02
Hero: posts big blind $0.05
*** HOLE CARDS ***
Dealt to 1699364e 
Dealt to af513a68 
Dealt to Hero [Ad Jc]
Dealt to 38dd435b 
Dealt to 19480dc1 
Dealt to a3d0f02e 
38dd435b: folds
19480dc1: folds
a3d0f02e: folds
1699364e: folds
af513a68: raises $0.1 to $0.15
Hero: folds
Uncalled bet ($0.1) returned to af513a68
*** SHOWDOWN ***
af513a68 collected $0.1 from pot
*** SUMMARY ***
Total pot $0.1 | Rake $0 | Jackpot $0 | Bingo $0 | Fortune $0 | Tax $0
Seat 1: 1699364e (button) folded before Flop (didn't bet)
Seat 2: af513a68 (small blind) collected ($0.1)
Seat 3: Hero (big blind) folded before Flop
Seat 4: 38dd435b folded before Flop (didn't bet)
Seat 5: 19480dc1 folded before Flop (didn't bet)
Seat 6: a3d0f02e folded before Flop (didn't bet)


Poker Hand #RC3811231644: Hold'em No Limit ($0.02/$0.05) - 2025/08/16 13:29:48
Table 'RushAndCash856904' 6-max Seat #1 is the button
Seat 1: cce07217 ($5.3 in chips)
Seat 2: ca49942f ($14.23 in chips)
Seat 3: 33810466 ($5.57 in chips)
Seat 4: Hero ($17.39 in chips)
Seat 5: 1699364e ($5.04 in chips)
Seat 6: 210eab90 ($4.65 in chips)
ca49942f: posts small blind $0.02
33810466: posts big blind $0.05
*** HOLE CARDS ***
Dealt to cce07217 
Dealt to ca49942f 
Dealt to 33810466 
Dealt to Hero [3s 4d]
Dealt to 1699364e 
Dealt to 210eab90 
Hero: folds
1699364e: folds
210eab90: folds
cce07217: raises $0.05 to $0.1
ca49942f: raises $0.35 to $0.45
33810466: raises $0.8 to $1.25
cce07217: folds
ca49942f: raises $12.98 to $14.23 and is all-in
33810466: calls $4.32 and is all-in
Uncalled bet ($8.66) returned to ca49942f
ca49942f: shows [Kd Ks]
33810466: shows [Kh As]
*** FIRST FLOP *** [Tc 2c 7d]
*** FIRST TURN *** [Tc 2c 7d] [Jd]
*** FIRST RIVER *** [Tc 2c 7d Jd] [9d]
*** SECOND FLOP *** [4c 6s Jc]
*** SECOND TURN *** [4c 6s Jc] [5c]
*** SECOND RIVER *** [4c 6s Jc 5c] [4s]
*** FIRST SHOWDOWN ***
ca49942f collected $5.52 from pot
*** SECOND SHOWDOWN ***
ca49942f collected $5.51 from pot
*** SUMMARY ***
Total pot $11.24 | Rake $0.14 | Jackpot $0.07 | Bingo $0 | Fortune $0 | Tax $0
Hand was run two times
FIRST Board [Tc 2c 7d Jd 9d]
SECOND Board [4c 6s Jc 5c 4s]
Seat 1: cce07217 (button) folded before Flop
Seat 2: ca49942f (small blind) showed [Kd Ks] and won ($5.52) with a pair of Kings, and won ($5.51) with two pair, Kings and Fours
Seat 3: 33810466 (big blind) showed [Kh As] and lost with Ace high, and lost with a pair of Fours
Seat 4: Hero folded before Flop (didn't bet)
Seat 5: 1699364e folded before Flop (didn't bet)
Seat 6: 210eab90 folded before Flop (didn't bet)


Poker Hand #RC3811231624: Hold'em No Limit ($0.02/$0.05) - 2025/08/16 13:29:43
Table 'RushAndCash856884' 6-max Seat #1 is the button
Seat 1: 21582d9 ($3.96 in chips)
Seat 2: 4698ae62 ($5.81 in chips)
Seat 3: 73d970a4 ($5 in chips)
Seat 4: Hero ($17.39 in chips)
Seat 5: 2897861c ($10 in chips)
Seat 6: 14d9c001 ($5 in chips)
4698ae62: posts small blind $0.02
73d970a4: posts big blind $0.05
*** HOLE CARDS ***
Dealt to 21582d9 
Dealt to 4698ae62 
Dealt to 73d970a4 
Dealt to Hero [3s 5s]
Dealt to 2897861c 
Dealt to 14d9c001 
Hero: folds
2897861c: folds
14d9c001: raises $0.05 to $0.1
21582d9: folds
4698ae62: folds
73d970a4: calls $0.05
*** FLOP *** [Th 2s 7h]
73d970a4: checks
14d9c001: checks
*** TURN *** [Th 2s 7h] [Js]
73d970a4: checks
14d9c001: checks
*** RIVER *** [Th 2s 7h Js] [6d]
73d970a4: checks
14d9c001: checks
73d970a4: shows [4c 6c] (a pair of Sixes)
14d9c001: shows [Ah Qs] (Ace high)
*** SHOWDOWN ***
73d970a4 collected $0.21 from pot
*** SUMMARY ***
Total pot $0.22 | Rake $0.01 | Jackpot $0 | Bingo $0 | Fortune $0 | Tax $0
Board [Th 2s 7h Js 6d]
Seat 1: 21582d9 (button) folded before Flop (didn't bet)
Seat 2: 4698ae62 (small blind) folded before Flop
Seat 3: 73d970a4 (big blind) showed [4c 6c] and won ($0.21) with a pair of Sixes
Seat 4: Hero folded before Flop (didn't bet)
Seat 5: 2897861c folded before Flop (didn't bet)
Seat 6: 14d9c001 showed [Ah Qs] and lost with Ace high


Poker Hand #RC3811231462: Hold'em No Limit ($0.02/$0.05) - 2025/08/16 13:29:07
Table 'RushAndCash856722' 6-max Seat #1 is the button
Seat 1: fdba6534 ($10.44 in chips)
Seat 2: 72f5f34a ($2.05 in chips)
Seat 3: a3d0f02e ($5 in chips)
Seat 4: a4bd3437 ($5.59 in chips)
Seat 5: 6f8d5760 ($5.3 in chips)
Seat 6: Hero ($17.28 in chips)
72f5f34a: posts small blind $0.02
a3d0f02e: posts big blind $0.05
*** HOLE CARDS ***
Dealt to fdba6534 
Dealt to 72f5f34a 
Dealt to a3d0f02e 
Dealt to a4bd3437 
Dealt to 6f8d5760 
Dealt to Hero [Js Ah]
a4bd3437: folds
6f8d5760: folds
Hero: raises $0.05 to $0.1
fdba6534: folds
72f5f34a: folds
a3d0f02e: calls $0.05
*** FLOP *** [8d Ac 3h]
a3d0f02e: checks
Hero: checks
*** TURN *** [8d Ac 3h] [3c]
a3d0f02e: checks
Hero: bets $0.14
a3d0f02e: folds
Uncalled bet ($0.14) returned to Hero
*** SHOWDOWN ***
Hero collected $0.21 from pot
*** SUMMARY ***
Total pot $0.22 | Rake $0.01 | Jackpot $0 | Bingo $0 | Fortune $0 | Tax $0
Board [8d Ac 3h 3c]
Seat 1: fdba6534 (button) folded before Flop (didn't bet)
Seat 2: 72f5f34a (small blind) folded before Flop
Seat 3: a3d0f02e (big blind) folded on the Turn
Seat 4: a4bd3437 folded before Flop (didn't bet)
Seat 5: 6f8d5760 folded before Flop (didn't bet)
Seat 6: Hero won ($0.21)


Poker Hand #RC3811231160: Hold'em No Limit ($0.02/$0.05) - 2025/08/16 13:28:00
Table 'RushAndCash856420' 6-max Seat #1 is the button
Seat 1: 7dec114f ($5.34 in chips)
Seat 2: Hero ($17.77 in chips)
Seat 3: 2938d11a ($15.48 in chips)
Seat 4: 48e9176f ($22.8 in chips)
Seat 5: bbe74281 ($5.42 in chips)
Seat 6: a4bd3437 ($5 in chips)
Hero: posts small blind $0.02
2938d11a: posts big blind $0.05
*** HOLE CARDS ***
Dealt to 7dec114f 
Dealt to Hero [Ks Qc]
Dealt to 2938d11a 
Dealt to 48e9176f 
Dealt to bbe74281 
Dealt to a4bd3437 
48e9176f: folds
bbe74281: folds
a4bd3437: raises $0.1 to $0.15
7dec114f: folds
Hero: calls $0.13
2938d11a: calls $0.1
*** FLOP *** [Td 4s Ac]
Hero: checks
2938d11a: checks
a4bd3437: bets $0.34
Hero: calls $0.34
2938d11a: folds
*** TURN *** [Td 4s Ac] [Kh]
Hero: checks
a4bd3437: bets $0.62
Hero: folds
Uncalled bet ($0.62) returned to a4bd3437
*** SHOWDOWN ***
a4bd3437 collected $1.08 from pot
*** SUMMARY ***
Total pot $1.13 | Rake $0.05 | Jackpot $0 | Bingo $0 | Fortune $0 | Tax $0
Board [Td 4s Ac Kh]
Seat 1: 7dec114f (button) folded before Flop (didn't bet)
Seat 2: Hero (small blind) folded on the Turn
Seat 3: 2938d11a (big blind) folded on the Flop
Seat 4: 48e9176f folded before Flop (didn't bet)
Seat 5: bbe74281 folded before Flop (didn't bet)
Seat 6: a4bd3437 won ($1.08)


Poker Hand #RC3811231088: Hold'em No Limit ($0.02/$0.05) - 2025/08/16 13:27:43
Table 'RushAndCash856348' 6-max Seat #1 is the button
Seat 1: Hero ($17.77 in chips)
Seat 2: e58b9f8d ($5.02 in chips)
Seat 3: 7dcc690a ($13.25 in chips)
Seat 4: 37c2e948 ($13.56 in chips)
Seat 5: 9be50a ($5.21 in chips)
Seat 6: 6daf85fc ($5 in chips)
e58b9f8d: posts small blind $0.02
7dcc690a: posts big blind $0.05
*** HOLE CARDS ***
Dealt to Hero [Qh Ts]
Dealt to e58b9f8d 
Dealt to 7dcc690a 
Dealt to 37c2e948 
Dealt to 9be50a 
Dealt to 6daf85fc 
37c2e948: raises $0.05 to $0.1
9be50a: folds
6daf85fc: calls $0.1
Hero: folds
e58b9f8d: folds
7dcc690a: calls $0.05
*** FLOP *** [9c Kc Ac]
7dcc690a: checks
37c2e948: bets $0.22
6daf85fc: folds
7dcc690a: raises $0.76 to $0.98
37c2e948: folds
Uncalled bet ($0.76) returned to 7dcc690a
*** SHOWDOWN ***
7dcc690a collected $0.73 from pot
*** SUMMARY ***
Total pot $0.76 | Rake $0.03 | Jackpot $0 | Bingo $0 | Fortune $0 | Tax $0
Board [9c Kc Ac]
Seat 1: Hero (button) folded before Flop (didn't bet)
Seat 2: e58b9f8d (small blind) folded before Flop
Seat 3: 7dcc690a (big blind) won ($0.73)
Seat 4: 37c2e948 folded on the Flop
Seat 5: 9be50a folded before Flop (didn't bet)
Seat 6: 6daf85fc folded on the Flop


Poker Hand #RC3811231009: Hold'em No Limit ($0.02/$0.05) - 2025/08/16 13:27:26
Table 'RushAndCash856269' 6-max Seat #1 is the button
Seat 1: 1b2883cb ($5.62 in chips)
Seat 2: Hero ($17.82 in chips)
Seat 3: 37c2e948 ($13.51 in chips)
Seat 4: f82070f ($5.02 in chips)
Seat 5: 41c92275 ($5.18 in chips)
Seat 6: eb124b29 ($5.57 in chips)
Hero: posts small blind $0.02
37c2e948: posts big blind $0.05
*** HOLE CARDS ***
Dealt to 1b2883cb 
Dealt to Hero [Th 3h]
Dealt to 37c2e948 
Dealt to f82070f 
Dealt to 41c92275 
Dealt to eb124b29 
f82070f: folds
41c92275: folds
eb124b29: folds
1b2883cb: folds
Hero: calls $0.03
37c2e948: raises $0.14 to $0.19
Hero: folds
Uncalled bet ($0.14) returned to 37c2e948
*** SHOWDOWN ***
37c2e948 collected $0.1 from pot
*** SUMMARY ***
Total pot $0.1 | Rake $0 | Jackpot $0 | Bingo $0 | Fortune $0 | Tax $0
Seat 1: 1b2883cb (button) folded before Flop (didn't bet)
Seat 2: Hero (small blind) folded before Flop
Seat 3: 37c2e948 (big blind) collected ($0.1)
Seat 4: f82070f folded before Flop (didn't bet)
Seat 5: 41c92275 folded before Flop (didn't bet)
Seat 6: eb124b29 folded before Flop (didn't bet)


Poker Hand #RC3811230995: Hold'em No Limit ($0.02/$0.05) - 2025/08/16 13:27:23
Table 'RushAndCash856255' 6-max Seat #1 is the button
Seat 1: cf40af3 ($9.66 in chips)
Seat 2: 49d968ac ($8.39 in chips)
Seat 3: eb124b29 ($5.62 in chips)
Seat 4: Hero ($17.82 in chips)
Seat 5: 75a945c ($6.71 in chips)
Seat 6: 53468d83 ($6.03 in chips)
49d968ac: posts small blind $0.02
eb124b29: posts big blind $0.05
*** HOLE CARDS ***
Dealt to cf40af3 
Dealt to 49d968ac 
Dealt to eb124b29 
Dealt to Hero [5c 6s]
Dealt to 75a945c 
Dealt to 53468d83 
Hero: folds
75a945c: folds
53468d83: folds
cf40af3: folds
49d968ac: folds
Uncalled bet ($0.03) returned to eb124b29
*** SHOWDOWN ***
eb124b29 collected $0.04 from pot
*** SUMMARY ***
Total pot $0.04 | Rake $0 | Jackpot $0 | Bingo $0 | Fortune $0 | Tax $0
Seat 1: cf40af3 (button) folded before Flop (didn't bet)
Seat 2: 49d968ac (small blind) folded before Flop
Seat 3: eb124b29 (big blind) collected ($0.04)
Seat 4: Hero folded before Flop (didn't bet)
Seat 5: 75a945c folded before Flop (didn't bet)
Seat 6: 53468d83 folded before Flop (didn't bet)


Poker Hand #RC3811230788: Hold'em No Limit ($0.02/$0.05) - 2025/08/16 13:26:37
Table 'RushAndCash856048' 6-max Seat #1 is the button
Seat 1: 4fda73cd ($4.83 in chips)
Seat 2: fad7a12d ($5.59 in chips)
Seat 3: Hero ($17.92 in chips)
Seat 4: c279a6b3 ($5 in chips)
Seat 5: 75a945c ($6.43 in chips)
Seat 6: 11f4f257 ($4.93 in chips)
fad7a12d: posts small blind $0.02
Hero: posts big blind $0.05
*** HOLE CARDS ***
Dealt to 4fda73cd 
Dealt to fad7a12d 
Dealt to Hero [Jc 4c]
Dealt to c279a6b3 
Dealt to 75a945c 
Dealt to 11f4f257 
c279a6b3: folds
75a945c: raises $0.05 to $0.1
11f4f257: folds
4fda73cd: calls $0.1
fad7a12d: calls $0.08
Hero: calls $0.05
*** FLOP *** [5h 9h 7d]
fad7a12d: checks
Hero: checks
75a945c: bets $0.23
4fda73cd: folds
fad7a12d: folds
Hero: folds
Uncalled bet ($0.23) returned to 75a945c
*** SHOWDOWN ***
75a945c collected $0.38 from pot
*** SUMMARY ***
Total pot $0.4 | Rake $0.02 | Jackpot $0 | Bingo $0 | Fortune $0 | Tax $0
Board [5h 9h 7d]
Seat 1: 4fda73cd (button) folded on the Flop
Seat 2: fad7a12d (small blind) folded on the Flop
Seat 3: Hero (big blind) folded on the Flop
Seat 4: c279a6b3 folded before Flop (didn't bet)
Seat 5: 75a945c won ($0.38)
Seat 6: 11f4f257 folded before Flop (didn't bet)


Poker Hand #RC3811230773: Hold'em No Limit ($0.02/$0.05) - 2025/08/16 13:26:34
Table 'RushAndCash856033' 6-max Seat #1 is the button
Seat 1: 10369860 ($5.59 in chips)
Seat 2: 233b28a ($5.85 in chips)
Seat 3: d0b455d3 ($10.28 in chips)
Seat 4: fad7a12d ($5.59 in chips)
Seat 5: 4dd7c0f6 ($1.47 in chips)
Seat 6: Hero ($17.92 in chips)
233b28a: posts small blind $0.02
d0b455d3: posts big blind $0.05
*** HOLE CARDS ***
Dealt to 10369860 
Dealt to 233b28a 
Dealt to d0b455d3 
Dealt to fad7a12d 
Dealt to 4dd7c0f6 
Dealt to Hero [Jc 9s]
fad7a12d: folds
4dd7c0f6: raises $0.05 to $0.1
Hero: folds
10369860: folds
233b28a: folds
d0b455d3: calls $0.05
*** FLOP *** [Ah 8s As]
d0b455d3: checks
4dd7c0f6: bets $0.17
d0b455d3: folds
Uncalled bet ($0.17) returned to 4dd7c0f6
*** SHOWDOWN ***
4dd7c0f6 collected $0.21 from pot
*** SUMMARY ***
Total pot $0.22 | Rake $0.01 | Jackpot $0 | Bingo $0 | Fortune $0 | Tax $0
Board [Ah 8s As]
Seat 1: 10369860 (button) folded before Flop (didn't bet)
Seat 2: 233b28a (small blind) folded before Flop
Seat 3: d0b455d3 (big blind) folded on the Flop
Seat 4: fad7a12d folded before Flop (didn't bet)
Seat 5: 4dd7c0f6 won ($0.21)
Seat 6: Hero folded before Flop (didn't bet)


Poker Hand #RC3811230756: Hold'em No Limit ($0.02/$0.05) - 2025/08/16 13:26:30
Table 'RushAndCash856016' 6-max Seat #1 is the button
Seat 1: 2209ab16 ($4.09 in chips)
Seat 2: 4dd7c0f6 ($1.49 in chips)
Seat 3: 58904fa2 ($5.41 in chips)
Seat 4: a4b465c3 ($1.99 in chips)
Seat 5: Hero ($17.92 in chips)
Seat 6: cce07217 ($5.07 in chips)
4dd7c0f6: posts small blind $0.02
58904fa2: posts big blind $0.05
*** HOLE CARDS ***
Dealt to 2209ab16 
Dealt to 4dd7c0f6 
Dealt to 58904fa2 
Dealt to a4b465c3 
Dealt to Hero [8h 9s]
Dealt to cce07217 
a4b465c3: folds
Hero: folds
cce07217: raises $0.05 to $0.1
2209ab16: folds
4dd7c0f6: folds
58904fa2: calls $0.05
*** FLOP *** [Ad 3d Kd]
58904fa2: checks
cce07217: bets $0.08
58904fa2: folds
Uncalled bet ($0.08) returned to cce07217
*** SHOWDOWN ***
cce07217 collected $0.21 from pot
*** SUMMARY ***
Total pot $0.22 | Rake $0.01 | Jackpot $0 | Bingo $0 | Fortune $0 | Tax $0
Board [Ad 3d Kd]
Seat 1: 2209ab16 (button) folded before Flop (didn't bet)
Seat 2: 4dd7c0f6 (small blind) folded before Flop
Seat 3: 58904fa2 (big blind) folded on the Flop
Seat 4: a4b465c3 folded before Flop (didn't bet)
Seat 5: Hero folded before Flop (didn't bet)
Seat 6: cce07217 won ($0.21)


Poker Hand #RC3811230740: Hold'em No Limit ($0.02/$0.05) - 2025/08/16 13:26:27
Table 'RushAndCash856000' 6-max Seat #1 is the button
Seat 1: 2a9a3527 ($6.12 in chips)
Seat 2: 48e9176f ($22.94 in chips)
Seat 3: 11f4f257 ($5 in chips)
Seat 4: 8efc316 ($4.47 in chips)
Seat 5: Hero ($17.92 in chips)
Seat 6: 4ade682a ($5.54 in chips)
48e9176f: posts small blind $0.02
11f4f257: posts big blind $0.05
*** HOLE CARDS ***
Dealt to 2a9a3527 
Dealt to 48e9176f 
Dealt to 11f4f257 
Dealt to 8efc316 
Dealt to Hero [5h 5c]
Dealt to 4ade682a 
8efc316: folds
Hero: folds
4ade682a: raises $0.06 to $0.11
2a9a3527: folds
48e9176f: folds
11f4f257: folds
Uncalled bet ($0.06) returned to 4ade682a
*** SHOWDOWN ***
4ade682a collected $0.12 from pot
*** SUMMARY ***
Total pot $0.12 | Rake $0 | Jackpot $0 | Bingo $0 | Fortune $0 | Tax $0
Seat 1: 2a9a3527 (button) folded before Flop (didn't bet)
Seat 2: 48e9176f (small blind) folded before Flop
Seat 3: 11f4f257 (big blind) folded before Flop
Seat 4: 8efc316 folded before Flop (didn't bet)
Seat 5: Hero folded before Flop (didn't bet)
Seat 6: 4ade682a collected ($0.12)


Poker Hand #RC3811230691: Hold'em No Limit ($0.02/$0.05) - 2025/08/16 13:26:16
Table 'RushAndCash855951' 6-max Seat #1 is the button
Seat 1: 1699364e ($4.93 in chips)
Seat 2: e88b4b2 ($5.27 in chips)
Seat 3: fe38f94c ($5 in chips)
Seat 4: 9e53c5e6 ($5 in chips)
Seat 5: 109a2d2f ($1.56 in chips)
Seat 6: Hero ($17.85 in chips)
e88b4b2: posts small blind $0.02
fe38f94c: posts big blind $0.05
*** HOLE CARDS ***
Dealt to 1699364e 
Dealt to e88b4b2 
Dealt to fe38f94c 
Dealt to 9e53c5e6 
Dealt to 109a2d2f 
Dealt to Hero [Td 9d]
9e53c5e6: folds
109a2d2f: folds
Hero: raises $0.05 to $0.1
1699364e: folds
e88b4b2: folds
fe38f94c: folds
Uncalled bet ($0.05) returned to Hero
*** SHOWDOWN ***
Hero collected $0.12 from pot
*** SUMMARY ***
Total pot $0.12 | Rake $0 | Jackpot $0 | Bingo $0 | Fortune $0 | Tax $0
Seat 1: 1699364e (button) folded before Flop (didn't bet)
Seat 2: e88b4b2 (small blind) folded before Flop
Seat 3: fe38f94c (big blind) folded before Flop
Seat 4: 9e53c5e6 folded before Flop (didn't bet)
Seat 5: 109a2d2f folded before Flop (didn't bet)
Seat 6: Hero collected ($0.12)


Poker Hand #RC3811230673: Hold'em No Limit ($0.02/$0.05) - 2025/08/16 13:26:12
Table 'RushAndCash855933' 6-max Seat #1 is the button
Seat 1: Hero ($17.85 in chips)
Seat 2: af513a68 ($40.04 in chips)
Seat 3: 21582d9 ($4.89 in chips)
Seat 4: 7cc092a1 ($5 in chips)
Seat 5: 3dbd3479 ($5 in chips)
Seat 6: eb124b29 ($5.72 in chips)
af513a68: posts small blind $0.02
21582d9: posts big blind $0.05
*** HOLE CARDS ***
Dealt to Hero [8s Qd]
Dealt to af513a68 
Dealt to 21582d9 
Dealt to 7cc092a1 
Dealt to 3dbd3479 
Dealt to eb124b29 
7cc092a1: folds
3dbd3479: folds
eb124b29: raises $0.1 to $0.15
Hero: folds
af513a68: folds
21582d9: folds
Uncalled bet ($0.1) returned to eb124b29
*** SHOWDOWN ***
eb124b29 collected $0.12 from pot
*** SUMMARY ***
Total pot $0.12 | Rake $0 | Jackpot $0 | Bingo $0 | Fortune $0 | Tax $0
Seat 1: Hero (button) folded before Flop (didn't bet)
Seat 2: af513a68 (small blind) folded before Flop
Seat 3: 21582d9 (big blind) folded before Flop
Seat 4: 7cc092a1 folded before Flop (didn't bet)
Seat 5: 3dbd3479 folded before Flop (didn't bet)
Seat 6: eb124b29 collected ($0.12)


Poker Hand #RC3811230638: Hold'em No Limit ($0.02/$0.05) - 2025/08/16 13:26:06
Table 'RushAndCash855898' 6-max Seat #1 is the button
Seat 1: 2bb6b6c9 ($4.04 in chips)
Seat 2: Hero ($17.87 in chips)
Seat 3: 6c6defcb ($12.46 in chips)
Seat 4: 35d6df2 ($5.07 in chips)
Seat 5: 48e9176f ($23.01 in chips)
Seat 6: 52635f99 ($5.49 in chips)
Hero: posts small blind $0.02
6c6defcb: posts big blind $0.05
*** HOLE CARDS ***
Dealt to 2bb6b6c9 
Dealt to Hero [5c 9h]
Dealt to 6c6defcb 
Dealt to 35d6df2 
Dealt to 48e9176f 
Dealt to 52635f99 
35d6df2: folds
48e9176f: folds
52635f99: folds
2bb6b6c9: folds
Hero: folds
Uncalled bet ($0.03) returned to 6c6defcb
*** SHOWDOWN ***
6c6defcb collected $0.04 from pot
*** SUMMARY ***
Total pot $0.04 | Rake $0 | Jackpot $0 | Bingo $0 | Fortune $0 | Tax $0
Seat 1: 2bb6b6c9 (button) folded before Flop (didn't bet)
Seat 2: Hero (small blind) folded before Flop
Seat 3: 6c6defcb (big blind) collected ($0.04)
Seat 4: 35d6df2 folded before Flop (didn't bet)
Seat 5: 48e9176f folded before Flop (didn't bet)
Seat 6: 52635f99 folded before Flop (didn't bet)


Poker Hand #RC3811230610: Hold'em No Limit ($0.02/$0.05) - 2025/08/16 13:26:00
Table 'RushAndCash855870' 6-max Seat #1 is the button
Seat 1: Hero ($17.87 in chips)
Seat 2: c279a6b3 ($5.02 in chips)
Seat 3: ee7d25e9 ($5.47 in chips)
Seat 4: c1fd72dd ($3.3 in chips)
Seat 5: 5f99e77e ($5.48 in chips)
Seat 6: b85fea1 ($5.63 in chips)
c279a6b3: posts small blind $0.02
ee7d25e9: posts big blind $0.05
*** HOLE CARDS ***
Dealt to Hero [Qd 3h]
Dealt to c279a6b3 
Dealt to ee7d25e9 
Dealt to c1fd72dd 
Dealt to 5f99e77e 
Dealt to b85fea1 
c1fd72dd: folds
5f99e77e: folds
b85fea1: folds
Hero: folds
c279a6b3: raises $0.09 to $0.14
ee7d25e9: folds
Uncalled bet ($0.09) returned to c279a6b3
*** SHOWDOWN ***
c279a6b3 collected $0.1 from pot
*** SUMMARY ***
Total pot $0.1 | Rake $0 | Jackpot $0 | Bingo $0 | Fortune $0 | Tax $0
Seat 1: Hero (button) folded before Flop (didn't bet)
Seat 2: c279a6b3 (small blind) collected ($0.1)
Seat 3: ee7d25e9 (big blind) folded before Flop
Seat 4: c1fd72dd folded before Flop (didn't bet)
Seat 5: 5f99e77e folded before Flop (didn't bet)
Seat 6: b85fea1 folded before Flop (didn't bet)


Poker Hand #RC3811230579: Hold'em No Limit ($0.02/$0.05) - 2025/08/16 13:25:54
Table 'RushAndCash855839' 6-max Seat #1 is the button
Seat 1: 5f770ea7 ($4.82 in chips)
Seat 2: ec79c726 ($5.37 in chips)
Seat 3: Hero ($17.92 in chips)
Seat 4: d1595e43 ($4.86 in chips)
Seat 5: 18ee0b33 ($5.12 in chips)
Seat 6: 58fd7293 ($8.62 in chips)
ec79c726: posts small blind $0.02
Hero: posts big blind $0.05
*** HOLE CARDS ***
Dealt to 5f770ea7 
Dealt to ec79c726 
Dealt to Hero [6s Qh]
Dealt to d1595e43 
Dealt to 18ee0b33 
Dealt to 58fd7293 
d1595e43: folds
18ee0b33: raises $0.05 to $0.1
58fd7293: folds
5f770ea7: folds
ec79c726: folds
Hero: folds
Uncalled bet ($0.05) returned to 18ee0b33
*** SHOWDOWN ***
18ee0b33 collected $0.12 from pot
*** SUMMARY ***
Total pot $0.12 | Rake $0 | Jackpot $0 | Bingo $0 | Fortune $0 | Tax $0
Seat 1: 5f770ea7 (button) folded before Flop (didn't bet)
Seat 2: ec79c726 (small blind) folded before Flop
Seat 3: Hero (big blind) folded before Flop
Seat 4: d1595e43 folded before Flop (didn't bet)
Seat 5: 18ee0b33 collected ($0.12)
Seat 6: 58fd7293 folded before Flop (didn't bet)


Poker Hand #RC3811230560: Hold'em No Limit ($0.02/$0.05) - 2025/08/16 13:25:51
Table 'RushAndCash855820' 6-max Seat #1 is the button
Seat 1: d2786e96 ($5.05 in chips)
Seat 2: cb635fd7 ($5 in chips)
Seat 3: c279a6b3 ($5.07 in chips)
Seat 4: a2fc73c0 ($3.43 in chips)
Seat 5: Hero ($17.92 in chips)
Seat 6: cc841ed2 ($7.33 in chips)
cb635fd7: posts small blind $0.02
c279a6b3: posts big blind $0.05
*** HOLE CARDS ***
Dealt to d2786e96 
Dealt to cb635fd7 
Dealt to c279a6b3 
Dealt to a2fc73c0 
Dealt to Hero [7c Ks]
Dealt to cc841ed2 
a2fc73c0: folds
Hero: folds
cc841ed2: folds
d2786e96: raises $0.1 to $0.15
cb635fd7: raises $0.35 to $0.5
c279a6b3: folds
d2786e96: calls $0.35
*** FLOP *** [8c 6s Th]
cb635fd7: bets $0.35
d2786e96: raises $0.88 to $1.23
cb635fd7: raises $3.27 to $4.5 and is all-in
d2786e96: folds
Uncalled bet ($3.27) returned to cb635fd7
*** SHOWDOWN ***
cb635fd7 collected $3.29 from pot
*** SUMMARY ***
Total pot $3.51 | Rake $0.15 | Jackpot $0.07 | Bingo $0 | Fortune $0 | Tax $0
Board [8c 6s Th]
Seat 1: d2786e96 (button) folded on the Flop
Seat 2: cb635fd7 (small blind) won ($3.29)
Seat 3: c279a6b3 (big blind) folded before Flop
Seat 4: a2fc73c0 folded before Flop (didn't bet)
Seat 5: Hero folded before Flop (didn't bet)
Seat 6: cc841ed2 folded before Flop (didn't bet)


Poker Hand #RC3811230413: Hold'em No Limit ($0.02/$0.05) - 2025/08/16 13:25:21
Table 'RushAndCash855673' 6-max Seat #1 is the button
Seat 1: bb09ab58 ($6.21 in chips)
Seat 2: Hero ($18.02 in chips)
Seat 3: cc841ed2 ($7.24 in chips)
Seat 4: 4db3ac33 ($7.1 in chips)
Seat 5: 721b1a93 ($5.29 in chips)
Seat 6: 4101fbff ($4.73 in chips)
Hero: posts small blind $0.02
cc841ed2: posts big blind $0.05
*** HOLE CARDS ***
Dealt to bb09ab58 
Dealt to Hero [7d Qh]
Dealt to cc841ed2 
Dealt to 4db3ac33 
Dealt to 721b1a93 
Dealt to 4101fbff 
4db3ac33: folds
721b1a93: folds
4101fbff: folds
bb09ab58: folds
Hero: raises $0.05 to $0.1
cc841ed2: raises $0.2 to $0.3
Hero: folds
Uncalled bet ($0.2) returned to cc841ed2
*** SHOWDOWN ***
cc841ed2 collected $0.19 from pot
*** SUMMARY ***
Total pot $0.2 | Rake $0.01 | Jackpot $0 | Bingo $0 | Fortune $0 | Tax $0
Seat 1: bb09ab58 (button) folded before Flop (didn't bet)
Seat 2: Hero (small blind) folded before Flop
Seat 3: cc841ed2 (big blind) collected ($0.19)
Seat 4: 4db3ac33 folded before Flop (didn't bet)
Seat 5: 721b1a93 folded before Flop (didn't bet)
Seat 6: 4101fbff folded before Flop (didn't bet)


Poker Hand #RC3811230373: Hold'em No Limit ($0.02/$0.05) - 2025/08/16 13:25:13
Table 'RushAndCash855633' 6-max Seat #1 is the button
Seat 1: Hero ($18.02 in chips)
Seat 2: 1d2b98aa ($8.96 in chips)
Seat 3: c752dcf3 ($6 in chips)
Seat 4: 14d9c001 ($6.92 in chips)
Seat 5: 5340c595 ($17.65 in chips)
Seat 6: 1c637781 ($2.6 in chips)
1d2b98aa: posts small blind $0.02
c752dcf3: posts big blind $0.05
*** HOLE CARDS ***
Dealt to Hero [9c Jd]
Dealt to 1d2b98aa 
Dealt to c752dcf3 
Dealt to 14d9c001 
Dealt to 5340c595 
Dealt to 1c637781 
14d9c001: folds
5340c595: raises $0.05 to $0.1
1c637781: folds
Hero: folds
1d2b98aa: folds
c752dcf3: folds
Uncalled bet ($0.05) returned to 5340c595
*** SHOWDOWN ***
5340c595 collected $0.12 from pot
*** SUMMARY ***
Total pot $0.12 | Rake $0 | Jackpot $0 | Bingo $0 | Fortune $0 | Tax $0
Seat 1: Hero (button) folded before Flop (didn't bet)
Seat 2: 1d2b98aa (small blind) folded before Flop
Seat 3: c752dcf3 (big blind) folded before Flop
Seat 4: 14d9c001 folded before Flop (didn't bet)
Seat 5: 5340c595 collected ($0.12)
Seat 6: 1c637781 folded before Flop (didn't bet)


Poker Hand #RC3811230272: Hold'em No Limit ($0.02/$0.05) - 2025/08/16 13:24:48
Table 'RushAndCash855532' 6-max Seat #1 is the button
Seat 1: cb6a0e23 ($4.99 in chips)
Seat 2: ed530cde ($5 in chips)
Seat 3: Hero ($18.07 in chips)
Seat 4: 94afcc3f ($5.75 in chips)
Seat 5: 6daf85fc ($5.55 in chips)
Seat 6: bc646f41 ($8.31 in chips)
ed530cde: posts small blind $0.02
Hero: posts big blind $0.05
*** HOLE CARDS ***
Dealt to cb6a0e23 
Dealt to ed530cde 
Dealt to Hero [2s 9d]
Dealt to 94afcc3f 
Dealt to 6daf85fc 
Dealt to bc646f41 
94afcc3f: calls $0.05
6daf85fc: raises $0.2 to $0.25
bc646f41: folds
cb6a0e23: folds
ed530cde: raises $0.75 to $1
Hero: folds
94afcc3f: folds
6daf85fc: raises $4.55 to $5.55 and is all-in
ed530cde: calls $4 and is all-in
Uncalled bet ($0.55) returned to 6daf85fc
6daf85fc: shows [Kd Ad]
ed530cde: shows [Ac As]
*** FLOP *** [3h 2c Js]
*** TURN *** [3h 2c Js] [5s]
*** RIVER *** [3h 2c Js 5s] [8s]
*** SHOWDOWN ***
ed530cde collected $9.88 from pot
*** SUMMARY ***
Total pot $10.1 | Rake $0.15 | Jackpot $0.07 | Bingo $0 | Fortune $0 | Tax $0
Board [3h 2c Js 5s 8s]
Seat 1: cb6a0e23 (button) folded before Flop (didn't bet)
Seat 2: ed530cde (small blind) showed [Ac As] and won ($9.88) with a pair of Aces
Seat 3: Hero (big blind) folded before Flop
Seat 4: 94afcc3f folded before Flop
Seat 5: 6daf85fc showed [Kd Ad] and lost with Ace high
Seat 6: bc646f41 folded before Flop (didn't bet)


Poker Hand #RC3811230040: Hold'em No Limit ($0.02/$0.05) - 2025/08/16 13:23:58
Table 'RushAndCash855300' 6-max Seat #1 is the button
Seat 1: f1e6db21 ($7.83 in chips)
Seat 2: c2dc4208 ($10.37 in chips)
Seat 3: 6daf85fc ($5.95 in chips)
Seat 4: Hero ($17.69 in chips)
Seat 5: c923a998 ($6.98 in chips)
Seat 6: 8f7e8e2d ($5.62 in chips)
c2dc4208: posts small blind $0.02
6daf85fc: posts big blind $0.05
*** HOLE CARDS ***
Dealt to f1e6db21 
Dealt to c2dc4208 
Dealt to 6daf85fc 
Dealt to Hero [Ah Ks]
Dealt to c923a998 
Dealt to 8f7e8e2d 
Hero: raises $0.05 to $0.1
c923a998: folds
8f7e8e2d: folds
f1e6db21: folds
c2dc4208: folds
6daf85fc: raises $0.3 to $0.4
Hero: calls $0.3
*** FLOP *** [9s 5d 2h]
6daf85fc: checks
Hero: checks
*** TURN *** [9s 5d 2h] [Kh]
6daf85fc: checks
Hero: bets $0.64
6daf85fc: folds
Uncalled bet ($0.64) returned to Hero
*** SHOWDOWN ***
Hero collected $0.78 from pot
*** SUMMARY ***
Total pot $0.82 | Rake $0.04 | Jackpot $0 | Bingo $0 | Fortune $0 | Tax $0
Board [9s 5d 2h Kh]
Seat 1: f1e6db21 (button) folded before Flop (didn't bet)
Seat 2: c2dc4208 (small blind) folded before Flop
Seat 3: 6daf85fc (big blind) folded on the Turn
Seat 4: Hero won ($0.78)
Seat 5: c923a998 folded before Flop (didn't bet)
Seat 6: 8f7e8e2d folded before Flop (didn't bet)


Poker Hand #RC3811230021: Hold'em No Limit ($0.02/$0.05) - 2025/08/16 13:23:55
Table 'RushAndCash855281' 6-max Seat #1 is the button
Seat 1: 6daf85fc ($5.95 in chips)
Seat 2: 4740bc08 ($5 in chips)
Seat 3: 53a135ae ($5 in chips)
Seat 4: Hero ($17.69 in chips)
Seat 5: ee7d25e9 ($5.25 in chips)
Seat 6: dda95519 ($11.14 in chips)
4740bc08: posts small blind $0.02
53a135ae: posts big blind $0.05
*** HOLE CARDS ***
Dealt to 6daf85fc 
Dealt to 4740bc08 
Dealt to 53a135ae 
Dealt to Hero [2h Qs]
Dealt to ee7d25e9 
Dealt to dda95519 
Hero: folds
ee7d25e9: folds
dda95519: folds
6daf85fc: folds
4740bc08: folds
Uncalled bet ($0.03) returned to 53a135ae
*** SHOWDOWN ***
53a135ae collected $0.04 from pot
*** SUMMARY ***
Total pot $0.04 | Rake $0 | Jackpot $0 | Bingo $0 | Fortune $0 | Tax $0
Seat 1: 6daf85fc (button) folded before Flop (didn't bet)
Seat 2: 4740bc08 (small blind) folded before Flop
Seat 3: 53a135ae (big blind) collected ($0.04)
Seat 4: Hero folded before Flop (didn't bet)
Seat 5: ee7d25e9 folded before Flop (didn't bet)
Seat 6: dda95519 folded before Flop (didn't bet)


Poker Hand #RC3811229994: Hold'em No Limit ($0.02/$0.05) - 2025/08/16 13:23:48
Table 'RushAndCash855254' 6-max Seat #1 is the button
Seat 1: Hero ($17.69 in chips)
Seat 2: 8748f4a7 ($5.64 in chips)
Seat 3: 11584718 ($8.37 in chips)
Seat 4: 6170ef01 ($5.14 in chips)
Seat 5: ee5d5dac ($5 in chips)
Seat 6: ee7d25e9 ($5.25 in chips)
8748f4a7: posts small blind $0.02
11584718: posts big blind $0.05
*** HOLE CARDS ***
Dealt to Hero [Qd 5h]
Dealt to 8748f4a7 
Dealt to 11584718 
Dealt to 6170ef01 
Dealt to ee5d5dac 
Dealt to ee7d25e9 
6170ef01: raises $0.05 to $0.1
ee5d5dac: folds
ee7d25e9: folds
Hero: folds
8748f4a7: folds
11584718: folds
Uncalled bet ($0.05) returned to 6170ef01
*** SHOWDOWN ***
6170ef01 collected $0.12 from pot
*** SUMMARY ***
Total pot $0.12 | Rake $0 | Jackpot $0 | Bingo $0 | Fortune $0 | Tax $0
Seat 1: Hero (button) folded before Flop (didn't bet)
Seat 2: 8748f4a7 (small blind) folded before Flop
Seat 3: 11584718 (big blind) folded before Flop
Seat 4: 6170ef01 collected ($0.12)
Seat 5: ee5d5dac folded before Flop (didn't bet)
Seat 6: ee7d25e9 folded before Flop (didn't bet)


Poker Hand #RC3811229975: Hold'em No Limit ($0.02/$0.05) - 2025/08/16 13:23:44
Table 'RushAndCash855235' 6-max Seat #1 is the button
Seat 1: 32436e51 ($2 in chips)
Seat 2: 143161ce ($5.53 in chips)
Seat 3: 4698ae62 ($6.13 in chips)
Seat 4: 53468d83 ($5.19 in chips)
Seat 5: b6fa424b ($7.26 in chips)
Seat 6: Hero ($17.69 in chips)
143161ce: posts small blind $0.02
4698ae62: posts big blind $0.05
*** HOLE CARDS ***
Dealt to 32436e51 
Dealt to 143161ce 
Dealt to 4698ae62 
Dealt to 53468d83 
Dealt to b6fa424b 
Dealt to Hero [Kc 5s]
53468d83: folds
b6fa424b: folds
Hero: folds
32436e51: folds
143161ce: folds
Uncalled bet ($0.03) returned to 4698ae62
*** SHOWDOWN ***
4698ae62 collected $0.04 from pot
*** SUMMARY ***
Total pot $0.04 | Rake $0 | Jackpot $0 | Bingo $0 | Fortune $0 | Tax $0
Seat 1: 32436e51 (button) folded before Flop (didn't bet)
Seat 2: 143161ce (small blind) folded before Flop
Seat 3: 4698ae62 (big blind) collected ($0.04)
Seat 4: 53468d83 folded before Flop (didn't bet)
Seat 5: b6fa424b folded before Flop (didn't bet)
Seat 6: Hero folded before Flop (didn't bet)


Poker Hand #RC3811229959: Hold'em No Limit ($0.02/$0.05) - 2025/08/16 13:23:40
Table 'RushAndCash855219' 6-max Seat #1 is the button
Seat 1: ea3ec8c7 ($5 in chips)
Seat 2: a3bdcd1f ($7.53 in chips)
Seat 3: bbe74281 ($5.36 in chips)
Seat 4: ab6c0fb8 ($5.1 in chips)
Seat 5: 9b7ef7b0 ($7 in chips)
Seat 6: Hero ($17.69 in chips)
a3bdcd1f: posts small blind $0.02
bbe74281: posts big blind $0.05
*** HOLE CARDS ***
Dealt to ea3ec8c7 
Dealt to a3bdcd1f 
Dealt to bbe74281 
Dealt to ab6c0fb8 
Dealt to 9b7ef7b0 
Dealt to Hero [6c 9s]
ab6c0fb8: folds
9b7ef7b0: folds
Hero: folds
ea3ec8c7: folds
a3bdcd1f: raises $0.1 to $0.15
bbe74281: calls $0.1
*** FLOP *** [3d 2s 7h]
a3bdcd1f: checks
bbe74281: bets $0.1
a3bdcd1f: calls $0.1
*** TURN *** [3d 2s 7h] [8h]
a3bdcd1f: checks
bbe74281: bets $0.38
a3bdcd1f: folds
Uncalled bet ($0.38) returned to bbe74281
*** SHOWDOWN ***
bbe74281 collected $0.48 from pot
*** SUMMARY ***
Total pot $0.5 | Rake $0.02 | Jackpot $0 | Bingo $0 | Fortune $0 | Tax $0
Board [3d 2s 7h 8h]
Seat 1: ea3ec8c7 (button) folded before Flop (didn't bet)
Seat 2: a3bdcd1f (small blind) folded on the Turn
Seat 3: bbe74281 (big blind) won ($0.48)
Seat 4: ab6c0fb8 folded before Flop (didn't bet)
Seat 5: 9b7ef7b0 folded before Flop (didn't bet)
Seat 6: Hero folded before Flop (didn't bet)


Poker Hand #RC3811229943: Hold'em No Limit ($0.02/$0.05) - 2025/08/16 13:23:37
Table 'RushAndCash855203' 6-max Seat #1 is the button
Seat 1: 3e5d8cd2 ($5 in chips)
Seat 2: 55e923ad ($8.08 in chips)
Seat 3: 4aba04ef ($6.02 in chips)
Seat 4: Hero ($17.69 in chips)
Seat 5: d0b455d3 ($8.44 in chips)
Seat 6: 188a67f6 ($6.68 in chips)
55e923ad: posts small blind $0.02
4aba04ef: posts big blind $0.05
*** HOLE CARDS ***
Dealt to 3e5d8cd2 
Dealt to 55e923ad 
Dealt to 4aba04ef 
Dealt to Hero [6d 3s]
Dealt to d0b455d3 
Dealt to 188a67f6 
Hero: folds
d0b455d3: folds
188a67f6: folds
3e5d8cd2: folds
55e923ad: raises $0.1 to $0.15
4aba04ef: raises $0.39 to $0.54
55e923ad: folds
Uncalled bet ($0.39) returned to 4aba04ef
*** SHOWDOWN ***
4aba04ef collected $0.29 from pot
*** SUMMARY ***
Total pot $0.3 | Rake $0.01 | Jackpot $0 | Bingo $0 | Fortune $0 | Tax $0
Seat 1: 3e5d8cd2 (button) folded before Flop (didn't bet)
Seat 2: 55e923ad (small blind) folded before Flop
Seat 3: 4aba04ef (big blind) collected ($0.29)
Seat 4: Hero folded before Flop (didn't bet)
Seat 5: d0b455d3 folded before Flop (didn't bet)
Seat 6: 188a67f6 folded before Flop (didn't bet)


Poker Hand #RC3811229761: Hold'em No Limit ($0.02/$0.05) - 2025/08/16 13:22:56
Table 'RushAndCash855021' 6-max Seat #1 is the button
Seat 1: 745a5d64 ($5.05 in chips)
Seat 2: Hero ($17.28 in chips)
Seat 3: 767ec7ee ($5.06 in chips)
Seat 4: d0b455d3 ($8.84 in chips)
Seat 5: 256d3efb ($5.07 in chips)
Seat 6: 91087b75 ($5.48 in chips)
Hero: posts small blind $0.02
767ec7ee: posts big blind $0.05
*** HOLE CARDS ***
Dealt to 745a5d64 
Dealt to Hero [9h Ah]
Dealt to 767ec7ee 
Dealt to d0b455d3 
Dealt to 256d3efb 
Dealt to 91087b75 
d0b455d3: raises $0.05 to $0.1
256d3efb: folds
91087b75: folds
745a5d64: folds
Hero: raises $0.3 to $0.4
767ec7ee: folds
d0b455d3: calls $0.3
*** FLOP *** [5d Qs Kc]
Hero: bets $0.24
d0b455d3: folds
Uncalled bet ($0.24) returned to Hero
*** SHOWDOWN ***
Hero collected $0.81 from pot
*** SUMMARY ***
Total pot $0.85 | Rake $0.04 | Jackpot $0 | Bingo $0 | Fortune $0 | Tax $0
Board [5d Qs Kc]
Seat 1: 745a5d64 (button) folded before Flop (didn't bet)
Seat 2: Hero (small blind) won ($0.81)
Seat 3: 767ec7ee (big blind) folded before Flop
Seat 4: d0b455d3 folded on the Flop
Seat 5: 256d3efb folded before Flop (didn't bet)
Seat 6: 91087b75 folded before Flop (didn't bet)


Poker Hand #RC3811229734: Hold'em No Limit ($0.02/$0.05) - 2025/08/16 13:22:49
Table 'RushAndCash854994' 6-max Seat #1 is the button
Seat 1: 53468d83 ($5.39 in chips)
Seat 2: cf40af3 ($10.43 in chips)
Seat 3: Hero ($17.33 in chips)
Seat 4: cc841ed2 ($6.62 in chips)
Seat 5: d981cd10 ($5 in chips)
Seat 6: e1628ffa ($4.39 in chips)
cf40af3: posts small blind $0.02
Hero: posts big blind $0.05
*** HOLE CARDS ***
Dealt to 53468d83 
Dealt to cf40af3 
Dealt to Hero [Kh 6c]
Dealt to cc841ed2 
Dealt to d981cd10 
Dealt to e1628ffa 
cc841ed2: raises $0.05 to $0.1
d981cd10: folds
e1628ffa: folds
53468d83: folds
cf40af3: folds
Hero: folds
Uncalled bet ($0.05) returned to cc841ed2
*** SHOWDOWN ***
cc841ed2 collected $0.12 from pot
*** SUMMARY ***
Total pot $0.12 | Rake $0 | Jackpot $0 | Bingo $0 | Fortune $0 | Tax $0
Seat 1: 53468d83 (button) folded before Flop (didn't bet)
Seat 2: cf40af3 (small blind) folded before Flop
Seat 3: Hero (big blind) folded before Flop
Seat 4: cc841ed2 collected ($0.12)
Seat 5: d981cd10 folded before Flop (didn't bet)
Seat 6: e1628ffa folded before Flop (didn't bet)


Poker Hand #RC3811229715: Hold'em No Limit ($0.02/$0.05) - 2025/08/16 13:22:45
Table 'RushAndCash854975' 6-max Seat #1 is the button
Seat 1: e3a8fca9 ($5.7 in chips)
Seat 2: Hero ($17.35 in chips)
Seat 3: eb124b29 ($5.55 in chips)
Seat 4: 750cd3 ($6.25 in chips)
Seat 5: 6fab6733 ($5.04 in chips)
Seat 6: ead0211e ($7.38 in chips)
Hero: posts small blind $0.02
eb124b29: posts big blind $0.05
*** HOLE CARDS ***
Dealt to e3a8fca9 
Dealt to Hero [9c 4h]
Dealt to eb124b29 
Dealt to 750cd3 
Dealt to 6fab6733 
Dealt to ead0211e 
750cd3: folds
6fab6733: folds
ead0211e: folds
e3a8fca9: raises $0.05 to $0.1
Hero: folds
eb124b29: folds
Uncalled bet ($0.05) returned to e3a8fca9
*** SHOWDOWN ***
e3a8fca9 collected $0.12 from pot
*** SUMMARY ***
Total pot $0.12 | Rake $0 | Jackpot $0 | Bingo $0 | Fortune $0 | Tax $0
Seat 1: e3a8fca9 (button) collected ($0.12)
Seat 2: Hero (small blind) folded before Flop
Seat 3: eb124b29 (big blind) folded before Flop
Seat 4: 750cd3 folded before Flop (didn't bet)
Seat 5: 6fab6733 folded before Flop (didn't bet)
Seat 6: ead0211e folded before Flop (didn't bet)


Poker Hand #RC3811229527: Hold'em No Limit ($0.02/$0.05) - 2025/08/16 13:22:02
Table 'RushAndCash854787' 6-max Seat #1 is the button
Seat 1: ead0211e ($7.38 in chips)
Seat 2: 6419c9d7 ($6.72 in chips)
Seat 3: Hero ($17.45 in chips)
Seat 4: 750cd3 ($6.04 in chips)
Seat 5: e3a8fca9 ($5.8 in chips)
Seat 6: 6fab6733 ($5.11 in chips)
6419c9d7: posts small blind $0.02
Hero: posts big blind $0.05
*** HOLE CARDS ***
Dealt to ead0211e 
Dealt to 6419c9d7 
Dealt to Hero [Ad 8c]
Dealt to 750cd3 
Dealt to e3a8fca9 
Dealt to 6fab6733 
750cd3: raises $0.05 to $0.1
e3a8fca9: calls $0.1
6fab6733: folds
ead0211e: folds
6419c9d7: folds
Hero: calls $0.05
*** FLOP *** [2s Ks 2h]
Hero: checks
750cd3: bets $0.1
e3a8fca9: folds
Hero: folds
Uncalled bet ($0.1) returned to 750cd3
*** SHOWDOWN ***
750cd3 collected $0.31 from pot
*** SUMMARY ***
Total pot $0.32 | Rake $0.01 | Jackpot $0 | Bingo $0 | Fortune $0 | Tax $0
Board [2s Ks 2h]
Seat 1: ead0211e (button) folded before Flop (didn't bet)
Seat 2: 6419c9d7 (small blind) folded before Flop
Seat 3: Hero (big blind) folded on the Flop
Seat 4: 750cd3 won ($0.31)
Seat 5: e3a8fca9 folded on the Flop
Seat 6: 6fab6733 folded before Flop (didn't bet)


Poker Hand #RC3811229512: Hold'em No Limit ($0.02/$0.05) - 2025/08/16 13:21:59
Table 'RushAndCash854772' 6-max Seat #1 is the button
Seat 1: 997a157f ($12.22 in chips)
Seat 2: 32436e51 ($2.72 in chips)
Seat 3: d981cd10 ($5 in chips)
Seat 4: 2ff313f1 ($6.32 in chips)
Seat 5: Hero ($17.45 in chips)
Seat 6: 5d9d05b1 ($5 in chips)
32436e51: posts small blind $0.02
d981cd10: posts big blind $0.05
*** HOLE CARDS ***
Dealt to 997a157f 
Dealt to 32436e51 
Dealt to d981cd10 
Dealt to 2ff313f1 
Dealt to Hero [5h 4c]
Dealt to 5d9d05b1 
2ff313f1: folds
Hero: folds
5d9d05b1: folds
997a157f: raises $0.05 to $0.1
32436e51: folds
d981cd10: folds
Uncalled bet ($0.05) returned to 997a157f
*** SHOWDOWN ***
997a157f collected $0.12 from pot
*** SUMMARY ***
Total pot $0.12 | Rake $0 | Jackpot $0 | Bingo $0 | Fortune $0 | Tax $0
Seat 1: 997a157f (button) collected ($0.12)
Seat 2: 32436e51 (small blind) folded before Flop
Seat 3: d981cd10 (big blind) folded before Flop
Seat 4: 2ff313f1 folded before Flop (didn't bet)
Seat 5: Hero folded before Flop (didn't bet)
Seat 6: 5d9d05b1 folded before Flop (didn't bet)


Poker Hand #RC3811229493: Hold'em No Limit ($0.02/$0.05) - 2025/08/16 13:21:55
Table 'RushAndCash854753' 6-max Seat #1 is the button
Seat 1: e7cb69c2 ($9.21 in chips)
Seat 2: 574825d9 ($3.64 in chips)
Seat 3: de2d8177 ($4.87 in chips)
Seat 4: Hero ($17.45 in chips)
Seat 5: c279a6b3 ($5 in chips)
Seat 6: 48e9176f ($22.74 in chips)
574825d9: posts small blind $0.02
de2d8177: posts big blind $0.05
*** HOLE CARDS ***
Dealt to e7cb69c2 
Dealt to 574825d9 
Dealt to de2d8177 
Dealt to Hero [9h Jh]
Dealt to c279a6b3 
Dealt to 48e9176f 
Hero: folds
c279a6b3: folds
48e9176f: folds
e7cb69c2: raises $0.05 to $0.1
574825d9: folds
de2d8177: folds
Uncalled bet ($0.05) returned to e7cb69c2
*** SHOWDOWN ***
e7cb69c2 collected $0.12 from pot
*** SUMMARY ***
Total pot $0.12 | Rake $0 | Jackpot $0 | Bingo $0 | Fortune $0 | Tax $0
Seat 1: e7cb69c2 (button) collected ($0.12)
Seat 2: 574825d9 (small blind) folded before Flop
Seat 3: de2d8177 (big blind) folded before Flop
Seat 4: Hero folded before Flop (didn't bet)
Seat 5: c279a6b3 folded before Flop (didn't bet)
Seat 6: 48e9176f folded before Flop (didn't bet)


Poker Hand #RC3811229475: Hold'em No Limit ($0.02/$0.05) - 2025/08/16 13:21:51
Table 'RushAndCash854735' 6-max Seat #1 is the button
Seat 1: 4aba04ef ($5.19 in chips)
Seat 2: 2200fae2 ($5.02 in chips)
Seat 3: 41ef1226 ($5.05 in chips)
Seat 4: 25646f0f ($5.04 in chips)
Seat 5: a0391971 ($8.1 in chips)
Seat 6: Hero ($17.45 in chips)
2200fae2: posts small blind $0.02
41ef1226: posts big blind $0.05
*** HOLE CARDS ***
Dealt to 4aba04ef 
Dealt to 2200fae2 
Dealt to 41ef1226 
Dealt to 25646f0f 
Dealt to a0391971 
Dealt to Hero [5c 4h]
25646f0f: folds
a0391971: folds
Hero: folds
4aba04ef: folds
2200fae2: raises $0.1 to $0.15
41ef1226: folds
Uncalled bet ($0.1) returned to 2200fae2
*** SHOWDOWN ***
2200fae2 collected $0.1 from pot
*** SUMMARY ***
Total pot $0.1 | Rake $0 | Jackpot $0 | Bingo $0 | Fortune $0 | Tax $0
Seat 1: 4aba04ef (button) folded before Flop (didn't bet)
Seat 2: 2200fae2 (small blind) collected ($0.1)
Seat 3: 41ef1226 (big blind) folded before Flop
Seat 4: 25646f0f folded before Flop (didn't bet)
Seat 5: a0391971 folded before Flop (didn't bet)
Seat 6: Hero folded before Flop (didn't bet)


Poker Hand #RC3811229459: Hold'em No Limit ($0.02/$0.05) - 2025/08/16 13:21:48
Table 'RushAndCash854719' 6-max Seat #1 is the button
Seat 1: 4b1c021d ($1.74 in chips)
Seat 2: 56099b06 ($2.5 in chips)
Seat 3: 493ed081 ($5 in chips)
Seat 4: 131ef941 ($5 in chips)
Seat 5: Hero ($17.45 in chips)
Seat 6: 4aba04ef ($5.19 in chips)
56099b06: posts small blind $0.02
493ed081: posts big blind $0.05
*** HOLE CARDS ***
Dealt to 4b1c021d 
Dealt to 56099b06 
Dealt to 493ed081 
Dealt to 131ef941 
Dealt to Hero [3h 2c]
Dealt to 4aba04ef 
131ef941: folds
Hero: folds
4aba04ef: folds
4b1c021d: folds
56099b06: folds
Uncalled bet ($0.03) returned to 493ed081
*** SHOWDOWN ***
493ed081 collected $0.04 from pot
*** SUMMARY ***
Total pot $0.04 | Rake $0 | Jackpot $0 | Bingo $0 | Fortune $0 | Tax $0
Seat 1: 4b1c021d (button) folded before Flop (didn't bet)
Seat 2: 56099b06 (small blind) folded before Flop
Seat 3: 493ed081 (big blind) collected ($0.04)
Seat 4: 131ef941 folded before Flop (didn't bet)
Seat 5: Hero folded before Flop (didn't bet)
Seat 6: 4aba04ef folded before Flop (didn't bet)


Poker Hand #RC3811229309: Hold'em No Limit ($0.02/$0.05) - 2025/08/16 13:21:16
Table 'RushAndCash854569' 6-max Seat #1 is the button
Seat 1: Hero ($17.58 in chips)
Seat 2: 15d53baa ($5.19 in chips)
Seat 3: f4ade85 ($6.71 in chips)
Seat 4: 4aba04ef ($5 in chips)
Seat 5: 5340c595 ($16.72 in chips)
Seat 6: de49edb2 ($4.9 in chips)
15d53baa: posts small blind $0.02
f4ade85: posts big blind $0.05
*** HOLE CARDS ***
Dealt to Hero [5h 7h]
Dealt to 15d53baa 
Dealt to f4ade85 
Dealt to 4aba04ef 
Dealt to 5340c595 
Dealt to de49edb2 
4aba04ef: raises $0.08 to $0.13
5340c595: folds
de49edb2: folds
Hero: calls $0.13
15d53baa: folds
f4ade85: folds
*** FLOP *** [Ad Qc 4c]
4aba04ef: checks
Hero: checks
*** TURN *** [Ad Qc 4c] [Kh]
4aba04ef: bets $0.17
Hero: folds
Uncalled bet ($0.17) returned to 4aba04ef
*** SHOWDOWN ***
4aba04ef collected $0.32 from pot
*** SUMMARY ***
Total pot $0.33 | Rake $0.01 | Jackpot $0 | Bingo $0 | Fortune $0 | Tax $0
Board [Ad Qc 4c Kh]
Seat 1: Hero (button) folded on the Turn
Seat 2: 15d53baa (small blind) folded before Flop
Seat 3: f4ade85 (big blind) folded before Flop
Seat 4: 4aba04ef won ($0.32)
Seat 5: 5340c595 folded before Flop (didn't bet)
Seat 6: de49edb2 folded before Flop (didn't bet)


Poker Hand #RC3811229292: Hold'em No Limit ($0.02/$0.05) - 2025/08/16 13:21:13
Table 'RushAndCash854552' 6-max Seat #1 is the button
Seat 1: 5340c595 ($16.72 in chips)
Seat 2: 41ef1226 ($5 in chips)
Seat 3: ce83ab8 ($7.8 in chips)
Seat 4: Hero ($17.58 in chips)
Seat 5: 562fab55 ($1.98 in chips)
Seat 6: 15d53baa ($5.19 in chips)
41ef1226: posts small blind $0.02
ce83ab8: posts big blind $0.05
*** HOLE CARDS ***
Dealt to 5340c595 
Dealt to 41ef1226 
Dealt to ce83ab8 
Dealt to Hero [3d 7c]
Dealt to 562fab55 
Dealt to 15d53baa 
Hero: folds
562fab55: raises $0.05 to $0.1
15d53baa: folds
5340c595: folds
41ef1226: folds
ce83ab8: raises $0.32 to $0.42
562fab55: calls $0.32
*** FLOP *** [Qc Jh 7s]
ce83ab8: checks
562fab55: bets $0.43
ce83ab8: calls $0.43
*** TURN *** [Qc Jh 7s] [5s]
ce83ab8: checks
562fab55: bets $1.13 and is all-in
ce83ab8: calls $1.13
562fab55: shows [Qs 8s] (a pair of Queens)
ce83ab8: shows [Ac Jc] (a pair of Jacks)
*** RIVER *** [Qc Jh 7s 5s] [Ts]
*** SHOWDOWN ***
562fab55 collected $3.76 from pot
*** SUMMARY ***
Total pot $3.98 | Rake $0.15 | Jackpot $0.07 | Bingo $0 | Fortune $0 | Tax $0
Board [Qc Jh 7s 5s Ts]
Seat 1: 5340c595 (button) folded before Flop (didn't bet)
Seat 2: 41ef1226 (small blind) folded before Flop
Seat 3: ce83ab8 (big blind) showed [Ac Jc] and lost with a pair of Jacks
Seat 4: Hero folded before Flop (didn't bet)
Seat 5: 562fab55 showed [Qs 8s] and won ($3.76) with a flush Queen high
Seat 6: 15d53baa folded before Flop (didn't bet)


Poker Hand #RC3811229274: Hold'em No Limit ($0.02/$0.05) - 2025/08/16 13:21:09
Table 'RushAndCash854534' 6-max Seat #1 is the button
Seat 1: 7d02f896 ($5 in chips)
Seat 2: 73d970a4 ($5 in chips)
Seat 3: 8b3d6303 ($8.38 in chips)
Seat 4: e406d38 ($4.68 in chips)
Seat 5: Hero ($17.58 in chips)
Seat 6: dea14c7d ($5.32 in chips)
73d970a4: posts small blind $0.02
8b3d6303: posts big blind $0.05
*** HOLE CARDS ***
Dealt to 7d02f896 
Dealt to 73d970a4 
Dealt to 8b3d6303 
Dealt to e406d38 
Dealt to Hero [5s 2s]
Dealt to dea14c7d 
e406d38: folds
Hero: folds
dea14c7d: raises $0.08 to $0.13
7d02f896: folds
73d970a4: folds
8b3d6303: folds
Uncalled bet ($0.08) returned to dea14c7d
*** SHOWDOWN ***
dea14c7d collected $0.12 from pot
*** SUMMARY ***
Total pot $0.12 | Rake $0 | Jackpot $0 | Bingo $0 | Fortune $0 | Tax $0
Seat 1: 7d02f896 (button) folded before Flop (didn't bet)
Seat 2: 73d970a4 (small blind) folded before Flop
Seat 3: 8b3d6303 (big blind) folded before Flop
Seat 4: e406d38 folded before Flop (didn't bet)
Seat 5: Hero folded before Flop (didn't bet)
Seat 6: dea14c7d collected ($0.12)


Poker Hand #RC3811229082: Hold'em No Limit ($0.02/$0.05) - 2025/08/16 13:20:26
Table 'RushAndCash854342' 6-max Seat #1 is the button
Seat 1: ca2bb0fc ($6.65 in chips)
Seat 2: e7cb69c2 ($9.45 in chips)
Seat 3: Hero ($17.31 in chips)
Seat 4: 493ed081 ($8.34 in chips)
Seat 5: 57edc162 ($5 in chips)
Seat 6: dea14c7d ($5.59 in chips)
e7cb69c2: posts small blind $0.02
Hero: posts big blind $0.05
*** HOLE CARDS ***
Dealt to ca2bb0fc 
Dealt to e7cb69c2 
Dealt to Hero [4c 7c]
Dealt to 493ed081 
Dealt to 57edc162 
Dealt to dea14c7d 
493ed081: folds
57edc162: folds
dea14c7d: raises $0.08 to $0.13
ca2bb0fc: folds
e7cb69c2: folds
Hero: calls $0.08
*** FLOP *** [9h 5s 3c]
Hero: checks
dea14c7d: bets $0.14
Hero: raises $0.34 to $0.48
dea14c7d: folds
Uncalled bet ($0.34) returned to Hero
*** SHOWDOWN ***
Hero collected $0.54 from pot
*** SUMMARY ***
Total pot $0.56 | Rake $0.02 | Jackpot $0 | Bingo $0 | Fortune $0 | Tax $0
Board [9h 5s 3c]
Seat 1: ca2bb0fc (button) folded before Flop (didn't bet)
Seat 2: e7cb69c2 (small blind) folded before Flop
Seat 3: Hero (big blind) won ($0.54)
Seat 4: 493ed081 folded before Flop (didn't bet)
Seat 5: 57edc162 folded before Flop (didn't bet)
Seat 6: dea14c7d folded on the Flop


Poker Hand #RC3811229016: Hold'em No Limit ($0.02/$0.05) - 2025/08/16 13:20:12
Table 'RushAndCash854276' 6-max Seat #1 is the button
Seat 1: 188a67f6 ($6.86 in chips)
Seat 2: Hero ($17.33 in chips)
Seat 3: 97493c82 ($5.41 in chips)
Seat 4: b3b554ce ($5.2 in chips)
Seat 5: ec79c726 ($5 in chips)
Seat 6: c279a6b3 ($5.11 in chips)
Hero: posts small blind $0.02
97493c82: posts big blind $0.05
*** HOLE CARDS ***
Dealt to 188a67f6 
Dealt to Hero [4s Jd]
Dealt to 97493c82 
Dealt to b3b554ce 
Dealt to ec79c726 
Dealt to c279a6b3 
b3b554ce: raises $0.05 to $0.1
ec79c726: folds
c279a6b3: folds
188a67f6: folds
Hero: folds
97493c82: folds
Uncalled bet ($0.05) returned to b3b554ce
*** SHOWDOWN ***
b3b554ce collected $0.12 from pot
*** SUMMARY ***
Total pot $0.12 | Rake $0 | Jackpot $0 | Bingo $0 | Fortune $0 | Tax $0
Seat 1: 188a67f6 (button) folded before Flop (didn't bet)
Seat 2: Hero (small blind) folded before Flop
Seat 3: 97493c82 (big blind) folded before Flop
Seat 4: b3b554ce collected ($0.12)
Seat 5: ec79c726 folded before Flop (didn't bet)
Seat 6: c279a6b3 folded before Flop (didn't bet)


Poker Hand #RC3811228997: Hold'em No Limit ($0.02/$0.05) - 2025/08/16 13:20:08
Table 'RushAndCash854257' 6-max Seat #1 is the button
Seat 1: 343e61a8 ($5 in chips)
Seat 2: 1c015352 ($6.33 in chips)
Seat 3: 6b644717 ($3.2 in chips)
Seat 4: b1978652 ($5.96 in chips)
Seat 5: d4de914c ($4.09 in chips)
Seat 6: Hero ($17.33 in chips)
1c015352: posts small blind $0.02
6b644717: posts big blind $0.05
*** HOLE CARDS ***
Dealt to 343e61a8 
Dealt to 1c015352 
Dealt to 6b644717 
Dealt to b1978652 
Dealt to d4de914c 
Dealt to Hero [9c 8h]
b1978652: folds
d4de914c: folds
Hero: folds
343e61a8: folds
1c015352: folds
Uncalled bet ($0.03) returned to 6b644717
*** SHOWDOWN ***
6b644717 collected $0.04 from pot
*** SUMMARY ***
Total pot $0.04 | Rake $0 | Jackpot $0 | Bingo $0 | Fortune $0 | Tax $0
Seat 1: 343e61a8 (button) folded before Flop (didn't bet)
Seat 2: 1c015352 (small blind) folded before Flop
Seat 3: 6b644717 (big blind) collected ($0.04)
Seat 4: b1978652 folded before Flop (didn't bet)
Seat 5: d4de914c folded before Flop (didn't bet)
Seat 6: Hero folded before Flop (didn't bet)


Poker Hand #RC3811228978: Hold'em No Limit ($0.02/$0.05) - 2025/08/16 13:20:05
Table 'RushAndCash854238' 6-max Seat #1 is the button
Seat 1: 1b34b380 ($14.22 in chips)
Seat 2: f68b1f38 ($5.69 in chips)
Seat 3: f18dae06 ($13.9 in chips)
Seat 4: b94644f5 ($7.25 in chips)
Seat 5: 10369860 ($5 in chips)
Seat 6: Hero ($17.33 in chips)
f68b1f38: posts small blind $0.02
f18dae06: posts big blind $0.05
*** HOLE CARDS ***
Dealt to 1b34b380 
Dealt to f68b1f38 
Dealt to f18dae06 
Dealt to b94644f5 
Dealt to 10369860 
Dealt to Hero [6c Td]
b94644f5: calls $0.05
10369860: folds
Hero: folds
1b34b380: folds
f68b1f38: folds
f18dae06: checks
*** FLOP *** [8d 3s 7s]
f18dae06: checks
b94644f5: checks
*** TURN *** [8d 3s 7s] [8h]
f18dae06: checks
b94644f5: bets $0.06
f18dae06: folds
Uncalled bet ($0.06) returned to b94644f5
*** SHOWDOWN ***
b94644f5 collected $0.12 from pot
*** SUMMARY ***
Total pot $0.12 | Rake $0 | Jackpot $0 | Bingo $0 | Fortune $0 | Tax $0
Board [8d 3s 7s 8h]
Seat 1: 1b34b380 (button) folded before Flop (didn't bet)
Seat 2: f68b1f38 (small blind) folded before Flop
Seat 3: f18dae06 (big blind) folded on the Turn
Seat 4: b94644f5 won ($0.12)
Seat 5: 10369860 folded before Flop (didn't bet)
Seat 6: Hero folded before Flop (didn't bet)


Poker Hand #RC3811228916: Hold'em No Limit ($0.02/$0.05) - 2025/08/16 13:19:52
Table 'RushAndCash854176' 6-max Seat #1 is the button
Seat 1: Hero ($17.26 in chips)
Seat 2: 9b7ef7b0 ($6.55 in chips)
Seat 3: fe38f94c ($2 in chips)
Seat 4: 58f42367 ($4.4 in chips)
Seat 5: 90ca1142 ($5.44 in chips)
Seat 6: 4cf212ec ($4.14 in chips)
9b7ef7b0: posts small blind $0.02
fe38f94c: posts big blind $0.05
*** HOLE CARDS ***
Dealt to Hero [6s 3s]
Dealt to 9b7ef7b0 
Dealt to fe38f94c 
Dealt to 58f42367 
Dealt to 90ca1142 
Dealt to 4cf212ec 
58f42367: folds
90ca1142: folds
4cf212ec: folds
Hero: raises $0.05 to $0.1
9b7ef7b0: folds
fe38f94c: folds
Uncalled bet ($0.05) returned to Hero
*** SHOWDOWN ***
Hero collected $0.12 from pot
*** SUMMARY ***
Total pot $0.12 | Rake $0 | Jackpot $0 | Bingo $0 | Fortune $0 | Tax $0
Seat 1: Hero (button) collected ($0.12)
Seat 2: 9b7ef7b0 (small blind) folded before Flop
Seat 3: fe38f94c (big blind) folded before Flop
Seat 4: 58f42367 folded before Flop (didn't bet)
Seat 5: 90ca1142 folded before Flop (didn't bet)
Seat 6: 4cf212ec folded before Flop (didn't bet)


Poker Hand #RC3811228879: Hold'em No Limit ($0.02/$0.05) - 2025/08/16 13:19:44
Table 'RushAndCash854139' 6-max Seat #1 is the button
Seat 1: de49edb2 ($4.97 in chips)
Seat 2: Hero ($17.28 in chips)
Seat 3: 8ebaac0c ($5.07 in chips)
Seat 4: 3ef86869 ($6.38 in chips)
Seat 5: e1628ffa ($4.55 in chips)
Seat 6: 3bb77eec ($2.42 in chips)
Hero: posts small blind $0.02
8ebaac0c: posts big blind $0.05
*** HOLE CARDS ***
Dealt to de49edb2 
Dealt to Hero [2d 8h]
Dealt to 8ebaac0c 
Dealt to 3ef86869 
Dealt to e1628ffa 
Dealt to 3bb77eec 
3ef86869: folds
e1628ffa: folds
3bb77eec: folds
de49edb2: folds
Hero: folds
Uncalled bet ($0.03) returned to 8ebaac0c
*** SHOWDOWN ***
8ebaac0c collected $0.04 from pot
*** SUMMARY ***
Total pot $0.04 | Rake $0 | Jackpot $0 | Bingo $0 | Fortune $0 | Tax $0
Seat 1: de49edb2 (button) folded before Flop (didn't bet)
Seat 2: Hero (small blind) folded before Flop
Seat 3: 8ebaac0c (big blind) collected ($0.04)
Seat 4: 3ef86869 folded before Flop (didn't bet)
Seat 5: e1628ffa folded before Flop (didn't bet)
Seat 6: 3bb77eec folded before Flop (didn't bet)


Poker Hand #RC3811228795: Hold'em No Limit ($0.02/$0.05) - 2025/08/16 13:19:26
Table 'RushAndCash854055' 6-max Seat #1 is the button
Seat 1: 74b4b4bd ($6.5 in chips)
Seat 2: 3ef86869 ($6.4 in chips)
Seat 3: Hero ($17.33 in chips)
Seat 4: 62d20b3c ($6.16 in chips)
Seat 5: c31e283f ($5.36 in chips)
Seat 6: 319f9ef4 ($11.6 in chips)
3ef86869: posts small blind $0.02
Hero: posts big blind $0.05
*** HOLE CARDS ***
Dealt to 74b4b4bd 
Dealt to 3ef86869 
Dealt to Hero [Kc 9c]
Dealt to 62d20b3c 
Dealt to c31e283f 
Dealt to 319f9ef4 
62d20b3c: folds
c31e283f: raises $0.05 to $0.1
319f9ef4: raises $0.24 to $0.34
74b4b4bd: folds
3ef86869: folds
Hero: folds
c31e283f: calls $0.24
*** FLOP *** [Kd 5d Qd]
c31e283f: checks
319f9ef4: checks
*** TURN *** [Kd 5d Qd] [3c]
c31e283f: checks
319f9ef4: checks
*** RIVER *** [Kd 5d Qd 3c] [4h]
c31e283f: checks
319f9ef4: checks
c31e283f: shows [8h 8s] (a pair of Eights)
319f9ef4: shows [Ts Td] (a pair of Tens)
*** SHOWDOWN ***
319f9ef4 collected $0.72 from pot
*** SUMMARY ***
Total pot $0.75 | Rake $0.03 | Jackpot $0 | Bingo $0 | Fortune $0 | Tax $0
Board [Kd 5d Qd 3c 4h]
Seat 1: 74b4b4bd (button) folded before Flop (didn't bet)
Seat 2: 3ef86869 (small blind) folded before Flop
Seat 3: Hero (big blind) folded before Flop
Seat 4: 62d20b3c folded before Flop (didn't bet)
Seat 5: c31e283f showed [8h 8s] and lost with a pair of Eights
Seat 6: 319f9ef4 showed [Ts Td] and won ($0.72) with a pair of Tens


Poker Hand #RC3811228750: Hold'em No Limit ($0.02/$0.05) - 2025/08/16 13:19:16
Table 'RushAndCash854010' 6-max Seat #1 is the button
Seat 1: Hero ($17.33 in chips)
Seat 2: 94afcc3f ($6.42 in chips)
Seat 3: ca2bb0fc ($6.65 in chips)
Seat 4: 5c5f6f86 ($5.96 in chips)
Seat 5: e8f2f382 ($5.72 in chips)
Seat 6: c2dc4208 ($10.13 in chips)
94afcc3f: posts small blind $0.02
ca2bb0fc: posts big blind $0.05
*** HOLE CARDS ***
Dealt to Hero [2c Ts]
Dealt to 94afcc3f 
Dealt to ca2bb0fc 
Dealt to 5c5f6f86 
Dealt to e8f2f382 
Dealt to c2dc4208 
5c5f6f86: folds
e8f2f382: raises $0.05 to $0.1
c2dc4208: folds
Hero: folds
94afcc3f: folds
ca2bb0fc: folds
Uncalled bet ($0.05) returned to e8f2f382
*** SHOWDOWN ***
e8f2f382 collected $0.12 from pot
*** SUMMARY ***
Total pot $0.12 | Rake $0 | Jackpot $0 | Bingo $0 | Fortune $0 | Tax $0
Seat 1: Hero (button) folded before Flop (didn't bet)
Seat 2: 94afcc3f (small blind) folded before Flop
Seat 3: ca2bb0fc (big blind) folded before Flop
Seat 4: 5c5f6f86 folded before Flop (didn't bet)
Seat 5: e8f2f382 collected ($0.12)
Seat 6: c2dc4208 folded before Flop (didn't bet)


Poker Hand #RC3811228702: Hold'em No Limit ($0.02/$0.05) - 2025/08/16 13:19:06
Table 'RushAndCash853962' 6-max Seat #1 is the button
Seat 1: Hero ($17.33 in chips)
Seat 2: 3005d008 ($5.97 in chips)
Seat 3: cda1ccc8 ($5.41 in chips)
Seat 4: 6fe93ba5 ($2.21 in chips)
Seat 5: d92429ab ($5.15 in chips)
Seat 6: f7220028 ($7.1 in chips)
3005d008: posts small blind $0.02
cda1ccc8: posts big blind $0.05
*** HOLE CARDS ***
Dealt to Hero [6h 9c]
Dealt to 3005d008 
Dealt to cda1ccc8 
Dealt to 6fe93ba5 
Dealt to d92429ab 
Dealt to f7220028 
6fe93ba5: raises $0.06 to $0.11
d92429ab: folds
f7220028: folds
Hero: folds
3005d008: folds
cda1ccc8: folds
Uncalled bet ($0.06) returned to 6fe93ba5
*** SHOWDOWN ***
6fe93ba5 collected $0.12 from pot
*** SUMMARY ***
Total pot $0.12 | Rake $0 | Jackpot $0 | Bingo $0 | Fortune $0 | Tax $0
Seat 1: Hero (button) folded before Flop (didn't bet)
Seat 2: 3005d008 (small blind) folded before Flop
Seat 3: cda1ccc8 (big blind) folded before Flop
Seat 4: 6fe93ba5 collected ($0.12)
Seat 5: d92429ab folded before Flop (didn't bet)
Seat 6: f7220028 folded before Flop (didn't bet)


Poker Hand #RC3811228647: Hold'em No Limit ($0.02/$0.05) - 2025/08/16 13:18:52
Table 'RushAndCash853907' 6-max Seat #1 is the button
Seat 1: d3b35555 ($3.07 in chips)
Seat 2: Hero ($17.35 in chips)
Seat 3: df91ffd8 ($9.96 in chips)
Seat 4: dc4b476b ($6.6 in chips)
Seat 5: ae86fd86 ($5.87 in chips)
Seat 6: d981cd10 ($5.17 in chips)
Hero: posts small blind $0.02
df91ffd8: posts big blind $0.05
*** HOLE CARDS ***
Dealt to d3b35555 
Dealt to Hero [Qh 5d]
Dealt to df91ffd8 
Dealt to dc4b476b 
Dealt to ae86fd86 
Dealt to d981cd10 
dc4b476b: raises $0.06 to $0.11
ae86fd86: folds
d981cd10: folds
d3b35555: folds
Hero: folds
df91ffd8: folds
Uncalled bet ($0.06) returned to dc4b476b
*** SHOWDOWN ***
dc4b476b collected $0.12 from pot
*** SUMMARY ***
Total pot $0.12 | Rake $0 | Jackpot $0 | Bingo $0 | Fortune $0 | Tax $0
Seat 1: d3b35555 (button) folded before Flop (didn't bet)
Seat 2: Hero (small blind) folded before Flop
Seat 3: df91ffd8 (big blind) folded before Flop
Seat 4: dc4b476b collected ($0.12)
Seat 5: ae86fd86 folded before Flop (didn't bet)
Seat 6: d981cd10 folded before Flop (didn't bet)


Poker Hand #RC3811227512: Hold'em No Limit ($0.02/$0.05) - 2025/08/16 13:14:39
Table 'RushAndCash852772' 6-max Seat #1 is the button
Seat 1: 750cd3 ($5 in chips)
Seat 2: 8437659 ($5.93 in chips)
Seat 3: dce7f224 ($20.38 in chips)
Seat 4: fd52c4fb ($5.62 in chips)
Seat 5: Hero ($17.35 in chips)
Seat 6: ead0211e ($6.38 in chips)
8437659: posts small blind $0.02
dce7f224: posts big blind $0.05
*** HOLE CARDS ***
Dealt to 750cd3 
Dealt to 8437659 
Dealt to dce7f224 
Dealt to fd52c4fb 
Dealt to Hero [5s 7d]
Dealt to ead0211e 
fd52c4fb: folds
Hero: folds
ead0211e: folds
750cd3: folds
8437659: raises $0.1 to $0.15
dce7f224: folds
Uncalled bet ($0.1) returned to 8437659
*** SHOWDOWN ***
8437659 collected $0.1 from pot
*** SUMMARY ***
Total pot $0.1 | Rake $0 | Jackpot $0 | Bingo $0 | Fortune $0 | Tax $0
Seat 1: 750cd3 (button) folded before Flop (didn't bet)
Seat 2: 8437659 (small blind) collected ($0.1)
Seat 3: dce7f224 (big blind) folded before Flop
Seat 4: fd52c4fb folded before Flop (didn't bet)
Seat 5: Hero folded before Flop (didn't bet)
Seat 6: ead0211e folded before Flop (didn't bet)


Poker Hand #RC3811227488: Hold'em No Limit ($0.02/$0.05) - 2025/08/16 13:14:33
Table 'RushAndCash852748' 6-max Seat #1 is the button
Seat 1: 4d72244d ($1.81 in chips)
Seat 2: 356cf6de ($5.04 in chips)
Seat 3: 1c015352 ($7.15 in chips)
Seat 4: 57846c0 ($4.63 in chips)
Seat 5: 19480dc1 ($7.08 in chips)
Seat 6: Hero ($17.35 in chips)
356cf6de: posts small blind $0.02
1c015352: posts big blind $0.05
*** HOLE CARDS ***
Dealt to 4d72244d 
Dealt to 356cf6de 
Dealt to 1c015352 
Dealt to 57846c0 
Dealt to 19480dc1 
Dealt to Hero [2d 5s]
57846c0: folds
19480dc1: folds
Hero: folds
4d72244d: folds
356cf6de: folds
Uncalled bet ($0.03) returned to 1c015352
*** SHOWDOWN ***
1c015352 collected $0.04 from pot
*** SUMMARY ***
Total pot $0.04 | Rake $0 | Jackpot $0 | Bingo $0 | Fortune $0 | Tax $0
Seat 1: 4d72244d (button) folded before Flop (didn't bet)
Seat 2: 356cf6de (small blind) folded before Flop
Seat 3: 1c015352 (big blind) collected ($0.04)
Seat 4: 57846c0 folded before Flop (didn't bet)
Seat 5: 19480dc1 folded before Flop (didn't bet)
Seat 6: Hero folded before Flop (didn't bet)


Poker Hand #RC3811227410: Hold'em No Limit ($0.02/$0.05) - 2025/08/16 13:14:17
Table 'RushAndCash852670' 6-max Seat #1 is the button
Seat 1: 3eba34ff ($5 in chips)
Seat 2: 917f3e19 ($6.18 in chips)
Seat 3: Hero ($17.4 in chips)
Seat 4: 4f917eaf ($5.34 in chips)
Seat 5: 9dd71188 ($5.59 in chips)
Seat 6: 45eea39e ($11.16 in chips)
917f3e19: posts small blind $0.02
Hero: posts big blind $0.05
*** HOLE CARDS ***
Dealt to 3eba34ff 
Dealt to 917f3e19 
Dealt to Hero [8d Ac]
Dealt to 4f917eaf 
Dealt to 9dd71188 
Dealt to 45eea39e 
4f917eaf: folds
9dd71188: raises $0.08 to $0.13
45eea39e: folds
3eba34ff: folds
917f3e19: folds
Hero: folds
Uncalled bet ($0.08) returned to 9dd71188
*** SHOWDOWN ***
9dd71188 collected $0.12 from pot
*** SUMMARY ***
Total pot $0.12 | Rake $0 | Jackpot $0 | Bingo $0 | Fortune $0 | Tax $0
Seat 1: 3eba34ff (button) folded before Flop (didn't bet)
Seat 2: 917f3e19 (small blind) folded before Flop
Seat 3: Hero (big blind) folded before Flop
Seat 4: 4f917eaf folded before Flop (didn't bet)
Seat 5: 9dd71188 collected ($0.12)
Seat 6: 45eea39e folded before Flop (didn't bet)


Poker Hand #RC3811227392: Hold'em No Limit ($0.02/$0.05) - 2025/08/16 13:14:13
Table 'RushAndCash852652' 6-max Seat #1 is the button
Seat 1: 25646f0f ($5.12 in chips)
Seat 2: e88b4b2 ($6.02 in chips)
Seat 3: 3dd958bc ($5.41 in chips)
Seat 4: 233b28a ($5.3 in chips)
Seat 5: Hero ($17.4 in chips)
Seat 6: 95e16b02 ($3.48 in chips)
e88b4b2: posts small blind $0.02
3dd958bc: posts big blind $0.05
*** HOLE CARDS ***
Dealt to 25646f0f 
Dealt to e88b4b2 
Dealt to 3dd958bc 
Dealt to 233b28a 
Dealt to Hero [2d 9d]
Dealt to 95e16b02 
233b28a: folds
Hero: folds
95e16b02: raises $0.15 to $0.2
25646f0f: folds
e88b4b2: folds
3dd958bc: calls $0.15
*** FLOP *** [8h 6c Qd]
3dd958bc: checks
95e16b02: bets $0.21
3dd958bc: folds
Uncalled bet ($0.21) returned to 95e16b02
*** SHOWDOWN ***
95e16b02 collected $0.4 from pot
*** SUMMARY ***
Total pot $0.42 | Rake $0.02 | Jackpot $0 | Bingo $0 | Fortune $0 | Tax $0
Board [8h 6c Qd]
Seat 1: 25646f0f (button) folded before Flop (didn't bet)
Seat 2: e88b4b2 (small blind) folded before Flop
Seat 3: 3dd958bc (big blind) folded on the Flop
Seat 4: 233b28a folded before Flop (didn't bet)
Seat 5: Hero folded before Flop (didn't bet)
Seat 6: 95e16b02 won ($0.4)


Poker Hand #RC3811227377: Hold'em No Limit ($0.02/$0.05) - 2025/08/16 13:14:09
Table 'RushAndCash852637' 6-max Seat #1 is the button
Seat 1: 4b1c021d ($1.93 in chips)
Seat 2: 8ebce41a ($5.14 in chips)
Seat 3: 4ef6f023 ($5 in chips)
Seat 4: dbc77349 ($5.04 in chips)
Seat 5: b6fa424b ($5.26 in chips)
Seat 6: Hero ($17.4 in chips)
8ebce41a: posts small blind $0.02
4ef6f023: posts big blind $0.05
*** HOLE CARDS ***
Dealt to 4b1c021d 
Dealt to 8ebce41a 
Dealt to 4ef6f023 
Dealt to dbc77349 
Dealt to b6fa424b 
Dealt to Hero [Th 4s]
dbc77349: folds
b6fa424b: folds
Hero: folds
4b1c021d: folds
8ebce41a: raises $0.1 to $0.15
4ef6f023: folds
Uncalled bet ($0.1) returned to 8ebce41a
*** SHOWDOWN ***
8ebce41a collected $0.1 from pot
*** SUMMARY ***
Total pot $0.1 | Rake $0 | Jackpot $0 | Bingo $0 | Fortune $0 | Tax $0
Seat 1: 4b1c021d (button) folded before Flop (didn't bet)
Seat 2: 8ebce41a (small blind) collected ($0.1)
Seat 3: 4ef6f023 (big blind) folded before Flop
Seat 4: dbc77349 folded before Flop (didn't bet)
Seat 5: b6fa424b folded before Flop (didn't bet)
Seat 6: Hero folded before Flop (didn't bet)


Poker Hand #RC3811227361: Hold'em No Limit ($0.02/$0.05) - 2025/08/16 13:14:06
Table 'RushAndCash852621' 6-max Seat #1 is the button
Seat 1: 856a263b ($9.04 in chips)
Seat 2: 9c157bbf ($5.07 in chips)
Seat 3: 343e61a8 ($5.23 in chips)
Seat 4: 1613b352 ($11.32 in chips)
Seat 5: 45eea39e ($11.16 in chips)
Seat 6: Hero ($17.4 in chips)
9c157bbf: posts small blind $0.02
343e61a8: posts big blind $0.05
*** HOLE CARDS ***
Dealt to 856a263b 
Dealt to 9c157bbf 
Dealt to 343e61a8 
Dealt to 1613b352 
Dealt to 45eea39e 
Dealt to Hero [3d 2h]
1613b352: folds
45eea39e: folds
Hero: folds
856a263b: folds
9c157bbf: folds
Uncalled bet ($0.03) returned to 343e61a8
*** SHOWDOWN ***
343e61a8 collected $0.04 from pot
*** SUMMARY ***
Total pot $0.04 | Rake $0 | Jackpot $0 | Bingo $0 | Fortune $0 | Tax $0
Seat 1: 856a263b (button) folded before Flop (didn't bet)
Seat 2: 9c157bbf (small blind) folded before Flop
Seat 3: 343e61a8 (big blind) collected ($0.04)
Seat 4: 1613b352 folded before Flop (didn't bet)
Seat 5: 45eea39e folded before Flop (didn't bet)
Seat 6: Hero folded before Flop (didn't bet)


Poker Hand #RC3811227266: Hold'em No Limit ($0.02/$0.05) - 2025/08/16 13:13:47
Table 'RushAndCash852526' 6-max Seat #1 is the button
Seat 1: a178a7ae ($2.3 in chips)
Seat 2: 45eea39e ($11.31 in chips)
Seat 3: Hero ($17.26 in chips)
Seat 4: 63365158 ($3.74 in chips)
Seat 5: 7bef0a2e ($2.25 in chips)
Seat 6: 368c4e75 ($7.97 in chips)
45eea39e: posts small blind $0.02
Hero: posts big blind $0.05
*** HOLE CARDS ***
Dealt to a178a7ae 
Dealt to 45eea39e 
Dealt to Hero [Ts 8s]
Dealt to 63365158 
Dealt to 7bef0a2e 
Dealt to 368c4e75 
63365158: folds
7bef0a2e: folds
368c4e75: folds
a178a7ae: folds
45eea39e: raises $0.1 to $0.15
Hero: raises $0.36 to $0.51
45eea39e: folds
Uncalled bet ($0.36) returned to Hero
*** SHOWDOWN ***
Hero collected $0.29 from pot
*** SUMMARY ***
Total pot $0.3 | Rake $0.01 | Jackpot $0 | Bingo $0 | Fortune $0 | Tax $0
Seat 1: a178a7ae (button) folded before Flop (didn't bet)
Seat 2: 45eea39e (small blind) folded before Flop
Seat 3: Hero (big blind) collected ($0.29)
Seat 4: 63365158 folded before Flop (didn't bet)
Seat 5: 7bef0a2e folded before Flop (didn't bet)
Seat 6: 368c4e75 folded before Flop (didn't bet)


Poker Hand #RC3811227168: Hold'em No Limit ($0.02/$0.05) - 2025/08/16 13:13:26
Table 'RushAndCash852428' 6-max Seat #1 is the button
Seat 1: f5902ff5 ($7.94 in chips)
Seat 2: 7bf33a65 ($17.16 in chips)
Seat 3: 63365158 ($3.53 in chips)
Seat 4: 9870a6c2 ($12.88 in chips)
Seat 5: Hero ($17.36 in chips)
Seat 6: b57e9625 ($5.65 in chips)
7bf33a65: posts small blind $0.02
63365158: posts big blind $0.05
*** HOLE CARDS ***
Dealt to f5902ff5 
Dealt to 7bf33a65 
Dealt to 63365158 
Dealt to 9870a6c2 
Dealt to Hero [7s As]
Dealt to b57e9625 
9870a6c2: folds
Hero: raises $0.05 to $0.1
b57e9625: folds
f5902ff5: calls $0.1
7bf33a65: folds
63365158: raises $0.45 to $0.55
Hero: folds
f5902ff5: folds
Uncalled bet ($0.45) returned to 63365158
*** SHOWDOWN ***
63365158 collected $0.31 from pot
*** SUMMARY ***
Total pot $0.32 | Rake $0.01 | Jackpot $0 | Bingo $0 | Fortune $0 | Tax $0
Seat 1: f5902ff5 (button) folded before Flop
Seat 2: 7bf33a65 (small blind) folded before Flop
Seat 3: 63365158 (big blind) collected ($0.31)
Seat 4: 9870a6c2 folded before Flop (didn't bet)
Seat 5: Hero folded before Flop
Seat 6: b57e9625 folded before Flop (didn't bet)


Poker Hand #RC3811227151: Hold'em No Limit ($0.02/$0.05) - 2025/08/16 13:13:23
Table 'RushAndCash852411' 6-max Seat #1 is the button
Seat 1: af718e4b ($27.14 in chips)
Seat 2: 63365158 ($3.55 in chips)
Seat 3: 9b7ef7b0 ($5.31 in chips)
Seat 4: Hero ($17.36 in chips)
Seat 5: 7bf33a65 ($17.16 in chips)
Seat 6: 6daf85fc ($5.19 in chips)
63365158: posts small blind $0.02
9b7ef7b0: posts big blind $0.05
*** HOLE CARDS ***
Dealt to af718e4b 
Dealt to 63365158 
Dealt to 9b7ef7b0 
Dealt to Hero [Kd 5s]
Dealt to 7bf33a65 
Dealt to 6daf85fc 
Hero: folds
7bf33a65: folds
6daf85fc: folds
af718e4b: folds
63365158: folds
Uncalled bet ($0.03) returned to 9b7ef7b0
*** SHOWDOWN ***
9b7ef7b0 collected $0.04 from pot
*** SUMMARY ***
Total pot $0.04 | Rake $0 | Jackpot $0 | Bingo $0 | Fortune $0 | Tax $0
Seat 1: af718e4b (button) folded before Flop (didn't bet)
Seat 2: 63365158 (small blind) folded before Flop
Seat 3: 9b7ef7b0 (big blind) collected ($0.04)
Seat 4: Hero folded before Flop (didn't bet)
Seat 5: 7bf33a65 folded before Flop (didn't bet)
Seat 6: 6daf85fc folded before Flop (didn't bet)


Poker Hand #RC3811227120: Hold'em No Limit ($0.02/$0.05) - 2025/08/16 13:13:16
Table 'RushAndCash852380' 6-max Seat #1 is the button
Seat 1: Hero ($17.36 in chips)
Seat 2: ef779654 ($8.16 in chips)
Seat 3: ae4775f8 ($5.75 in chips)
Seat 4: 4cf212ec ($4.92 in chips)
Seat 5: 192c6104 ($9.49 in chips)
Seat 6: 21289bc3 ($6.32 in chips)
ef779654: posts small blind $0.02
ae4775f8: posts big blind $0.05
*** HOLE CARDS ***
Dealt to Hero [3c 5s]
Dealt to ef779654 
Dealt to ae4775f8 
Dealt to 4cf212ec 
Dealt to 192c6104 
Dealt to 21289bc3 
4cf212ec: folds
192c6104: folds
21289bc3: folds
Hero: folds
ef779654: raises $0.05 to $0.1
ae4775f8: folds
Uncalled bet ($0.05) returned to ef779654
*** SHOWDOWN ***
ef779654 collected $0.1 from pot
*** SUMMARY ***
Total pot $0.1 | Rake $0 | Jackpot $0 | Bingo $0 | Fortune $0 | Tax $0
Seat 1: Hero (button) folded before Flop (didn't bet)
Seat 2: ef779654 (small blind) collected ($0.1)
Seat 3: ae4775f8 (big blind) folded before Flop
Seat 4: 4cf212ec folded before Flop (didn't bet)
Seat 5: 192c6104 folded before Flop (didn't bet)
Seat 6: 21289bc3 folded before Flop (didn't bet)


Poker Hand #RC3811227092: Hold'em No Limit ($0.02/$0.05) - 2025/08/16 13:13:10
Table 'RushAndCash852352' 6-max Seat #1 is the button
Seat 1: f4ade85 ($6.17 in chips)
Seat 2: Hero ($17.38 in chips)
Seat 3: 3eba34ff ($5 in chips)
Seat 4: c09afc51 ($13.01 in chips)
Seat 5: 679d1db9 ($6.61 in chips)
Seat 6: 45eea39e ($11.29 in chips)
Hero: posts small blind $0.02
3eba34ff: posts big blind $0.05
*** HOLE CARDS ***
Dealt to f4ade85 
Dealt to Hero [Qc 4d]
Dealt to 3eba34ff 
Dealt to c09afc51 
Dealt to 679d1db9 
Dealt to 45eea39e 
c09afc51: folds
679d1db9: folds
45eea39e: folds
f4ade85: raises $0.07 to $0.12
Hero: folds
3eba34ff: folds
Uncalled bet ($0.07) returned to f4ade85
*** SHOWDOWN ***
f4ade85 collected $0.12 from pot
*** SUMMARY ***
Total pot $0.12 | Rake $0 | Jackpot $0 | Bingo $0 | Fortune $0 | Tax $0
Seat 1: f4ade85 (button) collected ($0.12)
Seat 2: Hero (small blind) folded before Flop
Seat 3: 3eba34ff (big blind) folded before Flop
Seat 4: c09afc51 folded before Flop (didn't bet)
Seat 5: 679d1db9 folded before Flop (didn't bet)
Seat 6: 45eea39e folded before Flop (didn't bet)


Poker Hand #RC3811227074: Hold'em No Limit ($0.02/$0.05) - 2025/08/16 13:13:06
Table 'RushAndCash852334' 6-max Seat #1 is the button
Seat 1: fad7a12d ($6.73 in chips)
Seat 2: 45eea39e ($11.31 in chips)
Seat 3: d92261bd ($2.73 in chips)
Seat 4: f4ade85 ($6.17 in chips)
Seat 5: 3dd958bc ($5 in chips)
Seat 6: Hero ($17.38 in chips)
45eea39e: posts small blind $0.02
d92261bd: posts big blind $0.05
*** HOLE CARDS ***
Dealt to fad7a12d 
Dealt to 45eea39e 
Dealt to d92261bd 
Dealt to f4ade85 
Dealt to 3dd958bc 
Dealt to Hero [2s Ah]
f4ade85: folds
3dd958bc: raises $0.06 to $0.11
Hero: folds
fad7a12d: folds
45eea39e: folds
d92261bd: folds
Uncalled bet ($0.06) returned to 3dd958bc
*** SHOWDOWN ***
3dd958bc collected $0.12 from pot
*** SUMMARY ***
Total pot $0.12 | Rake $0 | Jackpot $0 | Bingo $0 | Fortune $0 | Tax $0
Seat 1: fad7a12d (button) folded before Flop (didn't bet)
Seat 2: 45eea39e (small blind) folded before Flop
Seat 3: d92261bd (big blind) folded before Flop
Seat 4: f4ade85 folded before Flop (didn't bet)
Seat 5: 3dd958bc collected ($0.12)
Seat 6: Hero folded before Flop (didn't bet)


Poker Hand #RC3811227057: Hold'em No Limit ($0.02/$0.05) - 2025/08/16 13:13:03
Table 'RushAndCash852317' 6-max Seat #1 is the button
Seat 1: c9cb0857 ($4.79 in chips)
Seat 2: 62d20b3c ($6.75 in chips)
Seat 3: 930ad1ac ($5.03 in chips)
Seat 4: 3dd958bc ($5 in chips)
Seat 5: 3005d008 ($5 in chips)
Seat 6: Hero ($17.38 in chips)
62d20b3c: posts small blind $0.02
930ad1ac: posts big blind $0.05
*** HOLE CARDS ***
Dealt to c9cb0857 
Dealt to 62d20b3c 
Dealt to 930ad1ac 
Dealt to 3dd958bc 
Dealt to 3005d008 
Dealt to Hero [Js 8c]
3dd958bc: folds
3005d008: raises $0.1 to $0.15
Hero: folds
c9cb0857: folds
62d20b3c: folds
930ad1ac: folds
Uncalled bet ($0.1) returned to 3005d008
*** SHOWDOWN ***
3005d008 collected $0.12 from pot
*** SUMMARY ***
Total pot $0.12 | Rake $0 | Jackpot $0 | Bingo $0 | Fortune $0 | Tax $0
Seat 1: c9cb0857 (button) folded before Flop (didn't bet)
Seat 2: 62d20b3c (small blind) folded before Flop
Seat 3: 930ad1ac (big blind) folded before Flop
Seat 4: 3dd958bc folded before Flop (didn't bet)
Seat 5: 3005d008 collected ($0.12)
Seat 6: Hero folded before Flop (didn't bet)


Poker Hand #RC3811227041: Hold'em No Limit ($0.02/$0.05) - 2025/08/16 13:12:59
Table 'RushAndCash852301' 6-max Seat #1 is the button
Seat 1: cce07217 ($5 in chips)
Seat 2: 52635f99 ($5.02 in chips)
Seat 3: e88b4b2 ($6 in chips)
Seat 4: ae4775f8 ($5.75 in chips)
Seat 5: Hero ($17.38 in chips)
Seat 6: 4de4032 ($5.16 in chips)
52635f99: posts small blind $0.02
e88b4b2: posts big blind $0.05
*** HOLE CARDS ***
Dealt to cce07217 
Dealt to 52635f99 
Dealt to e88b4b2 
Dealt to ae4775f8 
Dealt to Hero [9h Qs]
Dealt to 4de4032 
ae4775f8: folds
Hero: folds
4de4032: folds
cce07217: folds
52635f99: folds
Uncalled bet ($0.03) returned to e88b4b2
*** SHOWDOWN ***
e88b4b2 collected $0.04 from pot
*** SUMMARY ***
Total pot $0.04 | Rake $0 | Jackpot $0 | Bingo $0 | Fortune $0 | Tax $0
Seat 1: cce07217 (button) folded before Flop (didn't bet)
Seat 2: 52635f99 (small blind) folded before Flop
Seat 3: e88b4b2 (big blind) collected ($0.04)
Seat 4: ae4775f8 folded before Flop (didn't bet)
Seat 5: Hero folded before Flop (didn't bet)
Seat 6: 4de4032 folded before Flop (didn't bet)


Poker Hand #RC3811227025: Hold'em No Limit ($0.02/$0.05) - 2025/08/16 13:12:55
Table 'RushAndCash852285' 6-max Seat #1 is the button
Seat 1: 1c212b17 ($5.07 in chips)
Seat 2: Hero ($17.4 in chips)
Seat 3: f4ade85 ($6.22 in chips)
Seat 4: 14d9c001 ($6.67 in chips)
Seat 5: 154c971f ($6.11 in chips)
Seat 6: b3952c8b ($14.73 in chips)
Hero: posts small blind $0.02
f4ade85: posts big blind $0.05
*** HOLE CARDS ***
Dealt to 1c212b17 
Dealt to Hero [Qh 5d]
Dealt to f4ade85 
Dealt to 14d9c001 
Dealt to 154c971f 
Dealt to b3952c8b 
14d9c001: folds
154c971f: folds
b3952c8b: folds
1c212b17: raises $0.05 to $0.1
Hero: folds
f4ade85: folds
Uncalled bet ($0.05) returned to 1c212b17
*** SHOWDOWN ***
1c212b17 collected $0.12 from pot
*** SUMMARY ***
Total pot $0.12 | Rake $0 | Jackpot $0 | Bingo $0 | Fortune $0 | Tax $0
Seat 1: 1c212b17 (button) collected ($0.12)
Seat 2: Hero (small blind) folded before Flop
Seat 3: f4ade85 (big blind) folded before Flop
Seat 4: 14d9c001 folded before Flop (didn't bet)
Seat 5: 154c971f folded before Flop (didn't bet)
Seat 6: b3952c8b folded before Flop (didn't bet)


Poker Hand #RC3811227011: Hold'em No Limit ($0.02/$0.05) - 2025/08/16 13:12:52
Table 'RushAndCash852271' 6-max Seat #1 is the button
Seat 1: fc90aecc ($5.07 in chips)
Seat 2: 4e531498 ($5.44 in chips)
Seat 3: bc6d3eb5 ($5 in chips)
Seat 4: Hero ($17.4 in chips)
Seat 5: be02a95d ($12.25 in chips)
Seat 6: 14d9c001 ($6.67 in chips)
4e531498: posts small blind $0.02
bc6d3eb5: posts big blind $0.05
*** HOLE CARDS ***
Dealt to fc90aecc 
Dealt to 4e531498 
Dealt to bc6d3eb5 
Dealt to Hero [Jc 6s]
Dealt to be02a95d 
Dealt to 14d9c001 
Hero: folds
be02a95d: raises $0.05 to $0.1
14d9c001: folds
fc90aecc: folds
4e531498: folds
bc6d3eb5: folds
Uncalled bet ($0.05) returned to be02a95d
*** SHOWDOWN ***
be02a95d collected $0.12 from pot
*** SUMMARY ***
Total pot $0.12 | Rake $0 | Jackpot $0 | Bingo $0 | Fortune $0 | Tax $0
Seat 1: fc90aecc (button) folded before Flop (didn't bet)
Seat 2: 4e531498 (small blind) folded before Flop
Seat 3: bc6d3eb5 (big blind) folded before Flop
Seat 4: Hero folded before Flop (didn't bet)
Seat 5: be02a95d collected ($0.12)
Seat 6: 14d9c001 folded before Flop (didn't bet)


Poker Hand #RC3811226952: Hold'em No Limit ($0.02/$0.05) - 2025/08/16 13:12:36
Table 'RushAndCash852212' 6-max Seat #1 is the button
Seat 1: ef779654 ($8.23 in chips)
Seat 2: 7bf33a65 ($16.91 in chips)
Seat 3: Hero ($17.45 in chips)
Seat 4: 1613b352 ($11.15 in chips)
Seat 5: 1c212b17 ($5 in chips)
Seat 6: 8ebaac0c ($5.21 in chips)
7bf33a65: posts small blind $0.02
Hero: posts big blind $0.05
*** HOLE CARDS ***
Dealt to ef779654 
Dealt to 7bf33a65 
Dealt to Hero [4c Th]
Dealt to 1613b352 
Dealt to 1c212b17 
Dealt to 8ebaac0c 
1613b352: folds
1c212b17: raises $0.05 to $0.1
8ebaac0c: folds
ef779654: folds
7bf33a65: folds
Hero: folds
Uncalled bet ($0.05) returned to 1c212b17
*** SHOWDOWN ***
1c212b17 collected $0.12 from pot
*** SUMMARY ***
Total pot $0.12 | Rake $0 | Jackpot $0 | Bingo $0 | Fortune $0 | Tax $0
Seat 1: ef779654 (button) folded before Flop (didn't bet)
Seat 2: 7bf33a65 (small blind) folded before Flop
Seat 3: Hero (big blind) folded before Flop
Seat 4: 1613b352 folded before Flop (didn't bet)
Seat 5: 1c212b17 collected ($0.12)
Seat 6: 8ebaac0c folded before Flop (didn't bet)


Poker Hand #RC3811226937: Hold'em No Limit ($0.02/$0.05) - 2025/08/16 13:12:32
Table 'RushAndCash852197' 6-max Seat #1 is the button
Seat 1: Hero ($17.45 in chips)
Seat 2: 426bc648 ($4.27 in chips)
Seat 3: 4cf212ec ($5.09 in chips)
Seat 4: 4e531498 ($5.49 in chips)
Seat 5: 9b7ef7b0 ($5.33 in chips)
Seat 6: 917f3e19 ($6.11 in chips)
426bc648: posts small blind $0.02
4cf212ec: posts big blind $0.05
*** HOLE CARDS ***
Dealt to Hero [4h Td]
Dealt to 426bc648 
Dealt to 4cf212ec 
Dealt to 4e531498 
Dealt to 9b7ef7b0 
Dealt to 917f3e19 
4e531498: folds
9b7ef7b0: folds
917f3e19: folds
Hero: folds
426bc648: raises $0.08 to $0.13
4cf212ec: folds
Uncalled bet ($0.08) returned to 426bc648
*** SHOWDOWN ***
426bc648 collected $0.1 from pot
*** SUMMARY ***
Total pot $0.1 | Rake $0 | Jackpot $0 | Bingo $0 | Fortune $0 | Tax $0
Seat 1: Hero (button) folded before Flop (didn't bet)
Seat 2: 426bc648 (small blind) collected ($0.1)
Seat 3: 4cf212ec (big blind) folded before Flop
Seat 4: 4e531498 folded before Flop (didn't bet)
Seat 5: 9b7ef7b0 folded before Flop (didn't bet)
Seat 6: 917f3e19 folded before Flop (didn't bet)


Poker Hand #RC3811226918: Hold'em No Limit ($0.02/$0.05) - 2025/08/16 13:12:27
Table 'RushAndCash852178' 6-max Seat #1 is the button
Seat 1: 8b3d6303 ($8.9 in chips)
Seat 2: Hero ($17.47 in chips)
Seat 3: 997a157f ($15.59 in chips)
Seat 4: af718e4b ($27.14 in chips)
Seat 5: 228a7ffe ($11.77 in chips)
Seat 6: e93099b5 ($7 in chips)
Hero: posts small blind $0.02
997a157f: posts big blind $0.05
*** HOLE CARDS ***
Dealt to 8b3d6303 
Dealt to Hero [4s Jd]
Dealt to 997a157f 
Dealt to af718e4b 
Dealt to 228a7ffe 
Dealt to e93099b5 
af718e4b: folds
228a7ffe: folds
e93099b5: folds
8b3d6303: folds
Hero: folds
Uncalled bet ($0.03) returned to 997a157f
*** SHOWDOWN ***
997a157f collected $0.04 from pot
*** SUMMARY ***
Total pot $0.04 | Rake $0 | Jackpot $0 | Bingo $0 | Fortune $0 | Tax $0
Seat 1: 8b3d6303 (button) folded before Flop (didn't bet)
Seat 2: Hero (small blind) folded before Flop
Seat 3: 997a157f (big blind) collected ($0.04)
Seat 4: af718e4b folded before Flop (didn't bet)
Seat 5: 228a7ffe folded before Flop (didn't bet)
Seat 6: e93099b5 folded before Flop (didn't bet)


Poker Hand #RC3811226903: Hold'em No Limit ($0.02/$0.05) - 2025/08/16 13:12:24
Table 'RushAndCash852163' 6-max Seat #1 is the button
Seat 1: 6e690d04 ($4.92 in chips)
Seat 2: e58b9f8d ($5.22 in chips)
Seat 3: 1a55751a ($5.97 in chips)
Seat 4: Hero ($17.47 in chips)
Seat 5: ff701667 ($5 in chips)
Seat 6: b57e9625 ($5.56 in chips)
e58b9f8d: posts small blind $0.02
1a55751a: posts big blind $0.05
*** HOLE CARDS ***
Dealt to 6e690d04 
Dealt to e58b9f8d 
Dealt to 1a55751a 
Dealt to Hero [3h Tc]
Dealt to ff701667 
Dealt to b57e9625 
Hero: folds
ff701667: folds
b57e9625: folds
6e690d04: raises $0.07 to $0.12
e58b9f8d: folds
1a55751a: folds
Uncalled bet ($0.07) returned to 6e690d04
*** SHOWDOWN ***
6e690d04 collected $0.12 from pot
*** SUMMARY ***
Total pot $0.12 | Rake $0 | Jackpot $0 | Bingo $0 | Fortune $0 | Tax $0
Seat 1: 6e690d04 (button) collected ($0.12)
Seat 2: e58b9f8d (small blind) folded before Flop
Seat 3: 1a55751a (big blind) folded before Flop
Seat 4: Hero folded before Flop (didn't bet)
Seat 5: ff701667 folded before Flop (didn't bet)
Seat 6: b57e9625 folded before Flop (didn't bet)


Poker Hand #RC3811226850: Hold'em No Limit ($0.02/$0.05) - 2025/08/16 13:12:11
Table 'RushAndCash852110' 6-max Seat #1 is the button
Seat 1: 4de4032 ($5.14 in chips)
Seat 2: 8c9e3686 ($7.58 in chips)
Seat 3: Hero ($17.52 in chips)
Seat 4: 37c2e948 ($15.82 in chips)
Seat 5: 1b2883cb ($5.08 in chips)
Seat 6: ee7d25e9 ($5.62 in chips)
8c9e3686: posts small blind $0.02
Hero: posts big blind $0.05
*** HOLE CARDS ***
Dealt to 4de4032 
Dealt to 8c9e3686 
Dealt to Hero [8d 4d]
Dealt to 37c2e948 
Dealt to 1b2883cb 
Dealt to ee7d25e9 
37c2e948: folds
1b2883cb: folds
ee7d25e9: raises $0.05 to $0.1
4de4032: folds
8c9e3686: folds
Hero: folds
Uncalled bet ($0.05) returned to ee7d25e9
*** SHOWDOWN ***
ee7d25e9 collected $0.12 from pot
*** SUMMARY ***
Total pot $0.12 | Rake $0 | Jackpot $0 | Bingo $0 | Fortune $0 | Tax $0
Seat 1: 4de4032 (button) folded before Flop (didn't bet)
Seat 2: 8c9e3686 (small blind) folded before Flop
Seat 3: Hero (big blind) folded before Flop
Seat 4: 37c2e948 folded before Flop (didn't bet)
Seat 5: 1b2883cb folded before Flop (didn't bet)
Seat 6: ee7d25e9 collected ($0.12)


Poker Hand #RC3811226759: Hold'em No Limit ($0.02/$0.05) - 2025/08/16 13:11:49
Table 'RushAndCash852019' 6-max Seat #1 is the button
Seat 1: Hero ($17.45 in chips)
Seat 2: b03180a0 ($2.45 in chips)
Seat 3: b75c44b9 ($15.78 in chips)
Seat 4: dce7f224 ($21 in chips)
Seat 5: d3d73990 ($6.54 in chips)
Seat 6: 41ef1226 ($5.33 in chips)
b03180a0: posts small blind $0.02
b75c44b9: posts big blind $0.05
*** HOLE CARDS ***
Dealt to Hero [Ks Ts]
Dealt to b03180a0 
Dealt to b75c44b9 
Dealt to dce7f224 
Dealt to d3d73990 
Dealt to 41ef1226 
dce7f224: folds
d3d73990: folds
41ef1226: folds
Hero: raises $0.1 to $0.15
b03180a0: folds
b75c44b9: folds
Uncalled bet ($0.1) returned to Hero
*** SHOWDOWN ***
Hero collected $0.12 from pot
*** SUMMARY ***
Total pot $0.12 | Rake $0 | Jackpot $0 | Bingo $0 | Fortune $0 | Tax $0
Seat 1: Hero (button) collected ($0.12)
Seat 2: b03180a0 (small blind) folded before Flop
Seat 3: b75c44b9 (big blind) folded before Flop
Seat 4: dce7f224 folded before Flop (didn't bet)
Seat 5: d3d73990 folded before Flop (didn't bet)
Seat 6: 41ef1226 folded before Flop (didn't bet)


Poker Hand #RC3811226739: Hold'em No Limit ($0.02/$0.05) - 2025/08/16 13:11:45
Table 'RushAndCash851999' 6-max Seat #1 is the button
Seat 1: 7bef0a2e ($2.11 in chips)
Seat 2: 3bf5227a ($2.02 in chips)
Seat 3: fad7a12d ($6.8 in chips)
Seat 4: dda95519 ($7.39 in chips)
Seat 5: b85fea1 ($5.09 in chips)
Seat 6: Hero ($17.45 in chips)
3bf5227a: posts small blind $0.02
fad7a12d: posts big blind $0.05
*** HOLE CARDS ***
Dealt to 7bef0a2e 
Dealt to 3bf5227a 
Dealt to fad7a12d 
Dealt to dda95519 
Dealt to b85fea1 
Dealt to Hero [5s 7s]
dda95519: folds
b85fea1: raises $0.05 to $0.1
Hero: folds
7bef0a2e: folds
3bf5227a: folds
fad7a12d: folds
Uncalled bet ($0.05) returned to b85fea1
*** SHOWDOWN ***
b85fea1 collected $0.12 from pot
*** SUMMARY ***
Total pot $0.12 | Rake $0 | Jackpot $0 | Bingo $0 | Fortune $0 | Tax $0
Seat 1: 7bef0a2e (button) folded before Flop (didn't bet)
Seat 2: 3bf5227a (small blind) folded before Flop
Seat 3: fad7a12d (big blind) folded before Flop
Seat 4: dda95519 folded before Flop (didn't bet)
Seat 5: b85fea1 collected ($0.12)
Seat 6: Hero folded before Flop (didn't bet)


Poker Hand #RC3811184707: Hold'em No Limit ($0.02/$0.05) - 2025/08/16 13:02:59
Table 'RushAndCash849967' 6-max Seat #1 is the button
Seat 1: e88b4b2 ($5.96 in chips)
Seat 2: Hero ($17.55 in chips)
Seat 3: 56099b06 ($2.68 in chips)
Seat 4: be4fec29 ($12.73 in chips)
Seat 5: 17f8f0d4 ($5.29 in chips)
Seat 6: 9b7ef7b0 ($6.61 in chips)
Hero: posts small blind $0.02
56099b06: posts big blind $0.05
*** HOLE CARDS ***
Dealt to e88b4b2 
Dealt to Hero [Jd Ts]
Dealt to 56099b06 
Dealt to be4fec29 
Dealt to 17f8f0d4 
Dealt to 9b7ef7b0 
be4fec29: folds
17f8f0d4: folds
9b7ef7b0: folds
e88b4b2: folds
Hero: raises $0.05 to $0.1
56099b06: raises $0.2 to $0.3
Hero: folds
Uncalled bet ($0.2) returned to 56099b06
*** SHOWDOWN ***
56099b06 collected $0.19 from pot
*** SUMMARY ***
Total pot $0.2 | Rake $0.01 | Jackpot $0 | Bingo $0 | Fortune $0 | Tax $0
Seat 1: e88b4b2 (button) folded before Flop (didn't bet)
Seat 2: Hero (small blind) folded before Flop
Seat 3: 56099b06 (big blind) collected ($0.19)
Seat 4: be4fec29 folded before Flop (didn't bet)
Seat 5: 17f8f0d4 folded before Flop (didn't bet)
Seat 6: 9b7ef7b0 folded before Flop (didn't bet)


Poker Hand #RC3811184690: Hold'em No Limit ($0.02/$0.05) - 2025/08/16 13:02:54
Table 'RushAndCash849950' 6-max Seat #1 is the button
Seat 1: cf40af3 ($5.22 in chips)
Seat 2: aaca094a ($5.02 in chips)
Seat 3: e93099b5 ($7.26 in chips)
Seat 4: Hero ($17.55 in chips)
Seat 5: f1e6db21 ($7.35 in chips)
Seat 6: 1b0eb398 ($6.83 in chips)
aaca094a: posts small blind $0.02
e93099b5: posts big blind $0.05
*** HOLE CARDS ***
Dealt to cf40af3 
Dealt to aaca094a 
Dealt to e93099b5 
Dealt to Hero [As 8s]
Dealt to f1e6db21 
Dealt to 1b0eb398 
Hero: folds
f1e6db21: folds
1b0eb398: folds
cf40af3: folds
aaca094a: folds
Uncalled bet ($0.03) returned to e93099b5
*** SHOWDOWN ***
e93099b5 collected $0.04 from pot
*** SUMMARY ***
Total pot $0.04 | Rake $0 | Jackpot $0 | Bingo $0 | Fortune $0 | Tax $0
Seat 1: cf40af3 (button) folded before Flop (didn't bet)
Seat 2: aaca094a (small blind) folded before Flop
Seat 3: e93099b5 (big blind) collected ($0.04)
Seat 4: Hero folded before Flop (didn't bet)
Seat 5: f1e6db21 folded before Flop (didn't bet)
Seat 6: 1b0eb398 folded before Flop (didn't bet)


Poker Hand #RC3811184676: Hold'em No Limit ($0.02/$0.05) - 2025/08/16 13:02:51
Table 'RushAndCash849936' 6-max Seat #1 is the button
Seat 1: ec1be3f5 ($5.07 in chips)
Seat 2: 51e78bf7 ($3.46 in chips)
Seat 3: 1e25c9d8 ($6.59 in chips)
Seat 4: 8b979e5a ($5 in chips)
Seat 5: 5340c595 ($18.39 in chips)
Seat 6: Hero ($17.55 in chips)
51e78bf7: posts small blind $0.02
1e25c9d8: posts big blind $0.05
*** HOLE CARDS ***
Dealt to ec1be3f5 
Dealt to 51e78bf7 
Dealt to 1e25c9d8 
Dealt to 8b979e5a 
Dealt to 5340c595 
Dealt to Hero [9d 2h]
8b979e5a: raises $0.07 to $0.12
5340c595: folds
Hero: folds
ec1be3f5: folds
51e78bf7: folds
1e25c9d8: folds
Uncalled bet ($0.07) returned to 8b979e5a
*** SHOWDOWN ***
8b979e5a collected $0.12 from pot
*** SUMMARY ***
Total pot $0.12 | Rake $0 | Jackpot $0 | Bingo $0 | Fortune $0 | Tax $0
Seat 1: ec1be3f5 (button) folded before Flop (didn't bet)
Seat 2: 51e78bf7 (small blind) folded before Flop
Seat 3: 1e25c9d8 (big blind) folded before Flop
Seat 4: 8b979e5a collected ($0.12)
Seat 5: 5340c595 folded before Flop (didn't bet)
Seat 6: Hero folded before Flop (didn't bet)


Poker Hand #RC3811184330: Hold'em No Limit ($0.02/$0.05) - 2025/08/16 13:01:17
Table 'RushAndCash849590' 6-max Seat #1 is the button
Seat 1: 51e78bf7 ($4.98 in chips)
Seat 2: d843a727 ($5.36 in chips)
Seat 3: Hero ($16.16 in chips)
Seat 4: ca2bb0fc ($6.3 in chips)
Seat 5: bb649669 ($7.97 in chips)
Seat 6: 343e61a8 ($10.39 in chips)
d843a727: posts small blind $0.02
Hero: posts big blind $0.05
*** HOLE CARDS ***
Dealt to 51e78bf7 
Dealt to d843a727 
Dealt to Hero [8h 8c]
Dealt to ca2bb0fc 
Dealt to bb649669 
Dealt to 343e61a8 
ca2bb0fc: folds
bb649669: folds
343e61a8: folds
51e78bf7: raises $0.06 to $0.11
d843a727: folds
Hero: calls $0.06
*** FLOP *** [Ac 9c 8d]
Hero: checks
51e78bf7: bets $0.18
Hero: raises $0.4 to $0.58
51e78bf7: calls $0.4
*** TURN *** [Ac 9c 8d] [6s]
Hero: checks
51e78bf7: bets $0.9
Hero: raises $3.78 to $4.68
51e78bf7: folds
Uncalled bet ($3.78) returned to Hero
*** SHOWDOWN ***
Hero collected $2.98 from pot
*** SUMMARY ***
Total pot $3.2 | Rake $0.15 | Jackpot $0.07 | Bingo $0 | Fortune $0 | Tax $0
Board [Ac 9c 8d 6s]
Seat 1: 51e78bf7 (button) folded on the Turn
Seat 2: d843a727 (small blind) folded before Flop
Seat 3: Hero (big blind) won ($2.98)
Seat 4: ca2bb0fc folded before Flop (didn't bet)
Seat 5: bb649669 folded before Flop (didn't bet)
Seat 6: 343e61a8 folded before Flop (didn't bet)


Poker Hand #RC3811184317: Hold'em No Limit ($0.02/$0.05) - 2025/08/16 13:01:14
Table 'RushAndCash849577' 6-max Seat #1 is the button
Seat 1: 21582d9 ($5.08 in chips)
Seat 2: 9dcd69d5 ($11.57 in chips)
Seat 3: 6b0663c4 ($5.07 in chips)
Seat 4: dea14c7d ($5 in chips)
Seat 5: 2938d11a ($10.02 in chips)
Seat 6: Hero ($16.16 in chips)
9dcd69d5: posts small blind $0.02
6b0663c4: posts big blind $0.05
*** HOLE CARDS ***
Dealt to 21582d9 
Dealt to 9dcd69d5 
Dealt to 6b0663c4 
Dealt to dea14c7d 
Dealt to 2938d11a 
Dealt to Hero [8h Ts]
dea14c7d: raises $0.08 to $0.13
2938d11a: folds
Hero: folds
21582d9: folds
9dcd69d5: folds
6b0663c4: folds
Uncalled bet ($0.08) returned to dea14c7d
*** SHOWDOWN ***
dea14c7d collected $0.12 from pot
*** SUMMARY ***
Total pot $0.12 | Rake $0 | Jackpot $0 | Bingo $0 | Fortune $0 | Tax $0
Seat 1: 21582d9 (button) folded before Flop (didn't bet)
Seat 2: 9dcd69d5 (small blind) folded before Flop
Seat 3: 6b0663c4 (big blind) folded before Flop
Seat 4: dea14c7d collected ($0.12)
Seat 5: 2938d11a folded before Flop (didn't bet)
Seat 6: Hero folded before Flop (didn't bet)


Poker Hand #RC3811184280: Hold'em No Limit ($0.02/$0.05) - 2025/08/16 13:01:03
Table 'RushAndCash849540' 6-max Seat #1 is the button
Seat 1: Hero ($16.16 in chips)
Seat 2: b094641b ($5.16 in chips)
Seat 3: 6c09830e ($5.28 in chips)
Seat 4: 38964e39 ($1.96 in chips)
Seat 5: 8b3d6303 ($8.53 in chips)
Seat 6: a178a7ae ($3.68 in chips)
b094641b: posts small blind $0.02
6c09830e: posts big blind $0.05
*** HOLE CARDS ***
Dealt to Hero [4c 2s]
Dealt to b094641b 
Dealt to 6c09830e 
Dealt to 38964e39 
Dealt to 8b3d6303 
Dealt to a178a7ae 
38964e39: folds
8b3d6303: raises $0.08 to $0.13
a178a7ae: folds
Hero: folds
b094641b: folds
6c09830e: folds
Uncalled bet ($0.08) returned to 8b3d6303
*** SHOWDOWN ***
8b3d6303 collected $0.12 from pot
*** SUMMARY ***
Total pot $0.12 | Rake $0 | Jackpot $0 | Bingo $0 | Fortune $0 | Tax $0
Seat 1: Hero (button) folded before Flop (didn't bet)
Seat 2: b094641b (small blind) folded before Flop
Seat 3: 6c09830e (big blind) folded before Flop
Seat 4: 38964e39 folded before Flop (didn't bet)
Seat 5: 8b3d6303 collected ($0.12)
Seat 6: a178a7ae folded before Flop (didn't bet)


Poker Hand #RC3811184268: Hold'em No Limit ($0.02/$0.05) - 2025/08/16 13:00:59
Table 'RushAndCash849528' 6-max Seat #1 is the button
Seat 1: d843a727 ($5.34 in chips)
Seat 2: 56099b06 ($2.5 in chips)
Seat 3: d39a7ce4 ($6.06 in chips)
Seat 4: fb990610 ($12.78 in chips)
Seat 5: 36ce12e3 ($5.85 in chips)
Seat 6: Hero ($16.16 in chips)
56099b06: posts small blind $0.02
d39a7ce4: posts big blind $0.05
*** HOLE CARDS ***
Dealt to d843a727 
Dealt to 56099b06 
Dealt to d39a7ce4 
Dealt to fb990610 
Dealt to 36ce12e3 
Dealt to Hero [Ks 7h]
fb990610: folds
36ce12e3: folds
Hero: folds
d843a727: raises $0.1 to $0.15
56099b06: folds
d39a7ce4: folds
Uncalled bet ($0.1) returned to d843a727
*** SHOWDOWN ***
d843a727 collected $0.12 from pot
*** SUMMARY ***
Total pot $0.12 | Rake $0 | Jackpot $0 | Bingo $0 | Fortune $0 | Tax $0
Seat 1: d843a727 (button) collected ($0.12)
Seat 2: 56099b06 (small blind) folded before Flop
Seat 3: d39a7ce4 (big blind) folded before Flop
Seat 4: fb990610 folded before Flop (didn't bet)
Seat 5: 36ce12e3 folded before Flop (didn't bet)
Seat 6: Hero folded before Flop (didn't bet)


Poker Hand #RC3811184215: Hold'em No Limit ($0.02/$0.05) - 2025/08/16 13:00:45
Table 'RushAndCash849475' 6-max Seat #1 is the button
Seat 1: Hero ($16.16 in chips)
Seat 2: ad373012 ($7.28 in chips)
Seat 3: effb5b5e ($5.41 in chips)
Seat 4: 645b9541 ($5.97 in chips)
Seat 5: 154c971f ($3.75 in chips)
Seat 6: ae25512b ($4.64 in chips)
ad373012: posts small blind $0.02
effb5b5e: posts big blind $0.05
*** HOLE CARDS ***
Dealt to Hero [8h 4s]
Dealt to ad373012 
Dealt to effb5b5e 
Dealt to 645b9541 
Dealt to 154c971f 
Dealt to ae25512b 
645b9541: folds
154c971f: raises $0.05 to $0.1
ae25512b: folds
Hero: folds
ad373012: folds
effb5b5e: calls $0.05
*** FLOP *** [Jd 7s 9d]
effb5b5e: checks
154c971f: bets $0.17
effb5b5e: calls $0.17
*** TURN *** [Jd 7s 9d] [5d]
effb5b5e: checks
154c971f: checks
*** RIVER *** [Jd 7s 9d 5d] [7c]
effb5b5e: checks
154c971f: checks
effb5b5e: shows [As 9s] (two pair, Nines and Sevens)
154c971f: shows [Js Ts] (two pair, Jacks and Sevens)
*** SHOWDOWN ***
154c971f collected $0.54 from pot
*** SUMMARY ***
Total pot $0.56 | Rake $0.02 | Jackpot $0 | Bingo $0 | Fortune $0 | Tax $0
Board [Jd 7s 9d 5d 7c]
Seat 1: Hero (button) folded before Flop (didn't bet)
Seat 2: ad373012 (small blind) folded before Flop
Seat 3: effb5b5e (big blind) showed [As 9s] and lost with two pair, Nines and Sevens
Seat 4: 645b9541 folded before Flop (didn't bet)
Seat 5: 154c971f showed [Js Ts] and won ($0.54) with two pair, Jacks and Sevens
Seat 6: ae25512b folded before Flop (didn't bet)


Poker Hand #RC3811184187: Hold'em No Limit ($0.02/$0.05) - 2025/08/16 13:00:38
Table 'RushAndCash849447' 6-max Seat #1 is the button
Seat 1: e88b4b2 ($6.35 in chips)
Seat 2: 4e37785d ($5.2 in chips)
Seat 3: Hero ($16.21 in chips)
Seat 4: 17d1d965 ($6.02 in chips)
Seat 5: 372c0091 ($1.66 in chips)
Seat 6: 319f9ef4 ($10.24 in chips)
4e37785d: posts small blind $0.02
Hero: posts big blind $0.05
*** HOLE CARDS ***
Dealt to e88b4b2 
Dealt to 4e37785d 
Dealt to Hero [7h 2c]
Dealt to 17d1d965 
Dealt to 372c0091 
Dealt to 319f9ef4 
17d1d965: folds
372c0091: folds
319f9ef4: folds
e88b4b2: folds
4e37785d: raises $0.1 to $0.15
Hero: folds
Uncalled bet ($0.1) returned to 4e37785d
*** SHOWDOWN ***
4e37785d collected $0.1 from pot
*** SUMMARY ***
Total pot $0.1 | Rake $0 | Jackpot $0 | Bingo $0 | Fortune $0 | Tax $0
Seat 1: e88b4b2 (button) folded before Flop (didn't bet)
Seat 2: 4e37785d (small blind) collected ($0.1)
Seat 3: Hero (big blind) folded before Flop
Seat 4: 17d1d965 folded before Flop (didn't bet)
Seat 5: 372c0091 folded before Flop (didn't bet)
Seat 6: 319f9ef4 folded before Flop (didn't bet)


Poker Hand #RC3811184173: Hold'em No Limit ($0.02/$0.05) - 2025/08/16 13:00:34
Table 'RushAndCash849433' 6-max Seat #1 is the button
Seat 1: 667947dd ($5.65 in chips)
Seat 2: e8f2f382 ($5.2 in chips)
Seat 3: 28989ffe ($5.95 in chips)
Seat 4: 319f9ef4 ($10.24 in chips)
Seat 5: e7cb69c2 ($6.89 in chips)
Seat 6: Hero ($16.21 in chips)
e8f2f382: posts small blind $0.02
28989ffe: posts big blind $0.05
*** HOLE CARDS ***
Dealt to 667947dd 
Dealt to e8f2f382 
Dealt to 28989ffe 
Dealt to 319f9ef4 
Dealt to e7cb69c2 
Dealt to Hero [3s Ad]
319f9ef4: folds
e7cb69c2: folds
Hero: folds
667947dd: raises $0.08 to $0.13
e8f2f382: folds
28989ffe: calls $0.08
*** FLOP *** [6s 6c Jc]
28989ffe: checks
667947dd: bets $0.14
28989ffe: raises $0.33 to $0.47
667947dd: calls $0.33
*** TURN *** [6s 6c Jc] [3h]
28989ffe: bets $0.66
667947dd: folds
Uncalled bet ($0.66) returned to 28989ffe
*** SHOWDOWN ***
28989ffe collected $1.16 from pot
*** SUMMARY ***
Total pot $1.22 | Rake $0.06 | Jackpot $0 | Bingo $0 | Fortune $0 | Tax $0
Board [6s 6c Jc 3h]
Seat 1: 667947dd (button) folded on the Turn
Seat 2: e8f2f382 (small blind) folded before Flop
Seat 3: 28989ffe (big blind) won ($1.16)
Seat 4: 319f9ef4 folded before Flop (didn't bet)
Seat 5: e7cb69c2 folded before Flop (didn't bet)
Seat 6: Hero folded before Flop (didn't bet)


Poker Hand #RC3811184109: Hold'em No Limit ($0.02/$0.05) - 2025/08/16 13:00:16
Table 'RushAndCash849369' 6-max Seat #1 is the button
Seat 1: 62d20b3c ($5.43 in chips)
Seat 2: Hero ($16.23 in chips)
Seat 3: 53c5596b ($5.65 in chips)
Seat 4: b094641b ($5.07 in chips)
Seat 5: df91ffd8 ($7.88 in chips)
Seat 6: 272dc8b4 ($5 in chips)
Hero: posts small blind $0.02
53c5596b: posts big blind $0.05
*** HOLE CARDS ***
Dealt to 62d20b3c 
Dealt to Hero [5h Jc]
Dealt to 53c5596b 
Dealt to b094641b 
Dealt to df91ffd8 
Dealt to 272dc8b4 
b094641b: raises $0.08 to $0.13
df91ffd8: folds
272dc8b4: folds
62d20b3c: folds
Hero: folds
53c5596b: folds
Uncalled bet ($0.08) returned to b094641b
*** SHOWDOWN ***
b094641b collected $0.12 from pot
*** SUMMARY ***
Total pot $0.12 | Rake $0 | Jackpot $0 | Bingo $0 | Fortune $0 | Tax $0
Seat 1: 62d20b3c (button) folded before Flop (didn't bet)
Seat 2: Hero (small blind) folded before Flop
Seat 3: 53c5596b (big blind) folded before Flop
Seat 4: b094641b collected ($0.12)
Seat 5: df91ffd8 folded before Flop (didn't bet)
Seat 6: 272dc8b4 folded before Flop (didn't bet)


Poker Hand #RC3811184098: Hold'em No Limit ($0.02/$0.05) - 2025/08/16 13:00:12
Table 'RushAndCash849358' 6-max Seat #1 is the button
Seat 1: 721d5285 ($13.86 in chips)
Seat 2: a61563b7 ($5.61 in chips)
Seat 3: 60d6e9f3 ($4.76 in chips)
Seat 4: Hero ($16.23 in chips)
Seat 5: cf00cabc ($3.96 in chips)
Seat 6: 53c5596b ($5.65 in chips)
a61563b7: posts small blind $0.02
60d6e9f3: posts big blind $0.05
*** HOLE CARDS ***
Dealt to 721d5285 
Dealt to a61563b7 
Dealt to 60d6e9f3 
Dealt to Hero [7h 5d]
Dealt to cf00cabc 
Dealt to 53c5596b 
Hero: folds
cf00cabc: folds
53c5596b: folds
721d5285: folds
a61563b7: raises $0.1 to $0.15
60d6e9f3: folds
Uncalled bet ($0.1) returned to a61563b7
*** SHOWDOWN ***
a61563b7 collected $0.1 from pot
*** SUMMARY ***
Total pot $0.1 | Rake $0 | Jackpot $0 | Bingo $0 | Fortune $0 | Tax $0
Seat 1: 721d5285 (button) folded before Flop (didn't bet)
Seat 2: a61563b7 (small blind) collected ($0.1)
Seat 3: 60d6e9f3 (big blind) folded before Flop
Seat 4: Hero folded before Flop (didn't bet)
Seat 5: cf00cabc folded before Flop (didn't bet)
Seat 6: 53c5596b folded before Flop (didn't bet)


Poker Hand #RC3811184081: Hold'em No Limit ($0.02/$0.05) - 2025/08/16 13:00:07
Table 'RushAndCash849341' 6-max Seat #1 is the button
Seat 1: 9dcd69d5 ($11.95 in chips)
Seat 2: e8f2f382 ($5.15 in chips)
Seat 3: d92261bd ($2.29 in chips)
Seat 4: Hero ($16.23 in chips)
Seat 5: d5778e5c ($9.06 in chips)
Seat 6: 98fc6bc8 ($5 in chips)
e8f2f382: posts small blind $0.02
d92261bd: posts big blind $0.05
*** HOLE CARDS ***
Dealt to 9dcd69d5 
Dealt to e8f2f382 
Dealt to d92261bd 
Dealt to Hero [Ac Th]
Dealt to d5778e5c 
Dealt to 98fc6bc8 
Hero: folds
d5778e5c: folds
98fc6bc8: folds
9dcd69d5: folds
e8f2f382: folds
Uncalled bet ($0.03) returned to d92261bd
*** SHOWDOWN ***
d92261bd collected $0.04 from pot
*** SUMMARY ***
Total pot $0.04 | Rake $0 | Jackpot $0 | Bingo $0 | Fortune $0 | Tax $0
Seat 1: 9dcd69d5 (button) folded before Flop (didn't bet)
Seat 2: e8f2f382 (small blind) folded before Flop
Seat 3: d92261bd (big blind) collected ($0.04)
Seat 4: Hero folded before Flop (didn't bet)
Seat 5: d5778e5c folded before Flop (didn't bet)
Seat 6: 98fc6bc8 folded before Flop (didn't bet)


Poker Hand #RC3811184067: Hold'em No Limit ($0.02/$0.05) - 2025/08/16 13:00:04
Table 'RushAndCash849327' 6-max Seat #1 is the button
Seat 1: d45d45a4 ($5.18 in chips)
Seat 2: d39a7ce4 ($6.15 in chips)
Seat 3: f5902ff5 ($7.23 in chips)
Seat 4: Hero ($16.23 in chips)
Seat 5: af513a68 ($38.96 in chips)
Seat 6: 872c9862 ($11.53 in chips)
d39a7ce4: posts small blind $0.02
f5902ff5: posts big blind $0.05
*** HOLE CARDS ***
Dealt to d45d45a4 
Dealt to d39a7ce4 
Dealt to f5902ff5 
Dealt to Hero [5d Qh]
Dealt to af513a68 
Dealt to 872c9862 
Hero: folds
af513a68: folds
872c9862: raises $0.07 to $0.12
d45d45a4: raises $0.33 to $0.45
d39a7ce4: folds
f5902ff5: folds
872c9862: raises $0.75 to $1.2
d45d45a4: calls $0.75
*** FLOP *** [2s 3c 5s]
872c9862: bets $0.66
d45d45a4: raises $3.32 to $3.98 and is all-in
872c9862: folds
Uncalled bet ($3.32) returned to d45d45a4
*** SHOWDOWN ***
d45d45a4 collected $3.57 from pot
*** SUMMARY ***
Total pot $3.79 | Rake $0.15 | Jackpot $0.07 | Bingo $0 | Fortune $0 | Tax $0
Board [2s 3c 5s]
Seat 1: d45d45a4 (button) won ($3.57)
Seat 2: d39a7ce4 (small blind) folded before Flop
Seat 3: f5902ff5 (big blind) folded before Flop
Seat 4: Hero folded before Flop (didn't bet)
Seat 5: af513a68 folded before Flop (didn't bet)
Seat 6: 872c9862 folded on the Flop


Poker Hand #RC3811183843: Hold'em No Limit ($0.02/$0.05) - 2025/08/16 12:59:07
Table 'RushAndCash849103' 6-max Seat #1 is the button
Seat 1: c58b8609 ($12.34 in chips)
Seat 2: dc0f53eb ($1.66 in chips)
Seat 3: Hero ($15.37 in chips)
Seat 4: 4bb9e6a6 ($6.89 in chips)
Seat 5: f58c1fbe ($4.37 in chips)
Seat 6: ec79c726 ($5 in chips)
dc0f53eb: posts small blind $0.02
Hero: posts big blind $0.05
*** HOLE CARDS ***
Dealt to c58b8609 
Dealt to dc0f53eb 
Dealt to Hero [6h Ac]
Dealt to 4bb9e6a6 
Dealt to f58c1fbe 
Dealt to ec79c726 
4bb9e6a6: folds
f58c1fbe: folds
ec79c726: folds
c58b8609: folds
dc0f53eb: raises $0.15 to $0.2
Hero: calls $0.15
*** FLOP *** [5h 2h 4c]
dc0f53eb: bets $0.14
Hero: calls $0.14
*** TURN *** [5h 2h 4c] [8h]
dc0f53eb: checks
Hero: checks
*** RIVER *** [5h 2h 4c 8h] [3h]
dc0f53eb: bets $0.68
Hero: calls $0.68
dc0f53eb: shows [3s 3c] (three of a kind, Threes)
Hero: shows [6h Ac] (a flush Eight high)
*** SHOWDOWN ***
Hero collected $1.88 from pot
*** SUMMARY ***
Total pot $2.04 | Rake $0.09 | Jackpot $0.07 | Bingo $0 | Fortune $0 | Tax $0
Board [5h 2h 4c 8h 3h]
Seat 1: c58b8609 (button) folded before Flop (didn't bet)
Seat 2: dc0f53eb (small blind) showed [3s 3c] and lost with three of a kind, Threes
Seat 3: Hero (big blind) showed [6h Ac] and won ($1.88) with a flush Eight high
Seat 4: 4bb9e6a6 folded before Flop (didn't bet)
Seat 5: f58c1fbe folded before Flop (didn't bet)
Seat 6: ec79c726 folded before Flop (didn't bet)


Poker Hand #RC3811183812: Hold'em No Limit ($0.02/$0.05) - 2025/08/16 12:58:58
Table 'RushAndCash849072' 6-max Seat #1 is the button
Seat 1: 6c09830e ($5.43 in chips)
Seat 2: Hero ($15.39 in chips)
Seat 3: c279a6b3 ($5 in chips)
Seat 4: 77ca40f ($10.93 in chips)
Seat 5: 73ff40f7 ($5.74 in chips)
Seat 6: b213523c ($6.83 in chips)
Hero: posts small blind $0.02
c279a6b3: posts big blind $0.05
*** HOLE CARDS ***
Dealt to 6c09830e 
Dealt to Hero [Qd Jh]
Dealt to c279a6b3 
Dealt to 77ca40f 
Dealt to 73ff40f7 
Dealt to b213523c 
77ca40f: folds
73ff40f7: folds
b213523c: folds
6c09830e: folds
Hero: folds
Uncalled bet ($0.03) returned to c279a6b3
*** SHOWDOWN ***
c279a6b3 collected $0.04 from pot
*** SUMMARY ***
Total pot $0.04 | Rake $0 | Jackpot $0 | Bingo $0 | Fortune $0 | Tax $0
Seat 1: 6c09830e (button) folded before Flop (didn't bet)
Seat 2: Hero (small blind) folded before Flop
Seat 3: c279a6b3 (big blind) collected ($0.04)
Seat 4: 77ca40f folded before Flop (didn't bet)
Seat 5: 73ff40f7 folded before Flop (didn't bet)
Seat 6: b213523c folded before Flop (didn't bet)


Poker Hand #RC3811183789: Hold'em No Limit ($0.02/$0.05) - 2025/08/16 12:58:53
Table 'RushAndCash849049' 6-max Seat #1 is the button
Seat 1: Hero ($15.39 in chips)
Seat 2: 55ab7f3b ($8.33 in chips)
Seat 3: dc0f53eb ($1.71 in chips)
Seat 4: df4a0ffb ($5.07 in chips)
Seat 5: 1e25c9d8 ($6.2 in chips)
Seat 6: f1e9c2c3 ($10.51 in chips)
55ab7f3b: posts small blind $0.02
dc0f53eb: posts big blind $0.05
*** HOLE CARDS ***
Dealt to Hero [Ad 3h]
Dealt to 55ab7f3b 
Dealt to dc0f53eb 
Dealt to df4a0ffb 
Dealt to 1e25c9d8 
Dealt to f1e9c2c3 
df4a0ffb: folds
1e25c9d8: folds
f1e9c2c3: raises $0.05 to $0.1
Hero: folds
55ab7f3b: folds
dc0f53eb: folds
Uncalled bet ($0.05) returned to f1e9c2c3
*** SHOWDOWN ***
f1e9c2c3 collected $0.12 from pot
*** SUMMARY ***
Total pot $0.12 | Rake $0 | Jackpot $0 | Bingo $0 | Fortune $0 | Tax $0
Seat 1: Hero (button) folded before Flop (didn't bet)
Seat 2: 55ab7f3b (small blind) folded before Flop
Seat 3: dc0f53eb (big blind) folded before Flop
Seat 4: df4a0ffb folded before Flop (didn't bet)
Seat 5: 1e25c9d8 folded before Flop (didn't bet)
Seat 6: f1e9c2c3 collected ($0.12)


Poker Hand #RC3811183748: Hold'em No Limit ($0.02/$0.05) - 2025/08/16 12:58:42
Table 'RushAndCash849008' 6-max Seat #1 is the button
Seat 1: f1e6db21 ($7.78 in chips)
Seat 2: 2c13ab5a ($1.08 in chips)
Seat 3: 5e3fe18c ($9.99 in chips)
Seat 4: Hero ($15.32 in chips)
Seat 5: 3a31005b ($18.78 in chips)
Seat 6: e32431a3 ($5.2 in chips)
2c13ab5a: posts small blind $0.02
5e3fe18c: posts big blind $0.05
*** HOLE CARDS ***
Dealt to f1e6db21 
Dealt to 2c13ab5a 
Dealt to 5e3fe18c 
Dealt to Hero [Kc Qd]
Dealt to 3a31005b 
Dealt to e32431a3 
Hero: raises $0.05 to $0.1
3a31005b: folds
e32431a3: folds
f1e6db21: folds
2c13ab5a: folds
5e3fe18c: folds
Uncalled bet ($0.05) returned to Hero
*** SHOWDOWN ***
Hero collected $0.12 from pot
*** SUMMARY ***
Total pot $0.12 | Rake $0 | Jackpot $0 | Bingo $0 | Fortune $0 | Tax $0
Seat 1: f1e6db21 (button) folded before Flop (didn't bet)
Seat 2: 2c13ab5a (small blind) folded before Flop
Seat 3: 5e3fe18c (big blind) folded before Flop
Seat 4: Hero collected ($0.12)
Seat 5: 3a31005b folded before Flop (didn't bet)
Seat 6: e32431a3 folded before Flop (didn't bet)


Poker Hand #RC3811183734: Hold'em No Limit ($0.02/$0.05) - 2025/08/16 12:58:39
Table 'RushAndCash848994' 6-max Seat #1 is the button
Seat 1: 3f1c320d ($1.93 in chips)
Seat 2: 1ab2cd37 ($29.69 in chips)
Seat 3: fdba6534 ($10.86 in chips)
Seat 4: Hero ($15.32 in chips)
Seat 5: e32431a3 ($5.2 in chips)
Seat 6: 916c17b0 ($5 in chips)
1ab2cd37: posts small blind $0.02
fdba6534: posts big blind $0.05
*** HOLE CARDS ***
Dealt to 3f1c320d 
Dealt to 1ab2cd37 
Dealt to fdba6534 
Dealt to Hero [3d 5c]
Dealt to e32431a3 
Dealt to 916c17b0 
Hero: folds
e32431a3: folds
916c17b0: raises $0.06 to $0.11
3f1c320d: raises $0.29 to $0.4
1ab2cd37: folds
fdba6534: folds
916c17b0: folds
Uncalled bet ($0.29) returned to 3f1c320d
*** SHOWDOWN ***
3f1c320d collected $0.28 from pot
*** SUMMARY ***
Total pot $0.29 | Rake $0.01 | Jackpot $0 | Bingo $0 | Fortune $0 | Tax $0
Seat 1: 3f1c320d (button) collected ($0.28)
Seat 2: 1ab2cd37 (small blind) folded before Flop
Seat 3: fdba6534 (big blind) folded before Flop
Seat 4: Hero folded before Flop (didn't bet)
Seat 5: e32431a3 folded before Flop (didn't bet)
Seat 6: 916c17b0 folded before Flop


Poker Hand #RC3811183719: Hold'em No Limit ($0.02/$0.05) - 2025/08/16 12:58:35
Table 'RushAndCash848979' 6-max Seat #1 is the button
Seat 1: 18857e14 ($8.86 in chips)
Seat 2: 80415c7b ($5.41 in chips)
Seat 3: a0391971 ($12.15 in chips)
Seat 4: dccedb95 ($5.6 in chips)
Seat 5: 343e61a8 ($9.05 in chips)
Seat 6: Hero ($15.32 in chips)
80415c7b: posts small blind $0.02
a0391971: posts big blind $0.05
*** HOLE CARDS ***
Dealt to 18857e14 
Dealt to 80415c7b 
Dealt to a0391971 
Dealt to dccedb95 
Dealt to 343e61a8 
Dealt to Hero [3d Jh]
dccedb95: folds
343e61a8: folds
Hero: folds
18857e14: raises $0.08 to $0.13
80415c7b: folds
a0391971: calls $0.08
*** FLOP *** [5s 9d 3h]
a0391971: checks
18857e14: checks
*** TURN *** [5s 9d 3h] [Td]
a0391971: checks
18857e14: checks
*** RIVER *** [5s 9d 3h Td] [6d]
a0391971: checks
18857e14: checks
a0391971: shows [Th Ks] (a pair of Tens)
18857e14: shows [8d As] (Ace high)
*** SHOWDOWN ***
a0391971 collected $0.27 from pot
*** SUMMARY ***
Total pot $0.28 | Rake $0.01 | Jackpot $0 | Bingo $0 | Fortune $0 | Tax $0
Board [5s 9d 3h Td 6d]
Seat 1: 18857e14 (button) showed [8d As] and lost with Ace high
Seat 2: 80415c7b (small blind) folded before Flop
Seat 3: a0391971 (big blind) showed [Th Ks] and won ($0.27) with a pair of Tens
Seat 4: dccedb95 folded before Flop (didn't bet)
Seat 5: 343e61a8 folded before Flop (didn't bet)
Seat 6: Hero folded before Flop (didn't bet)


Poker Hand #RC3811183699: Hold'em No Limit ($0.02/$0.05) - 2025/08/16 12:58:30
Table 'RushAndCash848959' 6-max Seat #1 is the button
Seat 1: 51a6213 ($9.64 in chips)
Seat 2: f1e6db21 ($7.8 in chips)
Seat 3: 27e35928 ($1.93 in chips)
Seat 4: e3a8fca9 ($5.59 in chips)
Seat 5: a61563b7 ($5.83 in chips)
Seat 6: Hero ($15.32 in chips)
f1e6db21: posts small blind $0.02
27e35928: posts big blind $0.05
*** HOLE CARDS ***
Dealt to 51a6213 
Dealt to f1e6db21 
Dealt to 27e35928 
Dealt to e3a8fca9 
Dealt to a61563b7 
Dealt to Hero [8c Ad]
e3a8fca9: folds
a61563b7: folds
Hero: folds
51a6213: folds
f1e6db21: folds
Uncalled bet ($0.03) returned to 27e35928
*** SHOWDOWN ***
27e35928 collected $0.04 from pot
*** SUMMARY ***
Total pot $0.04 | Rake $0 | Jackpot $0 | Bingo $0 | Fortune $0 | Tax $0
Seat 1: 51a6213 (button) folded before Flop (didn't bet)
Seat 2: f1e6db21 (small blind) folded before Flop
Seat 3: 27e35928 (big blind) collected ($0.04)
Seat 4: e3a8fca9 folded before Flop (didn't bet)
Seat 5: a61563b7 folded before Flop (didn't bet)
Seat 6: Hero folded before Flop (didn't bet)


Poker Hand #RC3811183646: Hold'em No Limit ($0.02/$0.05) - 2025/08/16 12:58:19
Table 'RushAndCash848906' 6-max Seat #1 is the button
Seat 1: d73e29e7 ($5.36 in chips)
Seat 2: 773060d3 ($5.27 in chips)
Seat 3: Hero ($15.37 in chips)
Seat 4: 19480dc1 ($8.08 in chips)
Seat 5: fad7a12d ($6.05 in chips)
Seat 6: 52a2d7e7 ($4.98 in chips)
773060d3: posts small blind $0.02
Hero: posts big blind $0.05
*** HOLE CARDS ***
Dealt to d73e29e7 
Dealt to 773060d3 
Dealt to Hero [Js 5d]
Dealt to 19480dc1 
Dealt to fad7a12d 
Dealt to 52a2d7e7 
19480dc1: folds
fad7a12d: folds
52a2d7e7: raises $0.07 to $0.12
d73e29e7: raises $0.24 to $0.36
773060d3: folds
Hero: folds
52a2d7e7: calls $0.24
*** FLOP *** [Qc 9d Kd]
52a2d7e7: checks
d73e29e7: bets $0.29
52a2d7e7: raises $0.69 to $0.98
d73e29e7: folds
Uncalled bet ($0.69) returned to 52a2d7e7
*** SHOWDOWN ***
52a2d7e7 collected $1.31 from pot
*** SUMMARY ***
Total pot $1.37 | Rake $0.06 | Jackpot $0 | Bingo $0 | Fortune $0 | Tax $0
Board [Qc 9d Kd]
Seat 1: d73e29e7 (button) folded on the Flop
Seat 2: 773060d3 (small blind) folded before Flop
Seat 3: Hero (big blind) folded before Flop
Seat 4: 19480dc1 folded before Flop (didn't bet)
Seat 5: fad7a12d folded before Flop (didn't bet)
Seat 6: 52a2d7e7 won ($1.31)


Poker Hand #RC3811183627: Hold'em No Limit ($0.02/$0.05) - 2025/08/16 12:58:16
Table 'RushAndCash848887' 6-max Seat #1 is the button
Seat 1: Hero ($15.37 in chips)
Seat 2: 705da4ca ($5.08 in chips)
Seat 3: 73c308f9 ($16.61 in chips)
Seat 4: 111c5398 ($15.09 in chips)
Seat 5: e954f570 ($5.29 in chips)
Seat 6: 89b54cc6 ($5.95 in chips)
705da4ca: posts small blind $0.02
73c308f9: posts big blind $0.05
*** HOLE CARDS ***
Dealt to Hero [7c 6d]
Dealt to 705da4ca 
Dealt to 73c308f9 
Dealt to 111c5398 
Dealt to e954f570 
Dealt to 89b54cc6 
111c5398: folds
e954f570: folds
89b54cc6: folds
Hero: folds
705da4ca: calls $0.03
73c308f9: raises $0.15 to $0.2
705da4ca: calls $0.15
*** FLOP *** [Ts Ks 6s]
705da4ca: checks
73c308f9: bets $0.14
705da4ca: calls $0.14
*** TURN *** [Ts Ks 6s] [Jh]
705da4ca: checks
73c308f9: checks
*** RIVER *** [Ts Ks 6s Jh] [Ac]
705da4ca: bets $0.51
73c308f9: folds
Uncalled bet ($0.51) returned to 705da4ca
*** SHOWDOWN ***
705da4ca collected $0.65 from pot
*** SUMMARY ***
Total pot $0.68 | Rake $0.03 | Jackpot $0 | Bingo $0 | Fortune $0 | Tax $0
Board [Ts Ks 6s Jh Ac]
Seat 1: Hero (button) folded before Flop (didn't bet)
Seat 2: 705da4ca (small blind) won ($0.65)
Seat 3: 73c308f9 (big blind) folded on the River
Seat 4: 111c5398 folded before Flop (didn't bet)
Seat 5: e954f570 folded before Flop (didn't bet)
Seat 6: 89b54cc6 folded before Flop (didn't bet)


Poker Hand #RC3811183614: Hold'em No Limit ($0.02/$0.05) - 2025/08/16 12:58:12
Table 'RushAndCash848874' 6-max Seat #1 is the button
Seat 1: 154c971f ($1.4 in chips)
Seat 2: 767ec7ee ($7.83 in chips)
Seat 3: a6710f72 ($5.06 in chips)
Seat 4: d73e29e7 ($5.36 in chips)
Seat 5: Hero ($15.37 in chips)
Seat 6: f1e6db21 ($7.87 in chips)
767ec7ee: posts small blind $0.02
a6710f72: posts big blind $0.05
*** HOLE CARDS ***
Dealt to 154c971f 
Dealt to 767ec7ee 
Dealt to a6710f72 
Dealt to d73e29e7 
Dealt to Hero [Kc 8c]
Dealt to f1e6db21 
d73e29e7: folds
Hero: folds
f1e6db21: folds
154c971f: folds
767ec7ee: raises $0.05 to $0.1
a6710f72: raises $0.3 to $0.4
767ec7ee: folds
Uncalled bet ($0.3) returned to a6710f72
*** SHOWDOWN ***
a6710f72 collected $0.19 from pot
*** SUMMARY ***
Total pot $0.2 | Rake $0.01 | Jackpot $0 | Bingo $0 | Fortune $0 | Tax $0
Seat 1: 154c971f (button) folded before Flop (didn't bet)
Seat 2: 767ec7ee (small blind) folded before Flop
Seat 3: a6710f72 (big blind) collected ($0.19)
Seat 4: d73e29e7 folded before Flop (didn't bet)
Seat 5: Hero folded before Flop (didn't bet)
Seat 6: f1e6db21 folded before Flop (didn't bet)


Poker Hand #RC3811183598: Hold'em No Limit ($0.02/$0.05) - 2025/08/16 12:58:09
Table 'RushAndCash848858' 6-max Seat #1 is the button
Seat 1: d73e29e7 ($5.36 in chips)
Seat 2: 679d1db9 ($9.38 in chips)
Seat 3: 5e3fe18c ($9.97 in chips)
Seat 4: 6ad839b8 ($7.63 in chips)
Seat 5: Hero ($15.37 in chips)
Seat 6: ff1232b4 ($22.13 in chips)
679d1db9: posts small blind $0.02
5e3fe18c: posts big blind $0.05
*** HOLE CARDS ***
Dealt to d73e29e7 
Dealt to 679d1db9 
Dealt to 5e3fe18c 
Dealt to 6ad839b8 
Dealt to Hero [Jc 2c]
Dealt to ff1232b4 
6ad839b8: folds
Hero: folds
ff1232b4: folds
d73e29e7: folds
679d1db9: raises $0.08 to $0.13
5e3fe18c: folds
Uncalled bet ($0.08) returned to 679d1db9
*** SHOWDOWN ***
679d1db9 collected $0.1 from pot
*** SUMMARY ***
Total pot $0.1 | Rake $0 | Jackpot $0 | Bingo $0 | Fortune $0 | Tax $0
Seat 1: d73e29e7 (button) folded before Flop (didn't bet)
Seat 2: 679d1db9 (small blind) collected ($0.1)
Seat 3: 5e3fe18c (big blind) folded before Flop
Seat 4: 6ad839b8 folded before Flop (didn't bet)
Seat 5: Hero folded before Flop (didn't bet)
Seat 6: ff1232b4 folded before Flop (didn't bet)


Poker Hand #RC3811183495: Hold'em No Limit ($0.02/$0.05) - 2025/08/16 12:57:44
Table 'RushAndCash848755' 6-max Seat #1 is the button
Seat 1: e3a8fca9 ($5.59 in chips)
Seat 2: Hero ($15.32 in chips)
Seat 3: c8096260 ($5.16 in chips)
Seat 4: 721d5285 ($13.95 in chips)
Seat 5: 8d383074 ($5.02 in chips)
Seat 6: 7a2d6019 ($5.04 in chips)
Hero: posts small blind $0.02
c8096260: posts big blind $0.05
*** HOLE CARDS ***
Dealt to e3a8fca9 
Dealt to Hero [3d Kd]
Dealt to c8096260 
Dealt to 721d5285 
Dealt to 8d383074 
Dealt to 7a2d6019 
721d5285: folds
8d383074: folds
7a2d6019: folds
e3a8fca9: folds
Hero: calls $0.03
c8096260: checks
*** FLOP *** [Ks Qs 9h]
Hero: bets $0.05
c8096260: folds
Uncalled bet ($0.05) returned to Hero
*** SHOWDOWN ***
Hero collected $0.1 from pot
*** SUMMARY ***
Total pot $0.1 | Rake $0 | Jackpot $0 | Bingo $0 | Fortune $0 | Tax $0
Board [Ks Qs 9h]
Seat 1: e3a8fca9 (button) folded before Flop (didn't bet)
Seat 2: Hero (small blind) won ($0.1)
Seat 3: c8096260 (big blind) folded on the Flop
Seat 4: 721d5285 folded before Flop (didn't bet)
Seat 5: 8d383074 folded before Flop (didn't bet)
Seat 6: 7a2d6019 folded before Flop (didn't bet)


Poker Hand #RC3811183482: Hold'em No Limit ($0.02/$0.05) - 2025/08/16 12:57:41
Table 'RushAndCash848742' 6-max Seat #1 is the button
Seat 1: 1ab2cd37 ($29.6 in chips)
Seat 2: 74f6e82b ($5 in chips)
Seat 3: feb27c50 ($7.9 in chips)
Seat 4: ef779654 ($8.88 in chips)
Seat 5: 629057aa ($5.21 in chips)
Seat 6: Hero ($15.32 in chips)
74f6e82b: posts small blind $0.02
feb27c50: posts big blind $0.05
*** HOLE CARDS ***
Dealt to 1ab2cd37 
Dealt to 74f6e82b 
Dealt to feb27c50 
Dealt to ef779654 
Dealt to 629057aa 
Dealt to Hero [4s 3c]
ef779654: folds
629057aa: raises $0.06 to $0.11
Hero: folds
1ab2cd37: folds
74f6e82b: folds
feb27c50: calls $0.06
*** FLOP *** [2d 6s 5h]
feb27c50: checks
629057aa: checks
*** TURN *** [2d 6s 5h] [9h]
feb27c50: checks
629057aa: checks
*** RIVER *** [2d 6s 5h 9h] [Jh]
feb27c50: checks
629057aa: checks
feb27c50: shows [Kc 9c] (a pair of Nines)
629057aa: shows [3s 3d] (a pair of Threes)
*** SHOWDOWN ***
feb27c50 collected $0.23 from pot
*** SUMMARY ***
Total pot $0.24 | Rake $0.01 | Jackpot $0 | Bingo $0 | Fortune $0 | Tax $0
Board [2d 6s 5h 9h Jh]
Seat 1: 1ab2cd37 (button) folded before Flop (didn't bet)
Seat 2: 74f6e82b (small blind) folded before Flop
Seat 3: feb27c50 (big blind) showed [Kc 9c] and won ($0.23) with a pair of Nines
Seat 4: ef779654 folded before Flop (didn't bet)
Seat 5: 629057aa showed [3s 3d] and lost with a pair of Threes
Seat 6: Hero folded before Flop (didn't bet)


Poker Hand #RC3811183200: Hold'em No Limit ($0.02/$0.05) - 2025/08/16 12:56:28
Table 'RushAndCash848460' 6-max Seat #1 is the button
Seat 1: 629057aa ($6.05 in chips)
Seat 2: 368c4e75 ($7.62 in chips)
Seat 3: 45eea39e ($8.26 in chips)
Seat 4: a98f555a ($6.79 in chips)
Seat 5: Hero ($14.56 in chips)
Seat 6: 36ce12e3 ($5 in chips)
368c4e75: posts small blind $0.02
45eea39e: posts big blind $0.05
*** HOLE CARDS ***
Dealt to 629057aa 
Dealt to 368c4e75 
Dealt to 45eea39e 
Dealt to a98f555a 
Dealt to Hero [9s As]
Dealt to 36ce12e3 
a98f555a: folds
Hero: raises $0.05 to $0.1
36ce12e3: folds
629057aa: raises $0.3 to $0.4
368c4e75: folds
45eea39e: folds
Hero: calls $0.3
*** FLOP *** [Ac 5d 8d]
Hero: checks
629057aa: bets $0.44
Hero: calls $0.44
*** TURN *** [Ac 5d 8d] [Tc]
Hero: checks
629057aa: checks
*** RIVER *** [Ac 5d 8d Tc] [6s]
Hero: checks
629057aa: checks
Hero: shows [9s As] (a pair of Aces)
629057aa: shows [Qd Qh] (a pair of Queens)
*** SHOWDOWN ***
Hero collected $1.6 from pot
*** SUMMARY ***
Total pot $1.75 | Rake $0.08 | Jackpot $0.07 | Bingo $0 | Fortune $0 | Tax $0
Board [Ac 5d 8d Tc 6s]
Seat 1: 629057aa (button) showed [Qd Qh] and lost with a pair of Queens
Seat 2: 368c4e75 (small blind) folded before Flop
Seat 3: 45eea39e (big blind) folded before Flop
Seat 4: a98f555a folded before Flop (didn't bet)
Seat 5: Hero showed [9s As] and won ($1.6) with a pair of Aces
Seat 6: 36ce12e3 folded before Flop (didn't bet)


Poker Hand #RC3811183103: Hold'em No Limit ($0.02/$0.05) - 2025/08/16 12:56:02
Table 'RushAndCash848363' 6-max Seat #1 is the button
Seat 1: Hero ($14.66 in chips)
Seat 2: 629057aa ($5.91 in chips)
Seat 3: 402b3007 ($3 in chips)
Seat 4: b57e9625 ($5.26 in chips)
Seat 5: 57846c0 ($5.09 in chips)
Seat 6: b35df501 ($6.47 in chips)
629057aa: posts small blind $0.02
402b3007: posts big blind $0.05
*** HOLE CARDS ***
Dealt to Hero [Th Jd]
Dealt to 629057aa 
Dealt to 402b3007 
Dealt to b57e9625 
Dealt to 57846c0 
Dealt to b35df501 
b57e9625: folds
57846c0: folds
b35df501: folds
Hero: raises $0.05 to $0.1
629057aa: raises $0.4 to $0.5
402b3007: folds
Hero: folds
Uncalled bet ($0.4) returned to 629057aa
*** SHOWDOWN ***
629057aa collected $0.24 from pot
*** SUMMARY ***
Total pot $0.25 | Rake $0.01 | Jackpot $0 | Bingo $0 | Fortune $0 | Tax $0
Seat 1: Hero (button) folded before Flop
Seat 2: 629057aa (small blind) collected ($0.24)
Seat 3: 402b3007 (big blind) folded before Flop
Seat 4: b57e9625 folded before Flop (didn't bet)
Seat 5: 57846c0 folded before Flop (didn't bet)
Seat 6: b35df501 folded before Flop (didn't bet)


Poker Hand #RC3811183067: Hold'em No Limit ($0.02/$0.05) - 2025/08/16 12:55:53
Table 'RushAndCash848327' 6-max Seat #1 is the button
Seat 1: 45eea39e ($8.26 in chips)
Seat 2: Hero ($14.68 in chips)
Seat 3: e954f570 ($5.11 in chips)
Seat 4: 3d3ee091 ($8.58 in chips)
Seat 5: 5c1d3310 ($5.16 in chips)
Seat 6: f8d1eed ($5.18 in chips)
Hero: posts small blind $0.02
e954f570: posts big blind $0.05
*** HOLE CARDS ***
Dealt to 45eea39e 
Dealt to Hero [9h Ts]
Dealt to e954f570 
Dealt to 3d3ee091 
Dealt to 5c1d3310 
Dealt to f8d1eed 
3d3ee091: raises $0.08 to $0.13
5c1d3310: folds
f8d1eed: folds
45eea39e: folds
Hero: folds
e954f570: folds
Uncalled bet ($0.08) returned to 3d3ee091
*** SHOWDOWN ***
3d3ee091 collected $0.12 from pot
*** SUMMARY ***
Total pot $0.12 | Rake $0 | Jackpot $0 | Bingo $0 | Fortune $0 | Tax $0
Seat 1: 45eea39e (button) folded before Flop (didn't bet)
Seat 2: Hero (small blind) folded before Flop
Seat 3: e954f570 (big blind) folded before Flop
Seat 4: 3d3ee091 collected ($0.12)
Seat 5: 5c1d3310 folded before Flop (didn't bet)
Seat 6: f8d1eed folded before Flop (didn't bet)


Poker Hand #RC3811183052: Hold'em No Limit ($0.02/$0.05) - 2025/08/16 12:55:50
Table 'RushAndCash848312' 6-max Seat #1 is the button
Seat 1: d876bedd ($5.27 in chips)
Seat 2: 544f255f ($5.02 in chips)
Seat 3: 63def097 ($10.55 in chips)
Seat 4: a696b75f ($4.24 in chips)
Seat 5: cacc08d1 ($5.26 in chips)
Seat 6: Hero ($14.68 in chips)
544f255f: posts small blind $0.02
63def097: posts big blind $0.05
*** HOLE CARDS ***
Dealt to d876bedd 
Dealt to 544f255f 
Dealt to 63def097 
Dealt to a696b75f 
Dealt to cacc08d1 
Dealt to Hero [Tc 7s]
a696b75f: calls $0.05
cacc08d1: folds
Hero: folds
d876bedd: folds
544f255f: folds
63def097: checks
*** FLOP *** [7h 9c 9h]
63def097: checks
a696b75f: bets $0.12
63def097: folds
Uncalled bet ($0.12) returned to a696b75f
*** SHOWDOWN ***
a696b75f collected $0.12 from pot
*** SUMMARY ***
Total pot $0.12 | Rake $0 | Jackpot $0 | Bingo $0 | Fortune $0 | Tax $0
Board [7h 9c 9h]
Seat 1: d876bedd (button) folded before Flop (didn't bet)
Seat 2: 544f255f (small blind) folded before Flop
Seat 3: 63def097 (big blind) folded on the Flop
Seat 4: a696b75f won ($0.12)
Seat 5: cacc08d1 folded before Flop (didn't bet)
Seat 6: Hero folded before Flop (didn't bet)


Poker Hand #RC3811183039: Hold'em No Limit ($0.02/$0.05) - 2025/08/16 12:55:46
Table 'RushAndCash848299' 6-max Seat #1 is the button
Seat 1: 3d3ee091 ($8.58 in chips)
Seat 2: ee393169 ($5.04 in chips)
Seat 3: b827826f ($5 in chips)
Seat 4: 85e6eb31 ($6.23 in chips)
Seat 5: feb27c50 ($7.63 in chips)
Seat 6: Hero ($14.68 in chips)
ee393169: posts small blind $0.02
b827826f: posts big blind $0.05
*** HOLE CARDS ***
Dealt to 3d3ee091 
Dealt to ee393169 
Dealt to b827826f 
Dealt to 85e6eb31 
Dealt to feb27c50 
Dealt to Hero [4d 2c]
85e6eb31: folds
feb27c50: raises $0.05 to $0.1
Hero: folds
3d3ee091: folds
ee393169: folds
b827826f: calls $0.05
*** FLOP *** [9h Kc 7c]
b827826f: checks
feb27c50: bets $0.17
b827826f: calls $0.17
*** TURN *** [9h Kc 7c] [6s]
b827826f: checks
feb27c50: bets $0.81
b827826f: folds
Uncalled bet ($0.81) returned to feb27c50
*** SHOWDOWN ***
feb27c50 collected $0.54 from pot
*** SUMMARY ***
Total pot $0.56 | Rake $0.02 | Jackpot $0 | Bingo $0 | Fortune $0 | Tax $0
Board [9h Kc 7c 6s]
Seat 1: 3d3ee091 (button) folded before Flop (didn't bet)
Seat 2: ee393169 (small blind) folded before Flop
Seat 3: b827826f (big blind) folded on the Turn
Seat 4: 85e6eb31 folded before Flop (didn't bet)
Seat 5: feb27c50 won ($0.54)
Seat 6: Hero folded before Flop (didn't bet)


Poker Hand #RC3811183006: Hold'em No Limit ($0.02/$0.05) - 2025/08/16 12:55:37
Table 'RushAndCash848266' 6-max Seat #1 is the button
Seat 1: Hero ($14.68 in chips)
Seat 2: 424df61b ($5.27 in chips)
Seat 3: 6156df52 ($6.59 in chips)
Seat 4: 22ac4fad ($4.58 in chips)
Seat 5: df4a0ffb ($5.06 in chips)
Seat 6: e8f2f382 ($5.3 in chips)
424df61b: posts small blind $0.02
6156df52: posts big blind $0.05
*** HOLE CARDS ***
Dealt to Hero [Td 7c]
Dealt to 424df61b 
Dealt to 6156df52 
Dealt to 22ac4fad 
Dealt to df4a0ffb 
Dealt to e8f2f382 
22ac4fad: folds
df4a0ffb: folds
e8f2f382: folds
Hero: folds
424df61b: raises $0.05 to $0.1
6156df52: folds
Uncalled bet ($0.05) returned to 424df61b
*** SHOWDOWN ***
424df61b collected $0.1 from pot
*** SUMMARY ***
Total pot $0.1 | Rake $0 | Jackpot $0 | Bingo $0 | Fortune $0 | Tax $0
Seat 1: Hero (button) folded before Flop (didn't bet)
Seat 2: 424df61b (small blind) collected ($0.1)
Seat 3: 6156df52 (big blind) folded before Flop
Seat 4: 22ac4fad folded before Flop (didn't bet)
Seat 5: df4a0ffb folded before Flop (didn't bet)
Seat 6: e8f2f382 folded before Flop (didn't bet)


Poker Hand #RC3811182976: Hold'em No Limit ($0.02/$0.05) - 2025/08/16 12:55:29
Table 'RushAndCash848236' 6-max Seat #1 is the button
Seat 1: 3a532488 ($3.75 in chips)
Seat 2: 69ae3444 ($22.94 in chips)
Seat 3: Hero ($14.73 in chips)
Seat 4: b9c5901d ($8.16 in chips)
Seat 5: dccedb95 ($6.12 in chips)
Seat 6: f7220028 ($5 in chips)
69ae3444: posts small blind $0.02
Hero: posts big blind $0.05
*** HOLE CARDS ***
Dealt to 3a532488 
Dealt to 69ae3444 
Dealt to Hero [Qc 4h]
Dealt to b9c5901d 
Dealt to dccedb95 
Dealt to f7220028 
b9c5901d: folds
dccedb95: folds
f7220028: raises $0.08 to $0.13
3a532488: folds
69ae3444: calls $0.11
Hero: folds
*** FLOP *** [Kh 6c 5d]
69ae3444: checks
f7220028: bets $0.16
69ae3444: calls $0.16
*** TURN *** [Kh 6c 5d] [Qd]
69ae3444: checks
f7220028: bets $0.32
69ae3444: calls $0.32
*** RIVER *** [Kh 6c 5d Qd] [9c]
69ae3444: bets $1.27
f7220028: folds
Uncalled bet ($1.27) returned to 69ae3444
*** SHOWDOWN ***
69ae3444 collected $1.21 from pot
*** SUMMARY ***
Total pot $1.27 | Rake $0.06 | Jackpot $0 | Bingo $0 | Fortune $0 | Tax $0
Board [Kh 6c 5d Qd 9c]
Seat 1: 3a532488 (button) folded before Flop (didn't bet)
Seat 2: 69ae3444 (small blind) won ($1.21)
Seat 3: Hero (big blind) folded before Flop
Seat 4: b9c5901d folded before Flop (didn't bet)
Seat 5: dccedb95 folded before Flop (didn't bet)
Seat 6: f7220028 folded on the River


Poker Hand #RC3811182519: Hold'em No Limit ($0.02/$0.05) - 2025/08/16 12:53:30
Table 'RushAndCash847779' 6-max Seat #1 is the button
Seat 1: d526fb63 ($18.39 in chips)
Seat 2: Hero ($15.02 in chips)
Seat 3: 3e5d8cd2 ($5.19 in chips)
Seat 4: 5c1d3310 ($5 in chips)
Seat 5: 802530be ($4.71 in chips)
Seat 6: 41c92275 ($7.46 in chips)
Hero: posts small blind $0.02
3e5d8cd2: posts big blind $0.05
*** HOLE CARDS ***
Dealt to d526fb63 
Dealt to Hero [Qc Kc]
Dealt to 3e5d8cd2 
Dealt to 5c1d3310 
Dealt to 802530be 
Dealt to 41c92275 
5c1d3310: raises $0.05 to $0.1
802530be: raises $0.19 to $0.29
41c92275: folds
d526fb63: calls $0.29
Hero: calls $0.27
3e5d8cd2: folds
5c1d3310: calls $0.19
*** FLOP *** [2s 7s 9c]
Hero: checks
5c1d3310: checks
802530be: checks
d526fb63: checks
*** TURN *** [2s 7s 9c] [Kh]
Hero: checks
5c1d3310: checks
802530be: bets $0.37
d526fb63: calls $0.37
Hero: folds
5c1d3310: folds
*** RIVER *** [2s 7s 9c Kh] [Ad]
802530be: bets $0.98
d526fb63: raises $16.75 to $17.73 and is all-in
802530be: calls $3.07 and is all-in
Uncalled bet ($13.68) returned to d526fb63
d526fb63: shows [Kd As] (two pair, Aces and Kings)
802530be: shows [Ah Ks] (two pair, Aces and Kings)
*** SHOWDOWN ***
802530be collected $4.92 from pot
d526fb63 collected $4.87 from pot
*** SUMMARY ***
Total pot $10.05 | Rake $0.19 | Jackpot $0.07 | Bingo $0 | Fortune $0 | Tax $0
Board [2s 7s 9c Kh Ad]
Seat 1: d526fb63 (button) showed [Kd As] and won ($4.87) with two pair, Aces and Kings
Seat 2: Hero (small blind) folded on the Turn
Seat 3: 3e5d8cd2 (big blind) folded before Flop
Seat 4: 5c1d3310 folded on the Turn
Seat 5: 802530be showed [Ah Ks] and won ($4.92) with two pair, Aces and Kings
Seat 6: 41c92275 folded before Flop (didn't bet)


Poker Hand #RC3811182310: Hold'em No Limit ($0.02/$0.05) - 2025/08/16 12:52:38
Table 'RushAndCash847570' 6-max Seat #1 is the button
Seat 1: d526fb63 ($18.5 in chips)
Seat 2: 154c971f ($1.98 in chips)
Seat 3: Hero ($14.69 in chips)
Seat 4: 9ff5c314 ($8.38 in chips)
Seat 5: de2d8177 ($4.91 in chips)
Seat 6: 802530be ($4.93 in chips)
154c971f: posts small blind $0.02
Hero: posts big blind $0.05
*** HOLE CARDS ***
Dealt to d526fb63 
Dealt to 154c971f 
Dealt to Hero [3c Kc]
Dealt to 9ff5c314 
Dealt to de2d8177 
Dealt to 802530be 
9ff5c314: folds
de2d8177: folds
802530be: raises $0.06 to $0.11
d526fb63: calls $0.11
154c971f: folds
Hero: calls $0.06
*** FLOP *** [Tc Jc Ah]
Hero: checks
802530be: bets $0.11
d526fb63: folds
Hero: raises $0.28 to $0.39
802530be: folds
Uncalled bet ($0.28) returned to Hero
*** SHOWDOWN ***
Hero collected $0.55 from pot
*** SUMMARY ***
Total pot $0.57 | Rake $0.02 | Jackpot $0 | Bingo $0 | Fortune $0 | Tax $0
Board [Tc Jc Ah]
Seat 1: d526fb63 (button) folded on the Flop
Seat 2: 154c971f (small blind) folded before Flop
Seat 3: Hero (big blind) won ($0.55)
Seat 4: 9ff5c314 folded before Flop (didn't bet)
Seat 5: de2d8177 folded before Flop (didn't bet)
Seat 6: 802530be folded on the Flop


Poker Hand #RC3811182260: Hold'em No Limit ($0.02/$0.05) - 2025/08/16 12:52:27
Table 'RushAndCash847520' 6-max Seat #1 is the button
Seat 1: ab30512 ($8.57 in chips)
Seat 2: Hero ($14.71 in chips)
Seat 3: 893981cc ($5.61 in chips)
Seat 4: cd245036 ($7.37 in chips)
Seat 5: 21582d9 ($5.6 in chips)
Seat 6: 94afcc3f ($5.55 in chips)
Hero: posts small blind $0.02
893981cc: posts big blind $0.05
*** HOLE CARDS ***
Dealt to ab30512 
Dealt to Hero [8c 5s]
Dealt to 893981cc 
Dealt to cd245036 
Dealt to 21582d9 
Dealt to 94afcc3f 
cd245036: folds
21582d9: folds
94afcc3f: folds
ab30512: folds
Hero: folds
Uncalled bet ($0.03) returned to 893981cc
*** SHOWDOWN ***
893981cc collected $0.04 from pot
*** SUMMARY ***
Total pot $0.04 | Rake $0 | Jackpot $0 | Bingo $0 | Fortune $0 | Tax $0
Seat 1: ab30512 (button) folded before Flop (didn't bet)
Seat 2: Hero (small blind) folded before Flop
Seat 3: 893981cc (big blind) collected ($0.04)
Seat 4: cd245036 folded before Flop (didn't bet)
Seat 5: 21582d9 folded before Flop (didn't bet)
Seat 6: 94afcc3f folded before Flop (didn't bet)


Poker Hand #RC3811182227: Hold'em No Limit ($0.02/$0.05) - 2025/08/16 12:52:20
Table 'RushAndCash847487' 6-max Seat #1 is the button
Seat 1: 73c308f9 ($11.67 in chips)
Seat 2: bc095270 ($5.47 in chips)
Seat 3: Hero ($14.69 in chips)
Seat 4: cd245036 ($7.37 in chips)
Seat 5: f8d1eed ($5 in chips)
Seat 6: f4ade85 ($5.74 in chips)
bc095270: posts small blind $0.02
Hero: posts big blind $0.05
*** HOLE CARDS ***
Dealt to 73c308f9 
Dealt to bc095270 
Dealt to Hero [Jh 2h]
Dealt to cd245036 
Dealt to f8d1eed 
Dealt to f4ade85 
cd245036: folds
f8d1eed: folds
f4ade85: folds
73c308f9: folds
bc095270: folds
Uncalled bet ($0.03) returned to Hero
*** SHOWDOWN ***
Hero collected $0.04 from pot
*** SUMMARY ***
Total pot $0.04 | Rake $0 | Jackpot $0 | Bingo $0 | Fortune $0 | Tax $0
Seat 1: 73c308f9 (button) folded before Flop (didn't bet)
Seat 2: bc095270 (small blind) folded before Flop
Seat 3: Hero (big blind) collected ($0.04)
Seat 4: cd245036 folded before Flop (didn't bet)
Seat 5: f8d1eed folded before Flop (didn't bet)
Seat 6: f4ade85 folded before Flop (didn't bet)


Poker Hand #RC3811182144: Hold'em No Limit ($0.02/$0.05) - 2025/08/16 12:52:01
Table 'RushAndCash847404' 6-max Seat #1 is the button
Seat 1: dce7f224 ($17.06 in chips)
Seat 2: 3a532488 ($4.2 in chips)
Seat 3: baa6fc5e ($5.32 in chips)
Seat 4: 2d939dfb ($4.13 in chips)
Seat 5: af718e4b ($27.28 in chips)
Seat 6: Hero ($14.62 in chips)
3a532488: posts small blind $0.02
baa6fc5e: posts big blind $0.05
*** HOLE CARDS ***
Dealt to dce7f224 
Dealt to 3a532488 
Dealt to baa6fc5e 
Dealt to 2d939dfb 
Dealt to af718e4b 
Dealt to Hero [9c 8c]
2d939dfb: folds
af718e4b: folds
Hero: raises $0.05 to $0.1
dce7f224: folds
3a532488: folds
baa6fc5e: folds
Uncalled bet ($0.05) returned to Hero
*** SHOWDOWN ***
Hero collected $0.12 from pot
*** SUMMARY ***
Total pot $0.12 | Rake $0 | Jackpot $0 | Bingo $0 | Fortune $0 | Tax $0
Seat 1: dce7f224 (button) folded before Flop (didn't bet)
Seat 2: 3a532488 (small blind) folded before Flop
Seat 3: baa6fc5e (big blind) folded before Flop
Seat 4: 2d939dfb folded before Flop (didn't bet)
Seat 5: af718e4b folded before Flop (didn't bet)
Seat 6: Hero collected ($0.12)


Poker Hand #RC3811182127: Hold'em No Limit ($0.02/$0.05) - 2025/08/16 12:51:57
Table 'RushAndCash847387' 6-max Seat #1 is the button
Seat 1: df4a0ffb ($5.6 in chips)
Seat 2: 4e37785d ($5.43 in chips)
Seat 3: ca814da5 ($5.46 in chips)
Seat 4: Hero ($14.62 in chips)
Seat 5: cc841ed2 ($10.02 in chips)
Seat 6: 7e862cf8 ($6.3 in chips)
4e37785d: posts small blind $0.02
ca814da5: posts big blind $0.05
*** HOLE CARDS ***
Dealt to df4a0ffb 
Dealt to 4e37785d 
Dealt to ca814da5 
Dealt to Hero [2h 9c]
Dealt to cc841ed2 
Dealt to 7e862cf8 
Hero: folds
cc841ed2: folds
7e862cf8: folds
df4a0ffb: folds
4e37785d: folds
Uncalled bet ($0.03) returned to ca814da5
*** SHOWDOWN ***
ca814da5 collected $0.04 from pot
*** SUMMARY ***
Total pot $0.04 | Rake $0 | Jackpot $0 | Bingo $0 | Fortune $0 | Tax $0
Seat 1: df4a0ffb (button) folded before Flop (didn't bet)
Seat 2: 4e37785d (small blind) folded before Flop
Seat 3: ca814da5 (big blind) collected ($0.04)
Seat 4: Hero folded before Flop (didn't bet)
Seat 5: cc841ed2 folded before Flop (didn't bet)
Seat 6: 7e862cf8 folded before Flop (didn't bet)


Poker Hand #RC3811181719: Hold'em No Limit ($0.02/$0.05) - 2025/08/16 12:50:08
Table 'RushAndCash846979' 6-max Seat #1 is the button
Seat 1: Hero ($12.61 in chips)
Seat 2: 4e37785d ($5.86 in chips)
Seat 3: abe0c2b2 ($4.83 in chips)
Seat 4: 3d7e8ee ($10.22 in chips)
Seat 5: 37c2e948 ($16.68 in chips)
Seat 6: 910e3363 ($10.42 in chips)
4e37785d: posts small blind $0.02
abe0c2b2: posts big blind $0.05
*** HOLE CARDS ***
Dealt to Hero [5c 8c]
Dealt to 4e37785d 
Dealt to abe0c2b2 
Dealt to 3d7e8ee 
Dealt to 37c2e948 
Dealt to 910e3363 
3d7e8ee: folds
37c2e948: raises $0.08 to $0.13
910e3363: raises $0.25 to $0.38
Hero: calls $0.38
4e37785d: calls $0.36
abe0c2b2: folds
37c2e948: calls $0.25
*** FLOP *** [7c Tc 6s]
4e37785d: checks
37c2e948: bets $0.52
910e3363: calls $0.52
Hero: raises $2.5 to $3.02
4e37785d: folds
37c2e948: folds
910e3363: folds
Uncalled bet ($2.5) returned to Hero
*** SHOWDOWN ***
Hero collected $2.91 from pot
*** SUMMARY ***
Total pot $3.13 | Rake $0.15 | Jackpot $0.07 | Bingo $0 | Fortune $0 | Tax $0
Board [7c Tc 6s]
Seat 1: Hero (button) won ($2.91)
Seat 2: 4e37785d (small blind) folded on the Flop
Seat 3: abe0c2b2 (big blind) folded before Flop
Seat 4: 3d7e8ee folded before Flop (didn't bet)
Seat 5: 37c2e948 folded on the Flop
Seat 6: 910e3363 folded on the Flop


Poker Hand #RC3811181704: Hold'em No Limit ($0.02/$0.05) - 2025/08/16 12:50:05
Table 'RushAndCash846964' 6-max Seat #1 is the button
Seat 1: 9c1a625d ($8.46 in chips)
Seat 2: eadf38fc ($9.24 in chips)
Seat 3: a7b36545 ($5 in chips)
Seat 4: 9b7ef7b0 ($6.71 in chips)
Seat 5: Hero ($12.61 in chips)
Seat 6: ca2bb0fc ($5.02 in chips)
eadf38fc: posts small blind $0.02
a7b36545: posts big blind $0.05
*** HOLE CARDS ***
Dealt to 9c1a625d 
Dealt to eadf38fc 
Dealt to a7b36545 
Dealt to 9b7ef7b0 
Dealt to Hero [5d 9s]
Dealt to ca2bb0fc 
9b7ef7b0: folds
Hero: folds
ca2bb0fc: raises $0.05 to $0.1
9c1a625d: folds
eadf38fc: calls $0.08
a7b36545: folds
*** FLOP *** [7d 4d Ac]
eadf38fc: checks
ca2bb0fc: bets $0.13
eadf38fc: calls $0.13
*** TURN *** [7d 4d Ac] [8c]
eadf38fc: checks
ca2bb0fc: bets $1.52
eadf38fc: folds
Uncalled bet ($1.52) returned to ca2bb0fc
*** SHOWDOWN ***
ca2bb0fc collected $0.49 from pot
*** SUMMARY ***
Total pot $0.51 | Rake $0.02 | Jackpot $0 | Bingo $0 | Fortune $0 | Tax $0
Board [7d 4d Ac 8c]
Seat 1: 9c1a625d (button) folded before Flop (didn't bet)
Seat 2: eadf38fc (small blind) folded on the Turn
Seat 3: a7b36545 (big blind) folded before Flop
Seat 4: 9b7ef7b0 folded before Flop (didn't bet)
Seat 5: Hero folded before Flop (didn't bet)
Seat 6: ca2bb0fc won ($0.49)


Poker Hand #RC3811181521: Hold'em No Limit ($0.02/$0.05) - 2025/08/16 12:49:21
Table 'RushAndCash846781' 6-max Seat #1 is the button
Seat 1: 17f8f0d4 ($5 in chips)
Seat 2: 9c1a625d ($8.51 in chips)
Seat 3: 6f824e82 ($13.11 in chips)
Seat 4: Hero ($12.51 in chips)
Seat 5: 495abc44 ($5.62 in chips)
Seat 6: 997a157f ($14.25 in chips)
9c1a625d: posts small blind $0.02
6f824e82: posts big blind $0.05
*** HOLE CARDS ***
Dealt to 17f8f0d4 
Dealt to 9c1a625d 
Dealt to 6f824e82 
Dealt to Hero [Ts Ad]
Dealt to 495abc44 
Dealt to 997a157f 
Hero: calls $0.05
495abc44: folds
997a157f: folds
17f8f0d4: folds
9c1a625d: calls $0.03
6f824e82: checks
*** FLOP *** [5h 9h 5c]
9c1a625d: checks
6f824e82: checks
Hero: checks
*** TURN *** [5h 9h 5c] [Jd]
9c1a625d: checks
6f824e82: checks
Hero: checks
*** RIVER *** [5h 9h 5c Jd] [Ah]
9c1a625d: checks
6f824e82: checks
Hero: bets $0.08
9c1a625d: folds
6f824e82: folds
Uncalled bet ($0.08) returned to Hero
*** SHOWDOWN ***
Hero collected $0.15 from pot
*** SUMMARY ***
Total pot $0.15 | Rake $0 | Jackpot $0 | Bingo $0 | Fortune $0 | Tax $0
Board [5h 9h 5c Jd Ah]
Seat 1: 17f8f0d4 (button) folded before Flop (didn't bet)
Seat 2: 9c1a625d (small blind) folded on the River
Seat 3: 6f824e82 (big blind) folded on the River
Seat 4: Hero won ($0.15)
Seat 5: 495abc44 folded before Flop (didn't bet)
Seat 6: 997a157f folded before Flop (didn't bet)


Poker Hand #RC3811181487: Hold'em No Limit ($0.02/$0.05) - 2025/08/16 12:49:13
Table 'RushAndCash846747' 6-max Seat #1 is the button
Seat 1: Hero ($12.51 in chips)
Seat 2: c58b8609 ($11.86 in chips)
Seat 3: 4698ae62 ($9.28 in chips)
Seat 4: ee3c195 ($9.55 in chips)
Seat 5: 3d3ee091 ($5.3 in chips)
Seat 6: f4c2b883 ($5.32 in chips)
c58b8609: posts small blind $0.02
4698ae62: posts big blind $0.05
*** HOLE CARDS ***
Dealt to Hero [Jh 4c]
Dealt to c58b8609 
Dealt to 4698ae62 
Dealt to ee3c195 
Dealt to 3d3ee091 
Dealt to f4c2b883 
ee3c195: folds
3d3ee091: folds
f4c2b883: raises $0.1 to $0.15
Hero: folds
c58b8609: calls $0.13
4698ae62: folds
*** FLOP *** [8d 6h Jd]
c58b8609: checks
f4c2b883: bets $0.17
c58b8609: calls $0.17
*** TURN *** [8d 6h Jd] [4s]
c58b8609: checks
f4c2b883: checks
*** RIVER *** [8d 6h Jd 4s] [3c]
c58b8609: checks
f4c2b883: checks
c58b8609: shows [6s 5s] (a pair of Sixes)
f4c2b883: shows [5h 5c] (a pair of Fives)
*** SHOWDOWN ***
c58b8609 collected $0.65 from pot
*** SUMMARY ***
Total pot $0.69 | Rake $0.04 | Jackpot $0 | Bingo $0 | Fortune $0 | Tax $0
Board [8d 6h Jd 4s 3c]
Seat 1: Hero (button) folded before Flop (didn't bet)
Seat 2: c58b8609 (small blind) showed [6s 5s] and won ($0.65) with a pair of Sixes
Seat 3: 4698ae62 (big blind) folded before Flop
Seat 4: ee3c195 folded before Flop (didn't bet)
Seat 5: 3d3ee091 folded before Flop (didn't bet)
Seat 6: f4c2b883 showed [5h 5c] and lost with a pair of Fives


Poker Hand #RC3811181474: Hold'em No Limit ($0.02/$0.05) - 2025/08/16 12:49:09
Table 'RushAndCash846734' 6-max Seat #1 is the button
Seat 1: 9ff5c314 ($7.1 in chips)
Seat 2: 343e61a8 ($8.79 in chips)
Seat 3: feb27c50 ($6.38 in chips)
Seat 4: c1991e18 ($9.42 in chips)
Seat 5: f4c2b883 ($5.32 in chips)
Seat 6: Hero ($12.51 in chips)
343e61a8: posts small blind $0.02
feb27c50: posts big blind $0.05
*** HOLE CARDS ***
Dealt to 9ff5c314 
Dealt to 343e61a8 
Dealt to feb27c50 
Dealt to c1991e18 
Dealt to f4c2b883 
Dealt to Hero [9h 2c]
c1991e18: raises $0.05 to $0.1
f4c2b883: folds
Hero: folds
9ff5c314: calls $0.1
343e61a8: folds
feb27c50: folds
*** FLOP *** [4c 7d Jd]
c1991e18: bets $0.14
9ff5c314: calls $0.14
*** TURN *** [4c 7d Jd] [6d]
c1991e18: bets $0.19
9ff5c314: calls $0.19
*** RIVER *** [4c 7d Jd 6d] [Qd]
c1991e18: bets $0.31
9ff5c314: raises $0.78 to $1.09
c1991e18: calls $0.78
9ff5c314: shows [3d Ad] (a flush Ace high)
c1991e18: shows [8d Tc] (a flush Queen high)
*** SHOWDOWN ***
9ff5c314 collected $2.89 from pot
*** SUMMARY ***
Total pot $3.11 | Rake $0.15 | Jackpot $0.07 | Bingo $0 | Fortune $0 | Tax $0
Board [4c 7d Jd 6d Qd]
Seat 1: 9ff5c314 (button) showed [3d Ad] and won ($2.89) with a flush Ace high
Seat 2: 343e61a8 (small blind) folded before Flop
Seat 3: feb27c50 (big blind) folded before Flop
Seat 4: c1991e18 showed [8d Tc] and lost with a flush Queen high
Seat 5: f4c2b883 folded before Flop (didn't bet)
Seat 6: Hero folded before Flop (didn't bet)


Poker Hand #RC3811181455: Hold'em No Limit ($0.02/$0.05) - 2025/08/16 12:49:04
Table 'RushAndCash846715' 6-max Seat #1 is the button
Seat 1: b2d2da42 ($2.73 in chips)
Seat 2: d33081bd ($5.41 in chips)
Seat 3: 2f977f34 ($4.67 in chips)
Seat 4: Hero ($12.51 in chips)
Seat 5: 9ff5c314 ($7.1 in chips)
Seat 6: 51a6213 ($10.12 in chips)
d33081bd: posts small blind $0.02
2f977f34: posts big blind $0.05
*** HOLE CARDS ***
Dealt to b2d2da42 
Dealt to d33081bd 
Dealt to 2f977f34 
Dealt to Hero [Jd Kc]
Dealt to 9ff5c314 
Dealt to 51a6213 
Hero: folds
9ff5c314: folds
51a6213: folds
b2d2da42: folds
d33081bd: raises $0.1 to $0.15
2f977f34: folds
Uncalled bet ($0.1) returned to d33081bd
*** SHOWDOWN ***
d33081bd collected $0.1 from pot
*** SUMMARY ***
Total pot $0.1 | Rake $0 | Jackpot $0 | Bingo $0 | Fortune $0 | Tax $0
Seat 1: b2d2da42 (button) folded before Flop (didn't bet)
Seat 2: d33081bd (small blind) collected ($0.1)
Seat 3: 2f977f34 (big blind) folded before Flop
Seat 4: Hero folded before Flop (didn't bet)
Seat 5: 9ff5c314 folded before Flop (didn't bet)
Seat 6: 51a6213 folded before Flop (didn't bet)


Poker Hand #RC3811181417: Hold'em No Limit ($0.02/$0.05) - 2025/08/16 12:48:55
Table 'RushAndCash846677' 6-max Seat #1 is the button
Seat 1: 5183e732 ($7.07 in chips)
Seat 2: ab4c77fd ($5.78 in chips)
Seat 3: Hero ($12.49 in chips)
Seat 4: bd2c806a ($5.5 in chips)
Seat 5: 188a67f6 ($5 in chips)
Seat 6: 80415c7b ($5.57 in chips)
ab4c77fd: posts small blind $0.02
Hero: posts big blind $0.05
*** HOLE CARDS ***
Dealt to 5183e732 
Dealt to ab4c77fd 
Dealt to Hero [6d Ah]
Dealt to bd2c806a 
Dealt to 188a67f6 
Dealt to 80415c7b 
bd2c806a: folds
188a67f6: folds
80415c7b: folds
5183e732: folds
ab4c77fd: folds
Uncalled bet ($0.03) returned to Hero
*** SHOWDOWN ***
Hero collected $0.04 from pot
*** SUMMARY ***
Total pot $0.04 | Rake $0 | Jackpot $0 | Bingo $0 | Fortune $0 | Tax $0
Seat 1: 5183e732 (button) folded before Flop (didn't bet)
Seat 2: ab4c77fd (small blind) folded before Flop
Seat 3: Hero (big blind) collected ($0.04)
Seat 4: bd2c806a folded before Flop (didn't bet)
Seat 5: 188a67f6 folded before Flop (didn't bet)
Seat 6: 80415c7b folded before Flop (didn't bet)


Poker Hand #RC3811181382: Hold'em No Limit ($0.02/$0.05) - 2025/08/16 12:48:47
Table 'RushAndCash846642' 6-max Seat #1 is the button
Seat 1: eadf38fc ($9.08 in chips)
Seat 2: Hero ($12.51 in chips)
Seat 3: 2938d11a ($5.16 in chips)
Seat 4: 41c92275 ($8.01 in chips)
Seat 5: ee7d25e9 ($5.13 in chips)
Seat 6: 5322e146 ($2.8 in chips)
Hero: posts small blind $0.02
2938d11a: posts big blind $0.05
*** HOLE CARDS ***
Dealt to eadf38fc 
Dealt to Hero [Kc 8s]
Dealt to 2938d11a 
Dealt to 41c92275 
Dealt to ee7d25e9 
Dealt to 5322e146 
41c92275: folds
ee7d25e9: folds
5322e146: folds
eadf38fc: raises $0.08 to $0.13
Hero: folds
2938d11a: folds
Uncalled bet ($0.08) returned to eadf38fc
*** SHOWDOWN ***
eadf38fc collected $0.12 from pot
*** SUMMARY ***
Total pot $0.12 | Rake $0 | Jackpot $0 | Bingo $0 | Fortune $0 | Tax $0
Seat 1: eadf38fc (button) collected ($0.12)
Seat 2: Hero (small blind) folded before Flop
Seat 3: 2938d11a (big blind) folded before Flop
Seat 4: 41c92275 folded before Flop (didn't bet)
Seat 5: ee7d25e9 folded before Flop (didn't bet)
Seat 6: 5322e146 folded before Flop (didn't bet)


Poker Hand #RC3811181366: Hold'em No Limit ($0.02/$0.05) - 2025/08/16 12:48:43
Table 'RushAndCash846626' 6-max Seat #1 is the button
Seat 1: 1c212b17 ($5.48 in chips)
Seat 2: bc8cce8e ($5.13 in chips)
Seat 3: 15d53baa ($5.12 in chips)
Seat 4: 49ff58ff ($5.19 in chips)
Seat 5: e725801b ($5.54 in chips)
Seat 6: Hero ($12.51 in chips)
bc8cce8e: posts small blind $0.02
15d53baa: posts big blind $0.05
*** HOLE CARDS ***
Dealt to 1c212b17 
Dealt to bc8cce8e 
Dealt to 15d53baa 
Dealt to 49ff58ff 
Dealt to e725801b 
Dealt to Hero [6c Ts]
49ff58ff: folds
e725801b: raises $0.05 to $0.1
Hero: folds
1c212b17: folds
bc8cce8e: folds
15d53baa: folds
Uncalled bet ($0.05) returned to e725801b
*** SHOWDOWN ***
e725801b collected $0.12 from pot
*** SUMMARY ***
Total pot $0.12 | Rake $0 | Jackpot $0 | Bingo $0 | Fortune $0 | Tax $0
Seat 1: 1c212b17 (button) folded before Flop (didn't bet)
Seat 2: bc8cce8e (small blind) folded before Flop
Seat 3: 15d53baa (big blind) folded before Flop
Seat 4: 49ff58ff folded before Flop (didn't bet)
Seat 5: e725801b collected ($0.12)
Seat 6: Hero folded before Flop (didn't bet)


Poker Hand #RC3811181348: Hold'em No Limit ($0.02/$0.05) - 2025/08/16 12:48:39
Table 'RushAndCash846608' 6-max Seat #1 is the button
Seat 1: 73ff40f7 ($8.14 in chips)
Seat 2: 2938d11a ($5.18 in chips)
Seat 3: 7f00524f ($13.87 in chips)
Seat 4: ec79c726 ($5.61 in chips)
Seat 5: 6156df52 ($5 in chips)
Seat 6: Hero ($12.51 in chips)
2938d11a: posts small blind $0.02
7f00524f: posts big blind $0.05
*** HOLE CARDS ***
Dealt to 73ff40f7 
Dealt to 2938d11a 
Dealt to 7f00524f 
Dealt to ec79c726 
Dealt to 6156df52 
Dealt to Hero [8s Qh]
ec79c726: raises $0.05 to $0.1
6156df52: folds
Hero: folds
73ff40f7: folds
2938d11a: folds
7f00524f: calls $0.05
*** FLOP *** [Qc 5s 8h]
7f00524f: checks
ec79c726: checks
*** TURN *** [Qc 5s 8h] [Ts]
7f00524f: bets $0.17
ec79c726: folds
Uncalled bet ($0.17) returned to 7f00524f
*** SHOWDOWN ***
7f00524f collected $0.21 from pot
*** SUMMARY ***
Total pot $0.22 | Rake $0.01 | Jackpot $0 | Bingo $0 | Fortune $0 | Tax $0
Board [Qc 5s 8h Ts]
Seat 1: 73ff40f7 (button) folded before Flop (didn't bet)
Seat 2: 2938d11a (small blind) folded before Flop
Seat 3: 7f00524f (big blind) won ($0.21)
Seat 4: ec79c726 folded on the Turn
Seat 5: 6156df52 folded before Flop (didn't bet)
Seat 6: Hero folded before Flop (didn't bet)


Poker Hand #RC3811181323: Hold'em No Limit ($0.02/$0.05) - 2025/08/16 12:48:34
Table 'RushAndCash846583' 6-max Seat #1 is the button
Seat 1: fb990610 ($6.95 in chips)
Seat 2: dc6b3f2e ($12.45 in chips)
Seat 3: cd245036 ($8.14 in chips)
Seat 4: 917f3e19 ($10.01 in chips)
Seat 5: Hero ($12.51 in chips)
Seat 6: 7dcc690a ($5.26 in chips)
dc6b3f2e: posts small blind $0.02
cd245036: posts big blind $0.05
*** HOLE CARDS ***
Dealt to fb990610 
Dealt to dc6b3f2e 
Dealt to cd245036 
Dealt to 917f3e19 
Dealt to Hero [Js Tc]
Dealt to 7dcc690a 
917f3e19: folds
Hero: folds
7dcc690a: folds
fb990610: raises $0.06 to $0.11
dc6b3f2e: folds
cd245036: calls $0.06
*** FLOP *** [Kc 2c 4c]
cd245036: checks
fb990610: checks
*** TURN *** [Kc 2c 4c] [As]
cd245036: checks
fb990610: bets $0.45
cd245036: folds
Uncalled bet ($0.45) returned to fb990610
*** SHOWDOWN ***
fb990610 collected $0.23 from pot
*** SUMMARY ***
Total pot $0.24 | Rake $0.01 | Jackpot $0 | Bingo $0 | Fortune $0 | Tax $0
Board [Kc 2c 4c As]
Seat 1: fb990610 (button) won ($0.23)
Seat 2: dc6b3f2e (small blind) folded before Flop
Seat 3: cd245036 (big blind) folded on the Turn
Seat 4: 917f3e19 folded before Flop (didn't bet)
Seat 5: Hero folded before Flop (didn't bet)
Seat 6: 7dcc690a folded before Flop (didn't bet)


Poker Hand #RC3811181262: Hold'em No Limit ($0.02/$0.05) - 2025/08/16 12:48:19
Table 'RushAndCash846522' 6-max Seat #1 is the button
Seat 1: e93099b5 ($5.37 in chips)
Seat 2: Hero ($12.53 in chips)
Seat 3: 93c20826 ($6.73 in chips)
Seat 4: 5ea954db ($9.42 in chips)
Seat 5: 6c854e04 ($8.44 in chips)
Seat 6: 893981cc ($5.2 in chips)
Hero: posts small blind $0.02
93c20826: posts big blind $0.05
*** HOLE CARDS ***
Dealt to e93099b5 
Dealt to Hero [Jd 9c]
Dealt to 93c20826 
Dealt to 5ea954db 
Dealt to 6c854e04 
Dealt to 893981cc 
5ea954db: folds
6c854e04: folds
893981cc: raises $0.08 to $0.13
e93099b5: raises $0.25 to $0.38
Hero: folds
93c20826: folds
893981cc: raises $0.67 to $1.05
e93099b5: folds
Uncalled bet ($0.67) returned to 893981cc
*** SHOWDOWN ***
893981cc collected $0.79 from pot
*** SUMMARY ***
Total pot $0.83 | Rake $0.04 | Jackpot $0 | Bingo $0 | Fortune $0 | Tax $0
Seat 1: e93099b5 (button) folded before Flop
Seat 2: Hero (small blind) folded before Flop
Seat 3: 93c20826 (big blind) folded before Flop
Seat 4: 5ea954db folded before Flop (didn't bet)
Seat 5: 6c854e04 folded before Flop (didn't bet)
Seat 6: 893981cc collected ($0.79)


Poker Hand #RC3811181247: Hold'em No Limit ($0.02/$0.05) - 2025/08/16 12:48:16
Table 'RushAndCash846507' 6-max Seat #1 is the button
Seat 1: 5ea954db ($9.42 in chips)
Seat 2: 6c854e04 ($8.46 in chips)
Seat 3: b094641b ($5.05 in chips)
Seat 4: b3891cc0 ($14.17 in chips)
Seat 5: Hero ($12.53 in chips)
Seat 6: 15d53baa ($5.02 in chips)
6c854e04: posts small blind $0.02
b094641b: posts big blind $0.05
*** HOLE CARDS ***
Dealt to 5ea954db 
Dealt to 6c854e04 
Dealt to b094641b 
Dealt to b3891cc0 
Dealt to Hero [Ts 7c]
Dealt to 15d53baa 
b3891cc0: folds
Hero: folds
15d53baa: raises $0.06 to $0.11
5ea954db: folds
6c854e04: folds
b094641b: calls $0.06
*** FLOP *** [Ks 4c 9d]
b094641b: checks
15d53baa: bets $0.06
b094641b: folds
Uncalled bet ($0.06) returned to 15d53baa
*** SHOWDOWN ***
15d53baa collected $0.23 from pot
*** SUMMARY ***
Total pot $0.24 | Rake $0.01 | Jackpot $0 | Bingo $0 | Fortune $0 | Tax $0
Board [Ks 4c 9d]
Seat 1: 5ea954db (button) folded before Flop (didn't bet)
Seat 2: 6c854e04 (small blind) folded before Flop
Seat 3: b094641b (big blind) folded on the Flop
Seat 4: b3891cc0 folded before Flop (didn't bet)
Seat 5: Hero folded before Flop (didn't bet)
Seat 6: 15d53baa won ($0.23)


Poker Hand #RC3811181221: Hold'em No Limit ($0.02/$0.05) - 2025/08/16 12:48:10
Table 'RushAndCash846481' 6-max Seat #1 is the button
Seat 1: Hero ($12.53 in chips)
Seat 2: cb8bfe18 ($9.65 in chips)
Seat 3: 9adeb954 ($5 in chips)
Seat 4: 1c015352 ($5.02 in chips)
Seat 5: 7f00524f ($13.82 in chips)
Seat 6: 188a67f6 ($5 in chips)
cb8bfe18: posts small blind $0.02
9adeb954: posts big blind $0.05
*** HOLE CARDS ***
Dealt to Hero [4c 3s]
Dealt to cb8bfe18 
Dealt to 9adeb954 
Dealt to 1c015352 
Dealt to 7f00524f 
Dealt to 188a67f6 
1c015352: folds
7f00524f: folds
188a67f6: folds
Hero: folds
cb8bfe18: raises $0.1 to $0.15
9adeb954: calls $0.1
*** FLOP *** [6d Kc Ks]
cb8bfe18: checks
9adeb954: bets $0.12
cb8bfe18: folds
Uncalled bet ($0.12) returned to 9adeb954
*** SHOWDOWN ***
9adeb954 collected $0.29 from pot
*** SUMMARY ***
Total pot $0.3 | Rake $0.01 | Jackpot $0 | Bingo $0 | Fortune $0 | Tax $0
Board [6d Kc Ks]
Seat 1: Hero (button) folded before Flop (didn't bet)
Seat 2: cb8bfe18 (small blind) folded on the Flop
Seat 3: 9adeb954 (big blind) won ($0.29)
Seat 4: 1c015352 folded before Flop (didn't bet)
Seat 5: 7f00524f folded before Flop (didn't bet)
Seat 6: 188a67f6 folded before Flop (didn't bet)


Poker Hand #RC3811181168: Hold'em No Limit ($0.02/$0.05) - 2025/08/16 12:47:56
Table 'RushAndCash846428' 6-max Seat #1 is the button
Seat 1: 17d1d965 ($5 in chips)
Seat 2: 2e3731d0 ($8.61 in chips)
Seat 3: Hero ($12.58 in chips)
Seat 4: 3ef86869 ($4.91 in chips)
Seat 5: 188a67f6 ($5 in chips)
Seat 6: ee3c195 ($9.29 in chips)
2e3731d0: posts small blind $0.02
Hero: posts big blind $0.05
*** HOLE CARDS ***
Dealt to 17d1d965 
Dealt to 2e3731d0 
Dealt to Hero [2d Qs]
Dealt to 3ef86869 
Dealt to 188a67f6 
Dealt to ee3c195 
3ef86869: folds
188a67f6: folds
ee3c195: raises $0.05 to $0.1
17d1d965: folds
2e3731d0: folds
Hero: folds
Uncalled bet ($0.05) returned to ee3c195
*** SHOWDOWN ***
ee3c195 collected $0.12 from pot
*** SUMMARY ***
Total pot $0.12 | Rake $0 | Jackpot $0 | Bingo $0 | Fortune $0 | Tax $0
Seat 1: 17d1d965 (button) folded before Flop (didn't bet)
Seat 2: 2e3731d0 (small blind) folded before Flop
Seat 3: Hero (big blind) folded before Flop
Seat 4: 3ef86869 folded before Flop (didn't bet)
Seat 5: 188a67f6 folded before Flop (didn't bet)
Seat 6: ee3c195 collected ($0.12)


Poker Hand #RC3811181154: Hold'em No Limit ($0.02/$0.05) - 2025/08/16 12:47:53
Table 'RushAndCash846414' 6-max Seat #1 is the button
Seat 1: ff1232b4 ($22.61 in chips)
Seat 2: bda04d60 ($6.34 in chips)
Seat 3: 3600837f ($13.68 in chips)
Seat 4: 767ec7ee ($5.54 in chips)
Seat 5: e93099b5 ($5.37 in chips)
Seat 6: Hero ($12.58 in chips)
bda04d60: posts small blind $0.02
3600837f: posts big blind $0.05
*** HOLE CARDS ***
Dealt to ff1232b4 
Dealt to bda04d60 
Dealt to 3600837f 
Dealt to 767ec7ee 
Dealt to e93099b5 
Dealt to Hero [4h 8d]
767ec7ee: folds
e93099b5: folds
Hero: folds
ff1232b4: folds
bda04d60: raises $0.1 to $0.15
3600837f: folds
Uncalled bet ($0.1) returned to bda04d60
*** SHOWDOWN ***
bda04d60 collected $0.1 from pot
*** SUMMARY ***
Total pot $0.1 | Rake $0 | Jackpot $0 | Bingo $0 | Fortune $0 | Tax $0
Seat 1: ff1232b4 (button) folded before Flop (didn't bet)
Seat 2: bda04d60 (small blind) collected ($0.1)
Seat 3: 3600837f (big blind) folded before Flop
Seat 4: 767ec7ee folded before Flop (didn't bet)
Seat 5: e93099b5 folded before Flop (didn't bet)
Seat 6: Hero folded before Flop (didn't bet)


Poker Hand #RC3811181130: Hold'em No Limit ($0.02/$0.05) - 2025/08/16 12:47:47
Table 'RushAndCash846390' 6-max Seat #1 is the button
Seat 1: 8930d038 ($5 in chips)
Seat 2: Hero ($12.6 in chips)
Seat 3: 17b3fdb6 ($5.29 in chips)
Seat 4: b6adb304 ($7.99 in chips)
Seat 5: 1b0eb398 ($5.24 in chips)
Seat 6: ab4c77fd ($5.9 in chips)
Hero: posts small blind $0.02
17b3fdb6: posts big blind $0.05
*** HOLE CARDS ***
Dealt to 8930d038 
Dealt to Hero [3h Qs]
Dealt to 17b3fdb6 
Dealt to b6adb304 
Dealt to 1b0eb398 
Dealt to ab4c77fd 
b6adb304: folds
1b0eb398: folds
ab4c77fd: folds
8930d038: raises $0.07 to $0.12
Hero: folds
17b3fdb6: folds
Uncalled bet ($0.07) returned to 8930d038
*** SHOWDOWN ***
8930d038 collected $0.12 from pot
*** SUMMARY ***
Total pot $0.12 | Rake $0 | Jackpot $0 | Bingo $0 | Fortune $0 | Tax $0
Seat 1: 8930d038 (button) collected ($0.12)
Seat 2: Hero (small blind) folded before Flop
Seat 3: 17b3fdb6 (big blind) folded before Flop
Seat 4: b6adb304 folded before Flop (didn't bet)
Seat 5: 1b0eb398 folded before Flop (didn't bet)
Seat 6: ab4c77fd folded before Flop (didn't bet)


Poker Hand #RC3811181115: Hold'em No Limit ($0.02/$0.05) - 2025/08/16 12:47:44
Table 'RushAndCash846375' 6-max Seat #1 is the button
Seat 1: 856a263b ($9.13 in chips)
Seat 2: cfe77291 ($1.86 in chips)
Seat 3: c58b8609 ($11.67 in chips)
Seat 4: 25a5e771 ($10.95 in chips)
Seat 5: Hero ($12.6 in chips)
Seat 6: bc095270 ($5.72 in chips)
cfe77291: posts small blind $0.02
c58b8609: posts big blind $0.05
*** HOLE CARDS ***
Dealt to 856a263b 
Dealt to cfe77291 
Dealt to c58b8609 
Dealt to 25a5e771 
Dealt to Hero [3c 5d]
Dealt to bc095270 
25a5e771: folds
Hero: folds
bc095270: folds
856a263b: raises $0.05 to $0.1
cfe77291: folds
c58b8609: calls $0.05
*** FLOP *** [8h 4d 7d]
c58b8609: checks
856a263b: bets $0.11
c58b8609: calls $0.11
*** TURN *** [8h 4d 7d] [2d]
c58b8609: checks
856a263b: checks
*** RIVER *** [8h 4d 7d 2d] [Jc]
c58b8609: bets $0.15
856a263b: folds
Uncalled bet ($0.15) returned to c58b8609
*** SHOWDOWN ***
c58b8609 collected $0.42 from pot
*** SUMMARY ***
Total pot $0.44 | Rake $0.02 | Jackpot $0 | Bingo $0 | Fortune $0 | Tax $0
Board [8h 4d 7d 2d Jc]
Seat 1: 856a263b (button) folded on the River
Seat 2: cfe77291 (small blind) folded before Flop
Seat 3: c58b8609 (big blind) won ($0.42)
Seat 4: 25a5e771 folded before Flop (didn't bet)
Seat 5: Hero folded before Flop (didn't bet)
Seat 6: bc095270 folded before Flop (didn't bet)


Poker Hand #RC3811181062: Hold'em No Limit ($0.02/$0.05) - 2025/08/16 12:47:31
Table 'RushAndCash846322' 6-max Seat #1 is the button
Seat 1: Hero ($12.53 in chips)
Seat 2: b827826f ($5 in chips)
Seat 3: f58c1fbe ($6.89 in chips)
Seat 4: cfe77291 ($1.84 in chips)
Seat 5: f8911f74 ($5.18 in chips)
Seat 6: 6b0663c4 ($5.11 in chips)
b827826f: posts small blind $0.02
f58c1fbe: posts big blind $0.05
*** HOLE CARDS ***
Dealt to Hero [Qs Kd]
Dealt to b827826f 
Dealt to f58c1fbe 
Dealt to cfe77291 
Dealt to f8911f74 
Dealt to 6b0663c4 
cfe77291: folds
f8911f74: folds
6b0663c4: folds
Hero: raises $0.05 to $0.1
b827826f: folds
f58c1fbe: folds
Uncalled bet ($0.05) returned to Hero
*** SHOWDOWN ***
Hero collected $0.12 from pot
*** SUMMARY ***
Total pot $0.12 | Rake $0 | Jackpot $0 | Bingo $0 | Fortune $0 | Tax $0
Seat 1: Hero (button) collected ($0.12)
Seat 2: b827826f (small blind) folded before Flop
Seat 3: f58c1fbe (big blind) folded before Flop
Seat 4: cfe77291 folded before Flop (didn't bet)
Seat 5: f8911f74 folded before Flop (didn't bet)
Seat 6: 6b0663c4 folded before Flop (didn't bet)


Poker Hand #RC3811180749: Hold'em No Limit ($0.02/$0.05) - 2025/08/16 12:46:19
Table 'RushAndCash846009' 6-max Seat #1 is the button
Seat 1: be24990e ($5.23 in chips)
Seat 2: e0547449 ($6.32 in chips)
Seat 3: Hero ($14.25 in chips)
Seat 4: d59f2f93 ($5.48 in chips)
Seat 5: ae4775f8 ($5.74 in chips)
Seat 6: 372c0091 ($2 in chips)
e0547449: posts small blind $0.02
Hero: posts big blind $0.05
*** HOLE CARDS ***
Dealt to be24990e 
Dealt to e0547449 
Dealt to Hero [8h Qh]
Dealt to d59f2f93 
Dealt to ae4775f8 
Dealt to 372c0091 
d59f2f93: raises $0.08 to $0.13
ae4775f8: folds
372c0091: folds
be24990e: folds
e0547449: folds
Hero: calls $0.08
*** FLOP *** [6h As Jh]
Hero: bets $0.22
d59f2f93: calls $0.22
*** TURN *** [6h As Jh] [9s]
Hero: bets $0.52
d59f2f93: calls $0.52
*** RIVER *** [6h As Jh 9s] [Jd]
Hero: bets $0.85
d59f2f93: calls $0.85
Hero: shows [8h Qh] (a pair of Jacks)
d59f2f93: shows [6d Ad] (two pair, Aces and Jacks)
*** SHOWDOWN ***
d59f2f93 collected $3.24 from pot
*** SUMMARY ***
Total pot $3.46 | Rake $0.15 | Jackpot $0.07 | Bingo $0 | Fortune $0 | Tax $0
Board [6h As Jh 9s Jd]
Seat 1: be24990e (button) folded before Flop (didn't bet)
Seat 2: e0547449 (small blind) folded before Flop
Seat 3: Hero (big blind) showed [8h Qh] and lost with a pair of Jacks
Seat 4: d59f2f93 showed [6d Ad] and won ($3.24) with two pair, Aces and Jacks
Seat 5: ae4775f8 folded before Flop (didn't bet)
Seat 6: 372c0091 folded before Flop (didn't bet)


Poker Hand #RC3811180661: Hold'em No Limit ($0.02/$0.05) - 2025/08/16 12:45:58
Table 'RushAndCash845921' 6-max Seat #1 is the button
Seat 1: 916c17b0 ($5 in chips)
Seat 2: 7dcc690a ($5.72 in chips)
Seat 3: 228a7ffe ($5.06 in chips)
Seat 4: Hero ($14.25 in chips)
Seat 5: c58b8609 ($11.98 in chips)
Seat 6: 10398182 ($5.23 in chips)
7dcc690a: posts small blind $0.02
228a7ffe: posts big blind $0.05
*** HOLE CARDS ***
Dealt to 916c17b0 
Dealt to 7dcc690a 
Dealt to 228a7ffe 
Dealt to Hero [Qd 8d]
Dealt to c58b8609 
Dealt to 10398182 
Hero: folds
c58b8609: folds
10398182: folds
916c17b0: folds
7dcc690a: folds
Uncalled bet ($0.03) returned to 228a7ffe
*** SHOWDOWN ***
228a7ffe collected $0.04 from pot
*** SUMMARY ***
Total pot $0.04 | Rake $0 | Jackpot $0 | Bingo $0 | Fortune $0 | Tax $0
Seat 1: 916c17b0 (button) folded before Flop (didn't bet)
Seat 2: 7dcc690a (small blind) folded before Flop
Seat 3: 228a7ffe (big blind) collected ($0.04)
Seat 4: Hero folded before Flop (didn't bet)
Seat 5: c58b8609 folded before Flop (didn't bet)
Seat 6: 10398182 folded before Flop (didn't bet)


Poker Hand #RC3811180647: Hold'em No Limit ($0.02/$0.05) - 2025/08/16 12:45:55
Table 'RushAndCash845907' 6-max Seat #1 is the button
Seat 1: 15d53baa ($5 in chips)
Seat 2: f844f19 ($6.47 in chips)
Seat 3: 7512b24f ($10.16 in chips)
Seat 4: 6ae471b6 ($11.96 in chips)
Seat 5: bb832e44 ($7.15 in chips)
Seat 6: Hero ($14.25 in chips)
f844f19: posts small blind $0.02
7512b24f: posts big blind $0.05
*** HOLE CARDS ***
Dealt to 15d53baa 
Dealt to f844f19 
Dealt to 7512b24f 
Dealt to 6ae471b6 
Dealt to bb832e44 
Dealt to Hero [5c Td]
6ae471b6: folds
bb832e44: folds
Hero: folds
15d53baa: folds
f844f19: folds
Uncalled bet ($0.03) returned to 7512b24f
*** SHOWDOWN ***
7512b24f collected $0.04 from pot
*** SUMMARY ***
Total pot $0.04 | Rake $0 | Jackpot $0 | Bingo $0 | Fortune $0 | Tax $0
Seat 1: 15d53baa (button) folded before Flop (didn't bet)
Seat 2: f844f19 (small blind) folded before Flop
Seat 3: 7512b24f (big blind) collected ($0.04)
Seat 4: 6ae471b6 folded before Flop (didn't bet)
Seat 5: bb832e44 folded before Flop (didn't bet)
Seat 6: Hero folded before Flop (didn't bet)


Poker Hand #RC3811180634: Hold'em No Limit ($0.02/$0.05) - 2025/08/16 12:45:52
Table 'RushAndCash845894' 6-max Seat #1 is the button
Seat 1: 8c9e3686 ($5 in chips)
Seat 2: 210eab90 ($4.84 in chips)
Seat 3: 495abc44 ($5 in chips)
Seat 4: 6ae471b6 ($11.96 in chips)
Seat 5: Hero ($14.25 in chips)
Seat 6: 15d53baa ($5 in chips)
210eab90: posts small blind $0.02
495abc44: posts big blind $0.05
*** HOLE CARDS ***
Dealt to 8c9e3686 
Dealt to 210eab90 
Dealt to 495abc44 
Dealt to 6ae471b6 
Dealt to Hero [6c Qd]
Dealt to 15d53baa 
6ae471b6: folds
Hero: folds
15d53baa: folds
8c9e3686: folds
210eab90: folds
Uncalled bet ($0.03) returned to 495abc44
*** SHOWDOWN ***
495abc44 collected $0.04 from pot
*** SUMMARY ***
Total pot $0.04 | Rake $0 | Jackpot $0 | Bingo $0 | Fortune $0 | Tax $0
Seat 1: 8c9e3686 (button) folded before Flop (didn't bet)
Seat 2: 210eab90 (small blind) folded before Flop
Seat 3: 495abc44 (big blind) collected ($0.04)
Seat 4: 6ae471b6 folded before Flop (didn't bet)
Seat 5: Hero folded before Flop (didn't bet)
Seat 6: 15d53baa folded before Flop (didn't bet)


Poker Hand #RC3811180618: Hold'em No Limit ($0.02/$0.05) - 2025/08/16 12:45:48
Table 'RushAndCash845878' 6-max Seat #1 is the button
Seat 1: 910e3363 ($10.7 in chips)
Seat 2: Hero ($14.27 in chips)
Seat 3: b094641b ($5 in chips)
Seat 4: 374e2442 ($4.74 in chips)
Seat 5: 3b76f692 ($5.23 in chips)
Seat 6: 922b0c3 ($11.69 in chips)
Hero: posts small blind $0.02
b094641b: posts big blind $0.05
*** HOLE CARDS ***
Dealt to 910e3363 
Dealt to Hero [6c Ks]
Dealt to b094641b 
Dealt to 374e2442 
Dealt to 3b76f692 
Dealt to 922b0c3 
374e2442: folds
3b76f692: folds
922b0c3: folds
910e3363: folds
Hero: folds
Uncalled bet ($0.03) returned to b094641b
*** SHOWDOWN ***
b094641b collected $0.04 from pot
*** SUMMARY ***
Total pot $0.04 | Rake $0 | Jackpot $0 | Bingo $0 | Fortune $0 | Tax $0
Seat 1: 910e3363 (button) folded before Flop (didn't bet)
Seat 2: Hero (small blind) folded before Flop
Seat 3: b094641b (big blind) collected ($0.04)
Seat 4: 374e2442 folded before Flop (didn't bet)
Seat 5: 3b76f692 folded before Flop (didn't bet)
Seat 6: 922b0c3 folded before Flop (didn't bet)


Poker Hand #RC3811180406: Hold'em No Limit ($0.02/$0.05) - 2025/08/16 12:44:58
Table 'RushAndCash845666' 6-max Seat #1 is the button
Seat 1: Hero ($14.38 in chips)
Seat 2: 2621331f ($3.42 in chips)
Seat 3: 9dcd69d5 ($6.18 in chips)
Seat 4: dda95519 ($5.32 in chips)
Seat 5: 3b76f692 ($5 in chips)
Seat 6: 887726f1 ($4.93 in chips)
2621331f: posts small blind $0.02
9dcd69d5: posts big blind $0.05
*** HOLE CARDS ***
Dealt to Hero [Ah Jh]
Dealt to 2621331f 
Dealt to 9dcd69d5 
Dealt to dda95519 
Dealt to 3b76f692 
Dealt to 887726f1 
dda95519: folds
3b76f692: raises $0.06 to $0.11
887726f1: folds
Hero: calls $0.11
2621331f: folds
9dcd69d5: calls $0.06
*** FLOP *** [3c Qd 8s]
9dcd69d5: checks
3b76f692: bets $0.12
Hero: folds
9dcd69d5: folds
Uncalled bet ($0.12) returned to 3b76f692
*** SHOWDOWN ***
3b76f692 collected $0.34 from pot
*** SUMMARY ***
Total pot $0.35 | Rake $0.01 | Jackpot $0 | Bingo $0 | Fortune $0 | Tax $0
Board [3c Qd 8s]
Seat 1: Hero (button) folded on the Flop
Seat 2: 2621331f (small blind) folded before Flop
Seat 3: 9dcd69d5 (big blind) folded on the Flop
Seat 4: dda95519 folded before Flop (didn't bet)
Seat 5: 3b76f692 won ($0.34)
Seat 6: 887726f1 folded before Flop (didn't bet)


Poker Hand #RC3811180105: Hold'em No Limit ($0.02/$0.05) - 2025/08/16 12:43:45
Table 'RushAndCash845365' 6-max Seat #1 is the button
Seat 1: 2621331f ($3.69 in chips)
Seat 2: cec2a08b ($4.54 in chips)
Seat 3: Hero ($14.11 in chips)
Seat 4: e6a5b6ba ($12.1 in chips)
Seat 5: aa60f413 ($9.87 in chips)
Seat 6: a92ab1e1 ($2 in chips)
cec2a08b: posts small blind $0.02
Hero: posts big blind $0.05
*** HOLE CARDS ***
Dealt to 2621331f 
Dealt to cec2a08b 
Dealt to Hero [7d Jd]
Dealt to e6a5b6ba 
Dealt to aa60f413 
Dealt to a92ab1e1 
e6a5b6ba: folds
aa60f413: folds
a92ab1e1: folds
2621331f: raises $0.05 to $0.1
cec2a08b: folds
Hero: calls $0.05
*** FLOP *** [7c 6c 9h]
Hero: checks
2621331f: checks
*** TURN *** [7c 6c 9h] [3h]
Hero: checks
2621331f: bets $0.17
Hero: calls $0.17
*** RIVER *** [7c 6c 9h 3h] [Js]
Hero: bets $0.14
2621331f: folds
Uncalled bet ($0.14) returned to Hero
*** SHOWDOWN ***
Hero collected $0.54 from pot
*** SUMMARY ***
Total pot $0.56 | Rake $0.02 | Jackpot $0 | Bingo $0 | Fortune $0 | Tax $0
Board [7c 6c 9h 3h Js]
Seat 1: 2621331f (button) folded on the River
Seat 2: cec2a08b (small blind) folded before Flop
Seat 3: Hero (big blind) won ($0.54)
Seat 4: e6a5b6ba folded before Flop (didn't bet)
Seat 5: aa60f413 folded before Flop (didn't bet)
Seat 6: a92ab1e1 folded before Flop (didn't bet)


Poker Hand #RC3811180080: Hold'em No Limit ($0.02/$0.05) - 2025/08/16 12:43:40
Table 'RushAndCash845340' 6-max Seat #1 is the button
Seat 1: 5ea954db ($8.24 in chips)
Seat 2: 2684d7a4 ($4.72 in chips)
Seat 3: 36ce12e3 ($6.71 in chips)
Seat 4: Hero ($14.11 in chips)
Seat 5: 9a72c3d ($4.16 in chips)
Seat 6: f500d2b4 ($1.89 in chips)
2684d7a4: posts small blind $0.02
36ce12e3: posts big blind $0.05
*** HOLE CARDS ***
Dealt to 5ea954db 
Dealt to 2684d7a4 
Dealt to 36ce12e3 
Dealt to Hero [Kd 9h]
Dealt to 9a72c3d 
Dealt to f500d2b4 
Hero: folds
9a72c3d: folds
f500d2b4: folds
5ea954db: folds
2684d7a4: raises $0.05 to $0.1
36ce12e3: folds
Uncalled bet ($0.05) returned to 2684d7a4
*** SHOWDOWN ***
2684d7a4 collected $0.1 from pot
*** SUMMARY ***
Total pot $0.1 | Rake $0 | Jackpot $0 | Bingo $0 | Fortune $0 | Tax $0
Seat 1: 5ea954db (button) folded before Flop (didn't bet)
Seat 2: 2684d7a4 (small blind) collected ($0.1)
Seat 3: 36ce12e3 (big blind) folded before Flop
Seat 4: Hero folded before Flop (didn't bet)
Seat 5: 9a72c3d folded before Flop (didn't bet)
Seat 6: f500d2b4 folded before Flop (didn't bet)


Poker Hand #RC3811180051: Hold'em No Limit ($0.02/$0.05) - 2025/08/16 12:43:34
Table 'RushAndCash845311' 6-max Seat #1 is the button
Seat 1: Hero ($14.11 in chips)
Seat 2: d876bedd ($6.31 in chips)
Seat 3: f4c2b883 ($5.34 in chips)
Seat 4: 1ea904d2 ($9.9 in chips)
Seat 5: cec2a08b ($4.59 in chips)
Seat 6: b3952c8b ($10.39 in chips)
d876bedd: posts small blind $0.02
f4c2b883: posts big blind $0.05
*** HOLE CARDS ***
Dealt to Hero [Js 3h]
Dealt to d876bedd 
Dealt to f4c2b883 
Dealt to 1ea904d2 
Dealt to cec2a08b 
Dealt to b3952c8b 
1ea904d2: folds
cec2a08b: folds
b3952c8b: folds
Hero: folds
d876bedd: folds
Uncalled bet ($0.03) returned to f4c2b883
*** SHOWDOWN ***
f4c2b883 collected $0.04 from pot
*** SUMMARY ***
Total pot $0.04 | Rake $0 | Jackpot $0 | Bingo $0 | Fortune $0 | Tax $0
Seat 1: Hero (button) folded before Flop (didn't bet)
Seat 2: d876bedd (small blind) folded before Flop
Seat 3: f4c2b883 (big blind) collected ($0.04)
Seat 4: 1ea904d2 folded before Flop (didn't bet)
Seat 5: cec2a08b folded before Flop (didn't bet)
Seat 6: b3952c8b folded before Flop (didn't bet)


Poker Hand #RC3811180006: Hold'em No Limit ($0.02/$0.05) - 2025/08/16 12:43:23
Table 'RushAndCash845266' 6-max Seat #1 is the button
Seat 1: d1763fe4 ($5.43 in chips)
Seat 2: Hero ($14.13 in chips)
Seat 3: 56099b06 ($2.78 in chips)
Seat 4: abe0c2b2 ($5.65 in chips)
Seat 5: 16962fac ($5 in chips)
Seat 6: 37c2e948 ($15.1 in chips)
Hero: posts small blind $0.02
56099b06: posts big blind $0.05
*** HOLE CARDS ***
Dealt to d1763fe4 
Dealt to Hero [Qc 7s]
Dealt to 56099b06 
Dealt to abe0c2b2 
Dealt to 16962fac 
Dealt to 37c2e948 
abe0c2b2: folds
16962fac: folds
37c2e948: folds
d1763fe4: folds
Hero: folds
Uncalled bet ($0.03) returned to 56099b06
*** SHOWDOWN ***
56099b06 collected $0.04 from pot
*** SUMMARY ***
Total pot $0.04 | Rake $0 | Jackpot $0 | Bingo $0 | Fortune $0 | Tax $0
Seat 1: d1763fe4 (button) folded before Flop (didn't bet)
Seat 2: Hero (small blind) folded before Flop
Seat 3: 56099b06 (big blind) collected ($0.04)
Seat 4: abe0c2b2 folded before Flop (didn't bet)
Seat 5: 16962fac folded before Flop (didn't bet)
Seat 6: 37c2e948 folded before Flop (didn't bet)


Poker Hand #RC3811179688: Hold'em No Limit ($0.02/$0.05) - 2025/08/16 12:42:09
Table 'RushAndCash844948' 6-max Seat #1 is the button
Seat 1: a13cb32e ($6.72 in chips)
Seat 2: 3f90ff07 ($8.56 in chips)
Seat 3: Hero ($14.28 in chips)
Seat 4: d1763fe4 ($5.27 in chips)
Seat 5: abe0c2b2 ($5.38 in chips)
Seat 6: e0547449 ($7.1 in chips)
3f90ff07: posts small blind $0.02
Hero: posts big blind $0.05
*** HOLE CARDS ***
Dealt to a13cb32e 
Dealt to 3f90ff07 
Dealt to Hero [Ah 3s]
Dealt to d1763fe4 
Dealt to abe0c2b2 
Dealt to e0547449 
d1763fe4: raises $0.05 to $0.1
abe0c2b2: folds
e0547449: folds
a13cb32e: folds
3f90ff07: folds
Hero: calls $0.05
*** FLOP *** [5h 8d 7h]
Hero: checks
d1763fe4: checks
*** TURN *** [5h 8d 7h] [Td]
Hero: bets $0.05
d1763fe4: calls $0.05
*** RIVER *** [5h 8d 7h Td] [Jc]
Hero: checks
d1763fe4: checks
Hero: shows [Ah 3s] (Ace high)
d1763fe4: shows [Qc Qd] (a pair of Queens)
*** SHOWDOWN ***
d1763fe4 collected $0.31 from pot
*** SUMMARY ***
Total pot $0.32 | Rake $0.01 | Jackpot $0 | Bingo $0 | Fortune $0 | Tax $0
Board [5h 8d 7h Td Jc]
Seat 1: a13cb32e (button) folded before Flop (didn't bet)
Seat 2: 3f90ff07 (small blind) folded before Flop
Seat 3: Hero (big blind) showed [Ah 3s] and lost with Ace high
Seat 4: d1763fe4 showed [Qc Qd] and won ($0.31) with a pair of Queens
Seat 5: abe0c2b2 folded before Flop (didn't bet)
Seat 6: e0547449 folded before Flop (didn't bet)


Poker Hand #RC3811179667: Hold'em No Limit ($0.02/$0.05) - 2025/08/16 12:42:05
Table 'RushAndCash844927' 6-max Seat #1 is the button
Seat 1: bea85404 ($5.09 in chips)
Seat 2: 6960a5d8 ($5 in chips)
Seat 3: cec2a08b ($4.7 in chips)
Seat 4: Hero ($14.28 in chips)
Seat 5: 4ff5126a ($6.32 in chips)
Seat 6: 111c5398 ($10.82 in chips)
6960a5d8: posts small blind $0.02
cec2a08b: posts big blind $0.05
*** HOLE CARDS ***
Dealt to bea85404 
Dealt to 6960a5d8 
Dealt to cec2a08b 
Dealt to Hero [5d 6c]
Dealt to 4ff5126a 
Dealt to 111c5398 
Hero: folds
4ff5126a: folds
111c5398: folds
bea85404: folds
6960a5d8: folds
Uncalled bet ($0.03) returned to cec2a08b
*** SHOWDOWN ***
cec2a08b collected $0.04 from pot
*** SUMMARY ***
Total pot $0.04 | Rake $0 | Jackpot $0 | Bingo $0 | Fortune $0 | Tax $0
Seat 1: bea85404 (button) folded before Flop (didn't bet)
Seat 2: 6960a5d8 (small blind) folded before Flop
Seat 3: cec2a08b (big blind) collected ($0.04)
Seat 4: Hero folded before Flop (didn't bet)
Seat 5: 4ff5126a folded before Flop (didn't bet)
Seat 6: 111c5398 folded before Flop (didn't bet)


Poker Hand #RC3811179653: Hold'em No Limit ($0.02/$0.05) - 2025/08/16 12:42:01
Table 'RushAndCash844913' 6-max Seat #1 is the button
Seat 1: 6e4f3d57 ($5.65 in chips)
Seat 2: 1a55751a ($8.63 in chips)
Seat 3: aa60f413 ($9.58 in chips)
Seat 4: 9abc9d87 ($5.14 in chips)
Seat 5: 154c971f ($1.09 in chips)
Seat 6: Hero ($14.28 in chips)
1a55751a: posts small blind $0.02
aa60f413: posts big blind $0.05
*** HOLE CARDS ***
Dealt to 6e4f3d57 
Dealt to 1a55751a 
Dealt to aa60f413 
Dealt to 9abc9d87 
Dealt to 154c971f 
Dealt to Hero [5s 4s]
9abc9d87: folds
154c971f: folds
Hero: folds
6e4f3d57: raises $0.05 to $0.1
1a55751a: folds
aa60f413: folds
Uncalled bet ($0.05) returned to 6e4f3d57
*** SHOWDOWN ***
6e4f3d57 collected $0.12 from pot
*** SUMMARY ***
Total pot $0.12 | Rake $0 | Jackpot $0 | Bingo $0 | Fortune $0 | Tax $0
Seat 1: 6e4f3d57 (button) collected ($0.12)
Seat 2: 1a55751a (small blind) folded before Flop
Seat 3: aa60f413 (big blind) folded before Flop
Seat 4: 9abc9d87 folded before Flop (didn't bet)
Seat 5: 154c971f folded before Flop (didn't bet)
Seat 6: Hero folded before Flop (didn't bet)


Poker Hand #RC3811179640: Hold'em No Limit ($0.02/$0.05) - 2025/08/16 12:41:58
Table 'RushAndCash844900' 6-max Seat #1 is the button
Seat 1: 2684d7a4 ($4.96 in chips)
Seat 2: f844f19 ($6.95 in chips)
Seat 3: 1a55751a ($8.68 in chips)
Seat 4: 11fbebb5 ($8.75 in chips)
Seat 5: d92261bd ($1.34 in chips)
Seat 6: Hero ($14.28 in chips)
f844f19: posts small blind $0.02
1a55751a: posts big blind $0.05
*** HOLE CARDS ***
Dealt to 2684d7a4 
Dealt to f844f19 
Dealt to 1a55751a 
Dealt to 11fbebb5 
Dealt to d92261bd 
Dealt to Hero [7h 5d]
11fbebb5: raises $0.08 to $0.13
d92261bd: calls $0.13
Hero: folds
2684d7a4: folds
f844f19: folds
1a55751a: folds
*** FLOP *** [8s Qs Tc]
11fbebb5: checks
d92261bd: bets $0.15
11fbebb5: folds
Uncalled bet ($0.15) returned to d92261bd
*** SHOWDOWN ***
d92261bd collected $0.32 from pot
*** SUMMARY ***
Total pot $0.33 | Rake $0.01 | Jackpot $0 | Bingo $0 | Fortune $0 | Tax $0
Board [8s Qs Tc]
Seat 1: 2684d7a4 (button) folded before Flop (didn't bet)
Seat 2: f844f19 (small blind) folded before Flop
Seat 3: 1a55751a (big blind) folded before Flop
Seat 4: 11fbebb5 folded on the Flop
Seat 5: d92261bd won ($0.32)
Seat 6: Hero folded before Flop (didn't bet)


Poker Hand #RC3811179627: Hold'em No Limit ($0.02/$0.05) - 2025/08/16 12:41:54
Table 'RushAndCash844887' 6-max Seat #1 is the button
Seat 1: e6780e8f ($10.94 in chips)
Seat 2: 25e7bbe7 ($4.46 in chips)
Seat 3: 83c58815 ($5.51 in chips)
Seat 4: 36ce12e3 ($7.06 in chips)
Seat 5: Hero ($14.28 in chips)
Seat 6: f4ade85 ($6.3 in chips)
25e7bbe7: posts small blind $0.02
83c58815: posts big blind $0.05
*** HOLE CARDS ***
Dealt to e6780e8f 
Dealt to 25e7bbe7 
Dealt to 83c58815 
Dealt to 36ce12e3 
Dealt to Hero [3d 4h]
Dealt to f4ade85 
36ce12e3: raises $0.05 to $0.1
Hero: folds
f4ade85: raises $0.21 to $0.31
e6780e8f: folds
25e7bbe7: folds
83c58815: folds
36ce12e3: folds
Uncalled bet ($0.21) returned to f4ade85
*** SHOWDOWN ***
f4ade85 collected $0.26 from pot
*** SUMMARY ***
Total pot $0.27 | Rake $0.01 | Jackpot $0 | Bingo $0 | Fortune $0 | Tax $0
Seat 1: e6780e8f (button) folded before Flop (didn't bet)
Seat 2: 25e7bbe7 (small blind) folded before Flop
Seat 3: 83c58815 (big blind) folded before Flop
Seat 4: 36ce12e3 folded before Flop
Seat 5: Hero folded before Flop (didn't bet)
Seat 6: f4ade85 collected ($0.26)


Poker Hand #RC3811179591: Hold'em No Limit ($0.02/$0.05) - 2025/08/16 12:41:46
Table 'RushAndCash844851' 6-max Seat #1 is the button
Seat 1: Hero ($14.28 in chips)
Seat 2: 4ff5126a ($6.27 in chips)
Seat 3: 56099b06 ($2.88 in chips)
Seat 4: 3bf36a6c ($5 in chips)
Seat 5: 17b3fdb6 ($5.53 in chips)
Seat 6: e725801b ($5 in chips)
4ff5126a: posts small blind $0.02
56099b06: posts big blind $0.05
*** HOLE CARDS ***
Dealt to Hero [Qc 2s]
Dealt to 4ff5126a 
Dealt to 56099b06 
Dealt to 3bf36a6c 
Dealt to 17b3fdb6 
Dealt to e725801b 
3bf36a6c: folds
17b3fdb6: folds
e725801b: folds
Hero: folds
4ff5126a: raises $0.07 to $0.12
56099b06: folds
Uncalled bet ($0.07) returned to 4ff5126a
*** SHOWDOWN ***
4ff5126a collected $0.1 from pot
*** SUMMARY ***
Total pot $0.1 | Rake $0 | Jackpot $0 | Bingo $0 | Fortune $0 | Tax $0
Seat 1: Hero (button) folded before Flop (didn't bet)
Seat 2: 4ff5126a (small blind) collected ($0.1)
Seat 3: 56099b06 (big blind) folded before Flop
Seat 4: 3bf36a6c folded before Flop (didn't bet)
Seat 5: 17b3fdb6 folded before Flop (didn't bet)
Seat 6: e725801b folded before Flop (didn't bet)


Poker Hand #RC3811179526: Hold'em No Limit ($0.02/$0.05) - 2025/08/16 12:41:30
Table 'RushAndCash844786' 6-max Seat #1 is the button
Seat 1: 75fa1380 ($21.39 in chips)
Seat 2: Hero ($14.3 in chips)
Seat 3: 2e3731d0 ($8.12 in chips)
Seat 4: 8c9e3686 ($3.96 in chips)
Seat 5: 52a2d7e7 ($4.58 in chips)
Seat 6: 1651efc4 ($6.9 in chips)
Hero: posts small blind $0.02
2e3731d0: posts big blind $0.05
*** HOLE CARDS ***
Dealt to 75fa1380 
Dealt to Hero [9c 6c]
Dealt to 2e3731d0 
Dealt to 8c9e3686 
Dealt to 52a2d7e7 
Dealt to 1651efc4 
8c9e3686: folds
52a2d7e7: folds
1651efc4: raises $0.07 to $0.12
75fa1380: calls $0.12
Hero: folds
2e3731d0: folds
*** FLOP *** [3s Ad Td]
1651efc4: bets $0.1
75fa1380: folds
Uncalled bet ($0.1) returned to 1651efc4
*** SHOWDOWN ***
1651efc4 collected $0.3 from pot
*** SUMMARY ***
Total pot $0.31 | Rake $0.01 | Jackpot $0 | Bingo $0 | Fortune $0 | Tax $0
Board [3s Ad Td]
Seat 1: 75fa1380 (button) folded on the Flop
Seat 2: Hero (small blind) folded before Flop
Seat 3: 2e3731d0 (big blind) folded before Flop
Seat 4: 8c9e3686 folded before Flop (didn't bet)
Seat 5: 52a2d7e7 folded before Flop (didn't bet)
Seat 6: 1651efc4 won ($0.3)


Poker Hand #RC3811179331: Hold'em No Limit ($0.02/$0.05) - 2025/08/16 12:40:40
Table 'RushAndCash844591' 6-max Seat #1 is the button
Seat 1: 4c7edfe6 ($19.36 in chips)
Seat 2: 2e3731d0 ($8.22 in chips)
Seat 3: Hero ($14.11 in chips)
Seat 4: a1fb7346 ($2.64 in chips)
Seat 5: 3b76f692 ($5.07 in chips)
Seat 6: 1b34b380 ($15.35 in chips)
2e3731d0: posts small blind $0.02
Hero: posts big blind $0.05
*** HOLE CARDS ***
Dealt to 4c7edfe6 
Dealt to 2e3731d0 
Dealt to Hero [Qd Th]
Dealt to a1fb7346 
Dealt to 3b76f692 
Dealt to 1b34b380 
a1fb7346: folds
3b76f692: folds
1b34b380: raises $0.05 to $0.1
4c7edfe6: folds
2e3731d0: calls $0.08
Hero: calls $0.05
*** FLOP *** [2c Qc 9h]
2e3731d0: checks
Hero: bets $0.15
1b34b380: folds
2e3731d0: folds
Uncalled bet ($0.15) returned to Hero
*** SHOWDOWN ***
Hero collected $0.29 from pot
*** SUMMARY ***
Total pot $0.3 | Rake $0.01 | Jackpot $0 | Bingo $0 | Fortune $0 | Tax $0
Board [2c Qc 9h]
Seat 1: 4c7edfe6 (button) folded before Flop (didn't bet)
Seat 2: 2e3731d0 (small blind) folded on the Flop
Seat 3: Hero (big blind) won ($0.29)
Seat 4: a1fb7346 folded before Flop (didn't bet)
Seat 5: 3b76f692 folded before Flop (didn't bet)
Seat 6: 1b34b380 folded on the Flop


Poker Hand #RC3811179318: Hold'em No Limit ($0.02/$0.05) - 2025/08/16 12:40:36
Table 'RushAndCash844578' 6-max Seat #1 is the button
Seat 1: df91ffd8 ($7.08 in chips)
Seat 2: ec79c726 ($5.36 in chips)
Seat 3: 74d0d878 ($5.55 in chips)
Seat 4: d5778e5c ($5.08 in chips)
Seat 5: Hero ($14.11 in chips)
Seat 6: aecbb8f2 ($5.28 in chips)
ec79c726: posts small blind $0.02
74d0d878: posts big blind $0.05
*** HOLE CARDS ***
Dealt to df91ffd8 
Dealt to ec79c726 
Dealt to 74d0d878 
Dealt to d5778e5c 
Dealt to Hero [Ts 6s]
Dealt to aecbb8f2 
d5778e5c: folds
Hero: folds
aecbb8f2: folds
df91ffd8: raises $0.06 to $0.11
ec79c726: folds
74d0d878: folds
Uncalled bet ($0.06) returned to df91ffd8
*** SHOWDOWN ***
df91ffd8 collected $0.12 from pot
*** SUMMARY ***
Total pot $0.12 | Rake $0 | Jackpot $0 | Bingo $0 | Fortune $0 | Tax $0
Seat 1: df91ffd8 (button) collected ($0.12)
Seat 2: ec79c726 (small blind) folded before Flop
Seat 3: 74d0d878 (big blind) folded before Flop
Seat 4: d5778e5c folded before Flop (didn't bet)
Seat 5: Hero folded before Flop (didn't bet)
Seat 6: aecbb8f2 folded before Flop (didn't bet)


Poker Hand #RC3811179304: Hold'em No Limit ($0.02/$0.05) - 2025/08/16 12:40:33
Table 'RushAndCash844564' 6-max Seat #1 is the button
Seat 1: be24990e ($5.14 in chips)
Seat 2: 558d4f68 ($9.48 in chips)
Seat 3: ee3c195 ($8.73 in chips)
Seat 4: Hero ($14.11 in chips)
Seat 5: 4339513e ($10.31 in chips)
Seat 6: d5778e5c ($5.08 in chips)
558d4f68: posts small blind $0.02
ee3c195: posts big blind $0.05
*** HOLE CARDS ***
Dealt to be24990e 
Dealt to 558d4f68 
Dealt to ee3c195 
Dealt to Hero [5s 2s]
Dealt to 4339513e 
Dealt to d5778e5c 
Hero: folds
4339513e: raises $0.1 to $0.15
d5778e5c: folds
be24990e: folds
558d4f68: folds
ee3c195: folds
Uncalled bet ($0.1) returned to 4339513e
*** SHOWDOWN ***
4339513e collected $0.12 from pot
*** SUMMARY ***
Total pot $0.12 | Rake $0 | Jackpot $0 | Bingo $0 | Fortune $0 | Tax $0
Seat 1: be24990e (button) folded before Flop (didn't bet)
Seat 2: 558d4f68 (small blind) folded before Flop
Seat 3: ee3c195 (big blind) folded before Flop
Seat 4: Hero folded before Flop (didn't bet)
Seat 5: 4339513e collected ($0.12)
Seat 6: d5778e5c folded before Flop (didn't bet)


Poker Hand #RC3811179289: Hold'em No Limit ($0.02/$0.05) - 2025/08/16 12:40:29
Table 'RushAndCash844549' 6-max Seat #1 is the button
Seat 1: d5778e5c ($5.08 in chips)
Seat 2: 111c5398 ($10.57 in chips)
Seat 3: 4c967e29 ($4.41 in chips)
Seat 4: Hero ($14.11 in chips)
Seat 5: 917f3e19 ($10.17 in chips)
Seat 6: 1f0f0220 ($8.55 in chips)
111c5398: posts small blind $0.02
4c967e29: posts big blind $0.05
*** HOLE CARDS ***
Dealt to d5778e5c 
Dealt to 111c5398 
Dealt to 4c967e29 
Dealt to Hero [4h Kh]
Dealt to 917f3e19 
Dealt to 1f0f0220 
Hero: folds
917f3e19: folds
1f0f0220: raises $0.07 to $0.12
d5778e5c: folds
111c5398: folds
4c967e29: folds
Uncalled bet ($0.07) returned to 1f0f0220
*** SHOWDOWN ***
1f0f0220 collected $0.12 from pot
*** SUMMARY ***
Total pot $0.12 | Rake $0 | Jackpot $0 | Bingo $0 | Fortune $0 | Tax $0
Seat 1: d5778e5c (button) folded before Flop (didn't bet)
Seat 2: 111c5398 (small blind) folded before Flop
Seat 3: 4c967e29 (big blind) folded before Flop
Seat 4: Hero folded before Flop (didn't bet)
Seat 5: 917f3e19 folded before Flop (didn't bet)
Seat 6: 1f0f0220 collected ($0.12)


Poker Hand #RC3811179162: Hold'em No Limit ($0.02/$0.05) - 2025/08/16 12:40:00
Table 'RushAndCash844422' 6-max Seat #1 is the button
Seat 1: e6a5b6ba ($12.4 in chips)
Seat 2: Hero ($14.02 in chips)
Seat 3: d5778e5c ($5.18 in chips)
Seat 4: f844f19 ($7.2 in chips)
Seat 5: 6922f94e ($8.38 in chips)
Seat 6: 24678d46 ($13.68 in chips)
Hero: posts small blind $0.02
d5778e5c: posts big blind $0.05
*** HOLE CARDS ***
Dealt to e6a5b6ba 
Dealt to Hero [6c 8h]
Dealt to d5778e5c 
Dealt to f844f19 
Dealt to 6922f94e 
Dealt to 24678d46 
f844f19: folds
6922f94e: folds
24678d46: folds
e6a5b6ba: folds
Hero: calls $0.03
d5778e5c: checks
*** FLOP *** [Qh 6h 5d]
Hero: bets $0.05
d5778e5c: calls $0.05
*** TURN *** [Qh 6h 5d] [6s]
Hero: bets $0.26
d5778e5c: folds
Uncalled bet ($0.26) returned to Hero
*** SHOWDOWN ***
Hero collected $0.19 from pot
*** SUMMARY ***
Total pot $0.2 | Rake $0.01 | Jackpot $0 | Bingo $0 | Fortune $0 | Tax $0
Board [Qh 6h 5d 6s]
Seat 1: e6a5b6ba (button) folded before Flop (didn't bet)
Seat 2: Hero (small blind) won ($0.19)
Seat 3: d5778e5c (big blind) folded on the Turn
Seat 4: f844f19 folded before Flop (didn't bet)
Seat 5: 6922f94e folded before Flop (didn't bet)
Seat 6: 24678d46 folded before Flop (didn't bet)


Poker Hand #RC3811179112: Hold'em No Limit ($0.02/$0.05) - 2025/08/16 12:39:49
Table 'RushAndCash844372' 6-max Seat #1 is the button
Seat 1: 2e3731d0 ($7.82 in chips)
Seat 2: fff58a99 ($5.33 in chips)
Seat 3: Hero ($14 in chips)
Seat 4: 9dcd69d5 ($6.02 in chips)
Seat 5: ee3c195 ($8.73 in chips)
Seat 6: 25e7bbe7 ($4.46 in chips)
fff58a99: posts small blind $0.02
Hero: posts big blind $0.05
*** HOLE CARDS ***
Dealt to 2e3731d0 
Dealt to fff58a99 
Dealt to Hero [Tc Ac]
Dealt to 9dcd69d5 
Dealt to ee3c195 
Dealt to 25e7bbe7 
9dcd69d5: folds
ee3c195: folds
25e7bbe7: folds
2e3731d0: folds
fff58a99: folds
Uncalled bet ($0.03) returned to Hero
*** SHOWDOWN ***
Hero collected $0.04 from pot
*** SUMMARY ***
Total pot $0.04 | Rake $0 | Jackpot $0 | Bingo $0 | Fortune $0 | Tax $0
Seat 1: 2e3731d0 (button) folded before Flop (didn't bet)
Seat 2: fff58a99 (small blind) folded before Flop
Seat 3: Hero (big blind) collected ($0.04)
Seat 4: 9dcd69d5 folded before Flop (didn't bet)
Seat 5: ee3c195 folded before Flop (didn't bet)
Seat 6: 25e7bbe7 folded before Flop (didn't bet)


Poker Hand #RC3811179097: Hold'em No Limit ($0.02/$0.05) - 2025/08/16 12:39:45
Table 'RushAndCash844357' 6-max Seat #1 is the button
Seat 1: d59f2f93 ($5.16 in chips)
Seat 2: cc63a6ff ($4.9 in chips)
Seat 3: bb649669 ($5.09 in chips)
Seat 4: 6ad839b8 ($6.68 in chips)
Seat 5: a2981f05 ($5.88 in chips)
Seat 6: Hero ($14 in chips)
cc63a6ff: posts small blind $0.02
bb649669: posts big blind $0.05
*** HOLE CARDS ***
Dealt to d59f2f93 
Dealt to cc63a6ff 
Dealt to bb649669 
Dealt to 6ad839b8 
Dealt to a2981f05 
Dealt to Hero [7c Kh]
6ad839b8: folds
a2981f05: folds
Hero: folds
d59f2f93: raises $0.08 to $0.13
cc63a6ff: calls $0.11
bb649669: folds
*** FLOP *** [Qs 5s 6d]
cc63a6ff: checks
d59f2f93: checks
*** TURN *** [Qs 5s 6d] [Th]
cc63a6ff: bets $0.11
d59f2f93: calls $0.11
*** RIVER *** [Qs 5s 6d Th] [Ad]
cc63a6ff: checks
d59f2f93: checks
cc63a6ff: shows [8d Jd] (Ace high)
d59f2f93: shows [Qh 9h] (a pair of Queens)
*** SHOWDOWN ***
d59f2f93 collected $0.51 from pot
*** SUMMARY ***
Total pot $0.53 | Rake $0.02 | Jackpot $0 | Bingo $0 | Fortune $0 | Tax $0
Board [Qs 5s 6d Th Ad]
Seat 1: d59f2f93 (button) showed [Qh 9h] and won ($0.51) with a pair of Queens
Seat 2: cc63a6ff (small blind) showed [8d Jd] and lost with Ace high
Seat 3: bb649669 (big blind) folded before Flop
Seat 4: 6ad839b8 folded before Flop (didn't bet)
Seat 5: a2981f05 folded before Flop (didn't bet)
Seat 6: Hero folded before Flop (didn't bet)


Poker Hand #RC3811179083: Hold'em No Limit ($0.02/$0.05) - 2025/08/16 12:39:42
Table 'RushAndCash844343' 6-max Seat #1 is the button
Seat 1: af718e4b ($24.58 in chips)
Seat 2: de8865cc ($2.69 in chips)
Seat 3: ca49942f ($6.86 in chips)
Seat 4: c5700e6f ($5.19 in chips)
Seat 5: 51a6213 ($10.56 in chips)
Seat 6: Hero ($14 in chips)
de8865cc: posts small blind $0.02
ca49942f: posts big blind $0.05
*** HOLE CARDS ***
Dealt to af718e4b 
Dealt to de8865cc 
Dealt to ca49942f 
Dealt to c5700e6f 
Dealt to 51a6213 
Dealt to Hero [5d 5s]
c5700e6f: raises $0.05 to $0.1
51a6213: folds
Hero: folds
af718e4b: folds
de8865cc: calls $0.08
ca49942f: calls $0.05
*** FLOP *** [Qc Tc Kh]
de8865cc: checks
ca49942f: checks
c5700e6f: bets $0.12
de8865cc: folds
ca49942f: calls $0.12
*** TURN *** [Qc Tc Kh] [3h]
ca49942f: checks
c5700e6f: checks
*** RIVER *** [Qc Tc Kh 3h] [4s]
ca49942f: bets $0.27
c5700e6f: folds
Uncalled bet ($0.27) returned to ca49942f
*** SHOWDOWN ***
ca49942f collected $0.52 from pot
*** SUMMARY ***
Total pot $0.54 | Rake $0.02 | Jackpot $0 | Bingo $0 | Fortune $0 | Tax $0
Board [Qc Tc Kh 3h 4s]
Seat 1: af718e4b (button) folded before Flop (didn't bet)
Seat 2: de8865cc (small blind) folded on the Flop
Seat 3: ca49942f (big blind) won ($0.52)
Seat 4: c5700e6f folded on the River
Seat 5: 51a6213 folded before Flop (didn't bet)
Seat 6: Hero folded before Flop (didn't bet)


Poker Hand #RC3811179039: Hold'em No Limit ($0.02/$0.05) - 2025/08/16 12:39:33
Table 'RushAndCash844299' 6-max Seat #1 is the button
Seat 1: Hero ($14 in chips)
Seat 2: 97c3b99e ($4.1 in chips)
Seat 3: e5075287 ($5 in chips)
Seat 4: 1a4014a5 ($5.48 in chips)
Seat 5: 56ee232b ($3.25 in chips)
Seat 6: 7ea01cab ($1.61 in chips)
97c3b99e: posts small blind $0.02
e5075287: posts big blind $0.05
*** HOLE CARDS ***
Dealt to Hero [2h 9c]
Dealt to 97c3b99e 
Dealt to e5075287 
Dealt to 1a4014a5 
Dealt to 56ee232b 
Dealt to 7ea01cab 
1a4014a5: folds
56ee232b: folds
7ea01cab: folds
Hero: folds
97c3b99e: raises $0.07 to $0.12
e5075287: folds
Uncalled bet ($0.07) returned to 97c3b99e
*** SHOWDOWN ***
97c3b99e collected $0.1 from pot
*** SUMMARY ***
Total pot $0.1 | Rake $0 | Jackpot $0 | Bingo $0 | Fortune $0 | Tax $0
Seat 1: Hero (button) folded before Flop (didn't bet)
Seat 2: 97c3b99e (small blind) collected ($0.1)
Seat 3: e5075287 (big blind) folded before Flop
Seat 4: 1a4014a5 folded before Flop (didn't bet)
Seat 5: 56ee232b folded before Flop (didn't bet)
Seat 6: 7ea01cab folded before Flop (didn't bet)


Poker Hand #RC3811179023: Hold'em No Limit ($0.02/$0.05) - 2025/08/16 12:39:29
Table 'RushAndCash844283' 6-max Seat #1 is the button
Seat 1: c0b3d5e0 ($5.02 in chips)
Seat 2: 74d0d878 ($5.57 in chips)
Seat 3: 94476df0 ($6.44 in chips)
Seat 4: 5183e732 ($6.87 in chips)
Seat 5: b0933ab ($6.46 in chips)
Seat 6: Hero ($14 in chips)
74d0d878: posts small blind $0.02
94476df0: posts big blind $0.05
*** HOLE CARDS ***
Dealt to c0b3d5e0 
Dealt to 74d0d878 
Dealt to 94476df0 
Dealt to 5183e732 
Dealt to b0933ab 
Dealt to Hero [9s 2c]
5183e732: folds
b0933ab: folds
Hero: folds
c0b3d5e0: raises $0.05 to $0.1
74d0d878: folds
94476df0: folds
Uncalled bet ($0.05) returned to c0b3d5e0
*** SHOWDOWN ***
c0b3d5e0 collected $0.12 from pot
*** SUMMARY ***
Total pot $0.12 | Rake $0 | Jackpot $0 | Bingo $0 | Fortune $0 | Tax $0
Seat 1: c0b3d5e0 (button) collected ($0.12)
Seat 2: 74d0d878 (small blind) folded before Flop
Seat 3: 94476df0 (big blind) folded before Flop
Seat 4: 5183e732 folded before Flop (didn't bet)
Seat 5: b0933ab folded before Flop (didn't bet)
Seat 6: Hero folded before Flop (didn't bet)


Poker Hand #RC3811178791: Hold'em No Limit ($0.02/$0.05) - 2025/08/16 12:38:35
Table 'RushAndCash844051' 6-max Seat #1 is the button
Seat 1: Hero ($13.76 in chips)
Seat 2: 9dcd69d5 ($6 in chips)
Seat 3: 25e7bbe7 ($4.87 in chips)
Seat 4: fff58a99 ($5 in chips)
Seat 5: b0933ab ($6.65 in chips)
Seat 6: f8d1eed ($6.9 in chips)
9dcd69d5: posts small blind $0.02
25e7bbe7: posts big blind $0.05
*** HOLE CARDS ***
Dealt to Hero [4s 5h]
Dealt to 9dcd69d5 
Dealt to 25e7bbe7 
Dealt to fff58a99 
Dealt to b0933ab 
Dealt to f8d1eed 
fff58a99: folds
b0933ab: raises $0.05 to $0.1
f8d1eed: folds
Hero: calls $0.1
9dcd69d5: folds
25e7bbe7: folds
*** FLOP *** [6d Qc 4h]
b0933ab: bets $0.09
Hero: calls $0.09
*** TURN *** [6d Qc 4h] [3d]
b0933ab: checks
Hero: checks
*** RIVER *** [6d Qc 4h 3d] [Qd]
b0933ab: checks
Hero: checks
b0933ab: shows [9h Th] (a pair of Queens)
Hero: shows [4s 5h] (two pair, Queens and Fours)
*** SHOWDOWN ***
Hero collected $0.43 from pot
*** SUMMARY ***
Total pot $0.45 | Rake $0.02 | Jackpot $0 | Bingo $0 | Fortune $0 | Tax $0
Board [6d Qc 4h 3d Qd]
Seat 1: Hero (button) showed [4s 5h] and won ($0.43) with two pair, Queens and Fours
Seat 2: 9dcd69d5 (small blind) folded before Flop
Seat 3: 25e7bbe7 (big blind) folded before Flop
Seat 4: fff58a99 folded before Flop (didn't bet)
Seat 5: b0933ab showed [9h Th] and lost with a pair of Queens
Seat 6: f8d1eed folded before Flop (didn't bet)


Poker Hand #RC3811178776: Hold'em No Limit ($0.02/$0.05) - 2025/08/16 12:38:31
Table 'RushAndCash844036' 6-max Seat #1 is the button
Seat 1: d2f2eb8a ($5 in chips)
Seat 2: 8e0daf4 ($16.05 in chips)
Seat 3: 997a157f ($5.36 in chips)
Seat 4: 88f2ba0f ($5.98 in chips)
Seat 5: Hero ($13.76 in chips)
Seat 6: 1c015352 ($5.31 in chips)
8e0daf4: posts small blind $0.02
997a157f: posts big blind $0.05
*** HOLE CARDS ***
Dealt to d2f2eb8a 
Dealt to 8e0daf4 
Dealt to 997a157f 
Dealt to 88f2ba0f 
Dealt to Hero [2d 2c]
Dealt to 1c015352 
88f2ba0f: folds
Hero: folds
1c015352: raises $0.05 to $0.1
d2f2eb8a: folds
8e0daf4: folds
997a157f: folds
Uncalled bet ($0.05) returned to 1c015352
*** SHOWDOWN ***
1c015352 collected $0.12 from pot
*** SUMMARY ***
Total pot $0.12 | Rake $0 | Jackpot $0 | Bingo $0 | Fortune $0 | Tax $0
Seat 1: d2f2eb8a (button) folded before Flop (didn't bet)
Seat 2: 8e0daf4 (small blind) folded before Flop
Seat 3: 997a157f (big blind) folded before Flop
Seat 4: 88f2ba0f folded before Flop (didn't bet)
Seat 5: Hero folded before Flop (didn't bet)
Seat 6: 1c015352 collected ($0.12)


Poker Hand #RC3811178697: Hold'em No Limit ($0.02/$0.05) - 2025/08/16 12:38:13
Table 'RushAndCash843957' 6-max Seat #1 is the button
Seat 1: 17d1d965 ($5.63 in chips)
Seat 2: 7b8b66eb ($5.34 in chips)
Seat 3: Hero ($13.81 in chips)
Seat 4: e6780e8f ($10.57 in chips)
Seat 5: f844f19 ($7.04 in chips)
Seat 6: 343e61a8 ($9.58 in chips)
7b8b66eb: posts small blind $0.02
Hero: posts big blind $0.05
*** HOLE CARDS ***
Dealt to 17d1d965 
Dealt to 7b8b66eb 
Dealt to Hero [Ts 9d]
Dealt to e6780e8f 
Dealt to f844f19 
Dealt to 343e61a8 
e6780e8f: folds
f844f19: folds
343e61a8: raises $0.05 to $0.1
17d1d965: raises $0.21 to $0.31
7b8b66eb: folds
Hero: folds
343e61a8: calls $0.21
*** FLOP *** [7s Qc Tc]
343e61a8: checks
17d1d965: bets $0.2
343e61a8: calls $0.2
*** TURN *** [7s Qc Tc] [Ks]
343e61a8: checks
17d1d965: checks
*** RIVER *** [7s Qc Tc Ks] [6s]
343e61a8: bets $0.92
17d1d965: folds
Uncalled bet ($0.92) returned to 343e61a8
*** SHOWDOWN ***
343e61a8 collected $1.04 from pot
*** SUMMARY ***
Total pot $1.09 | Rake $0.05 | Jackpot $0 | Bingo $0 | Fortune $0 | Tax $0
Board [7s Qc Tc Ks 6s]
Seat 1: 17d1d965 (button) folded on the River
Seat 2: 7b8b66eb (small blind) folded before Flop
Seat 3: Hero (big blind) folded before Flop
Seat 4: e6780e8f folded before Flop (didn't bet)
Seat 5: f844f19 folded before Flop (didn't bet)
Seat 6: 343e61a8 won ($1.04)


Poker Hand #RC3811178660: Hold'em No Limit ($0.02/$0.05) - 2025/08/16 12:38:04
Table 'RushAndCash843920' 6-max Seat #1 is the button
Seat 1: d1763fe4 ($5.16 in chips)
Seat 2: Hero ($13.83 in chips)
Seat 3: 6f8d5760 ($5.18 in chips)
Seat 4: 6922f94e ($9.25 in chips)
Seat 5: ca49942f ($6.86 in chips)
Seat 6: bea85404 ($5 in chips)
Hero: posts small blind $0.02
6f8d5760: posts big blind $0.05
*** HOLE CARDS ***
Dealt to d1763fe4 
Dealt to Hero [6c 8d]
Dealt to 6f8d5760 
Dealt to 6922f94e 
Dealt to ca49942f 
Dealt to bea85404 
6922f94e: folds
ca49942f: folds
bea85404: raises $0.06 to $0.11
d1763fe4: folds
Hero: folds
6f8d5760: folds
Uncalled bet ($0.06) returned to bea85404
*** SHOWDOWN ***
bea85404 collected $0.12 from pot
*** SUMMARY ***
Total pot $0.12 | Rake $0 | Jackpot $0 | Bingo $0 | Fortune $0 | Tax $0
Seat 1: d1763fe4 (button) folded before Flop (didn't bet)
Seat 2: Hero (small blind) folded before Flop
Seat 3: 6f8d5760 (big blind) folded before Flop
Seat 4: 6922f94e folded before Flop (didn't bet)
Seat 5: ca49942f folded before Flop (didn't bet)
Seat 6: bea85404 collected ($0.12)


Poker Hand #RC3811178483: Hold'em No Limit ($0.02/$0.05) - 2025/08/16 12:37:20
Table 'RushAndCash843743' 6-max Seat #1 is the button
Seat 1: bea85404 ($5.34 in chips)
Seat 2: aaae658f ($5.72 in chips)
Seat 3: 28989ffe ($4.17 in chips)
Seat 4: 343e61a8 ($9.51 in chips)
Seat 5: Hero ($13.21 in chips)
Seat 6: e2823751 ($6.7 in chips)
aaae658f: posts small blind $0.02
28989ffe: posts big blind $0.05
*** HOLE CARDS ***
Dealt to bea85404 
Dealt to aaae658f 
Dealt to 28989ffe 
Dealt to 343e61a8 
Dealt to Hero [8h 7h]
Dealt to e2823751 
343e61a8: folds
Hero: raises $0.05 to $0.1
e2823751: folds
bea85404: raises $0.25 to $0.35
aaae658f: folds
28989ffe: folds
Hero: calls $0.25
*** FLOP *** [Jh 7s 4h]
Hero: checks
bea85404: bets $0.26
Hero: raises $0.62 to $0.88
bea85404: folds
Uncalled bet ($0.62) returned to Hero
*** SHOWDOWN ***
Hero collected $1.23 from pot
*** SUMMARY ***
Total pot $1.29 | Rake $0.06 | Jackpot $0 | Bingo $0 | Fortune $0 | Tax $0
Board [Jh 7s 4h]
Seat 1: bea85404 (button) folded on the Flop
Seat 2: aaae658f (small blind) folded before Flop
Seat 3: 28989ffe (big blind) folded before Flop
Seat 4: 343e61a8 folded before Flop (didn't bet)
Seat 5: Hero won ($1.23)
Seat 6: e2823751 folded before Flop (didn't bet)


Poker Hand #RC3811178469: Hold'em No Limit ($0.02/$0.05) - 2025/08/16 12:37:17
Table 'RushAndCash843729' 6-max Seat #1 is the button
Seat 1: 3d7e8ee ($9.86 in chips)
Seat 2: 1a5c24ee ($5 in chips)
Seat 3: e767dc8d ($7.42 in chips)
Seat 4: 629057aa ($5.62 in chips)
Seat 5: Hero ($13.21 in chips)
Seat 6: 2dd1c16d ($5 in chips)
1a5c24ee: posts small blind $0.02
e767dc8d: posts big blind $0.05
*** HOLE CARDS ***
Dealt to 3d7e8ee 
Dealt to 1a5c24ee 
Dealt to e767dc8d 
Dealt to 629057aa 
Dealt to Hero [4s 5c]
Dealt to 2dd1c16d 
629057aa: folds
Hero: folds
2dd1c16d: folds
3d7e8ee: raises $0.1 to $0.15
1a5c24ee: folds
e767dc8d: folds
Uncalled bet ($0.1) returned to 3d7e8ee
*** SHOWDOWN ***
3d7e8ee collected $0.12 from pot
*** SUMMARY ***
Total pot $0.12 | Rake $0 | Jackpot $0 | Bingo $0 | Fortune $0 | Tax $0
Seat 1: 3d7e8ee (button) collected ($0.12)
Seat 2: 1a5c24ee (small blind) folded before Flop
Seat 3: e767dc8d (big blind) folded before Flop
Seat 4: 629057aa folded before Flop (didn't bet)
Seat 5: Hero folded before Flop (didn't bet)
Seat 6: 2dd1c16d folded before Flop (didn't bet)


Poker Hand #RC3811178454: Hold'em No Limit ($0.02/$0.05) - 2025/08/16 12:37:13
Table 'RushAndCash843714' 6-max Seat #1 is the button
Seat 1: cf40af3 ($9.73 in chips)
Seat 2: 96844f57 ($7.61 in chips)
Seat 3: cc6cbf1d ($5.83 in chips)
Seat 4: b094641b ($5 in chips)
Seat 5: Hero ($13.21 in chips)
Seat 6: feb27c50 ($5.23 in chips)
96844f57: posts small blind $0.02
cc6cbf1d: posts big blind $0.05
*** HOLE CARDS ***
Dealt to cf40af3 
Dealt to 96844f57 
Dealt to cc6cbf1d 
Dealt to b094641b 
Dealt to Hero [Qh 8s]
Dealt to feb27c50 
b094641b: folds
Hero: folds
feb27c50: raises $0.05 to $0.1
cf40af3: folds
96844f57: calls $0.08
cc6cbf1d: calls $0.05
*** FLOP *** [5s 2s 3d]
96844f57: checks
cc6cbf1d: checks
feb27c50: checks
*** TURN *** [5s 2s 3d] [Ks]
96844f57: checks
cc6cbf1d: checks
feb27c50: checks
*** RIVER *** [5s 2s 3d Ks] [5h]
96844f57: checks
cc6cbf1d: bets $0.15
feb27c50: folds
96844f57: folds
Uncalled bet ($0.15) returned to cc6cbf1d
*** SHOWDOWN ***
cc6cbf1d collected $0.29 from pot
*** SUMMARY ***
Total pot $0.3 | Rake $0.01 | Jackpot $0 | Bingo $0 | Fortune $0 | Tax $0
Board [5s 2s 3d Ks 5h]
Seat 1: cf40af3 (button) folded before Flop (didn't bet)
Seat 2: 96844f57 (small blind) folded on the River
Seat 3: cc6cbf1d (big blind) won ($0.29)
Seat 4: b094641b folded before Flop (didn't bet)
Seat 5: Hero folded before Flop (didn't bet)
Seat 6: feb27c50 folded on the River


Poker Hand #RC3811178371: Hold'em No Limit ($0.02/$0.05) - 2025/08/16 12:36:53
Table 'RushAndCash843631' 6-max Seat #1 is the button
Seat 1: 2dd1c16d ($5.07 in chips)
Seat 2: Hero ($13.02 in chips)
Seat 3: 58d21334 ($6.53 in chips)
Seat 4: 319f9ef4 ($10.92 in chips)
Seat 5: 6ae471b6 ($10.01 in chips)
Seat 6: 7f00524f ($14.25 in chips)
Hero: posts small blind $0.02
58d21334: posts big blind $0.05
*** HOLE CARDS ***
Dealt to 2dd1c16d 
Dealt to Hero [2s 3s]
Dealt to 58d21334 
Dealt to 319f9ef4 
Dealt to 6ae471b6 
Dealt to 7f00524f 
319f9ef4: folds
6ae471b6: folds
7f00524f: folds
2dd1c16d: raises $0.1 to $0.15
Hero: raises $0.42 to $0.57
58d21334: folds
2dd1c16d: folds
Uncalled bet ($0.42) returned to Hero
*** SHOWDOWN ***
Hero collected $0.34 from pot
*** SUMMARY ***
Total pot $0.35 | Rake $0.01 | Jackpot $0 | Bingo $0 | Fortune $0 | Tax $0
Seat 1: 2dd1c16d (button) folded before Flop
Seat 2: Hero (small blind) collected ($0.34)
Seat 3: 58d21334 (big blind) folded before Flop
Seat 4: 319f9ef4 folded before Flop (didn't bet)
Seat 5: 6ae471b6 folded before Flop (didn't bet)
Seat 6: 7f00524f folded before Flop (didn't bet)


Poker Hand #RC3811178354: Hold'em No Limit ($0.02/$0.05) - 2025/08/16 12:36:49
Table 'RushAndCash843614' 6-max Seat #1 is the button
Seat 1: d9cc8864 ($10.5 in chips)
Seat 2: 7ce6a2f2 ($5.99 in chips)
Seat 3: 9adeb954 ($5 in chips)
Seat 4: 4ff5126a ($6.42 in chips)
Seat 5: Hero ($13.02 in chips)
Seat 6: 1c015352 ($5.15 in chips)
7ce6a2f2: posts small blind $0.02
9adeb954: posts big blind $0.05
*** HOLE CARDS ***
Dealt to d9cc8864 
Dealt to 7ce6a2f2 
Dealt to 9adeb954 
Dealt to 4ff5126a 
Dealt to Hero [Ks 6s]
Dealt to 1c015352 
4ff5126a: folds
Hero: folds
1c015352: folds
d9cc8864: folds
7ce6a2f2: raises $0.1 to $0.15
9adeb954: folds
Uncalled bet ($0.1) returned to 7ce6a2f2
*** SHOWDOWN ***
7ce6a2f2 collected $0.1 from pot
*** SUMMARY ***
Total pot $0.1 | Rake $0 | Jackpot $0 | Bingo $0 | Fortune $0 | Tax $0
Seat 1: d9cc8864 (button) folded before Flop (didn't bet)
Seat 2: 7ce6a2f2 (small blind) collected ($0.1)
Seat 3: 9adeb954 (big blind) folded before Flop
Seat 4: 4ff5126a folded before Flop (didn't bet)
Seat 5: Hero folded before Flop (didn't bet)
Seat 6: 1c015352 folded before Flop (didn't bet)


Poker Hand #RC3811178268: Hold'em No Limit ($0.02/$0.05) - 2025/08/16 12:36:28
Table 'RushAndCash843528' 6-max Seat #1 is the button
Seat 1: 60d6e9f3 ($4.86 in chips)
Seat 2: 3d7cbc07 ($2.51 in chips)
Seat 3: Hero ($13 in chips)
Seat 4: dea14c7d ($5.11 in chips)
Seat 5: a6710f72 ($5.12 in chips)
Seat 6: 7d24c8c5 ($8.52 in chips)
3d7cbc07: posts small blind $0.02
Hero: posts big blind $0.05
*** HOLE CARDS ***
Dealt to 60d6e9f3 
Dealt to 3d7cbc07 
Dealt to Hero [6s Kc]
Dealt to dea14c7d 
Dealt to a6710f72 
Dealt to 7d24c8c5 
dea14c7d: folds
a6710f72: folds
7d24c8c5: folds
60d6e9f3: folds
3d7cbc07: folds
Uncalled bet ($0.03) returned to Hero
*** SHOWDOWN ***
Hero collected $0.04 from pot
*** SUMMARY ***
Total pot $0.04 | Rake $0 | Jackpot $0 | Bingo $0 | Fortune $0 | Tax $0
Seat 1: 60d6e9f3 (button) folded before Flop (didn't bet)
Seat 2: 3d7cbc07 (small blind) folded before Flop
Seat 3: Hero (big blind) collected ($0.04)
Seat 4: dea14c7d folded before Flop (didn't bet)
Seat 5: a6710f72 folded before Flop (didn't bet)
Seat 6: 7d24c8c5 folded before Flop (didn't bet)


Poker Hand #RC3811178250: Hold'em No Limit ($0.02/$0.05) - 2025/08/16 12:36:24
Table 'RushAndCash843510' 6-max Seat #1 is the button
Seat 1: 3fee27f9 ($14.35 in chips)
Seat 2: 4698ae62 ($9.22 in chips)
Seat 3: 7bf33a65 ($21.93 in chips)
Seat 4: 7d698db1 ($8.69 in chips)
Seat 5: Hero ($13 in chips)
Seat 6: 7d24c8c5 ($8.52 in chips)
4698ae62: posts small blind $0.02
7bf33a65: posts big blind $0.05
*** HOLE CARDS ***
Dealt to 3fee27f9 
Dealt to 4698ae62 
Dealt to 7bf33a65 
Dealt to 7d698db1 
Dealt to Hero [8c 3s]
Dealt to 7d24c8c5 
7d698db1: folds
Hero: folds
7d24c8c5: folds
3fee27f9: folds
4698ae62: raises $0.09 to $0.14
7bf33a65: folds
Uncalled bet ($0.09) returned to 4698ae62
*** SHOWDOWN ***
4698ae62 collected $0.1 from pot
*** SUMMARY ***
Total pot $0.1 | Rake $0 | Jackpot $0 | Bingo $0 | Fortune $0 | Tax $0
Seat 1: 3fee27f9 (button) folded before Flop (didn't bet)
Seat 2: 4698ae62 (small blind) collected ($0.1)
Seat 3: 7bf33a65 (big blind) folded before Flop
Seat 4: 7d698db1 folded before Flop (didn't bet)
Seat 5: Hero folded before Flop (didn't bet)
Seat 6: 7d24c8c5 folded before Flop (didn't bet)


Poker Hand #RC3811178235: Hold'em No Limit ($0.02/$0.05) - 2025/08/16 12:36:21
Table 'RushAndCash843495' 6-max Seat #1 is the button
Seat 1: 7d698db1 ($8.69 in chips)
Seat 2: 79cdd8b2 ($4.95 in chips)
Seat 3: 60d6e9f3 ($4.93 in chips)
Seat 4: 35089a1b ($6.78 in chips)
Seat 5: Hero ($13 in chips)
Seat 6: e7cb69c2 ($5.23 in chips)
79cdd8b2: posts small blind $0.02
60d6e9f3: posts big blind $0.05
*** HOLE CARDS ***
Dealt to 7d698db1 
Dealt to 79cdd8b2 
Dealt to 60d6e9f3 
Dealt to 35089a1b 
Dealt to Hero [Qd 7s]
Dealt to e7cb69c2 
35089a1b: folds
Hero: folds
e7cb69c2: raises $0.05 to $0.1
7d698db1: folds
79cdd8b2: calls $0.08
60d6e9f3: folds
*** FLOP *** [6h 5d Ks]
79cdd8b2: checks
e7cb69c2: bets $0.08
79cdd8b2: folds
Uncalled bet ($0.08) returned to e7cb69c2
*** SHOWDOWN ***
e7cb69c2 collected $0.24 from pot
*** SUMMARY ***
Total pot $0.25 | Rake $0.01 | Jackpot $0 | Bingo $0 | Fortune $0 | Tax $0
Board [6h 5d Ks]
Seat 1: 7d698db1 (button) folded before Flop (didn't bet)
Seat 2: 79cdd8b2 (small blind) folded on the Flop
Seat 3: 60d6e9f3 (big blind) folded before Flop
Seat 4: 35089a1b folded before Flop (didn't bet)
Seat 5: Hero folded before Flop (didn't bet)
Seat 6: e7cb69c2 won ($0.24)


Poker Hand #RC3811178209: Hold'em No Limit ($0.02/$0.05) - 2025/08/16 12:36:15
Table 'RushAndCash843469' 6-max Seat #1 is the button
Seat 1: Hero ($13 in chips)
Seat 2: 393048cb ($5.14 in chips)
Seat 3: cc6cbf1d ($5.81 in chips)
Seat 4: aaae658f ($5.44 in chips)
Seat 5: dda95519 ($5.62 in chips)
Seat 6: f6a47e9f ($15.02 in chips)
393048cb: posts small blind $0.02
cc6cbf1d: posts big blind $0.05
*** HOLE CARDS ***
Dealt to Hero [7d 2h]
Dealt to 393048cb 
Dealt to cc6cbf1d 
Dealt to aaae658f 
Dealt to dda95519 
Dealt to f6a47e9f 
aaae658f: folds
dda95519: folds
f6a47e9f: folds
Hero: folds
393048cb: folds
Uncalled bet ($0.03) returned to cc6cbf1d
*** SHOWDOWN ***
cc6cbf1d collected $0.04 from pot
*** SUMMARY ***
Total pot $0.04 | Rake $0 | Jackpot $0 | Bingo $0 | Fortune $0 | Tax $0
Seat 1: Hero (button) folded before Flop (didn't bet)
Seat 2: 393048cb (small blind) folded before Flop
Seat 3: cc6cbf1d (big blind) collected ($0.04)
Seat 4: aaae658f folded before Flop (didn't bet)
Seat 5: dda95519 folded before Flop (didn't bet)
Seat 6: f6a47e9f folded before Flop (didn't bet)


Poker Hand #RC3811178112: Hold'em No Limit ($0.02/$0.05) - 2025/08/16 12:35:52
Table 'RushAndCash843372' 6-max Seat #1 is the button
Seat 1: Hero ($12.93 in chips)
Seat 2: ad373012 ($5.01 in chips)
Seat 3: 4698ae62 ($9.27 in chips)
Seat 4: e5075287 ($5.08 in chips)
Seat 5: 8ebaac0c ($6.38 in chips)
Seat 6: 188a67f6 ($5 in chips)
ad373012: posts small blind $0.02
4698ae62: posts big blind $0.05
*** HOLE CARDS ***
Dealt to Hero [Tc Jh]
Dealt to ad373012 
Dealt to 4698ae62 
Dealt to e5075287 
Dealt to 8ebaac0c 
Dealt to 188a67f6 
e5075287: folds
8ebaac0c: folds
188a67f6: folds
Hero: raises $0.05 to $0.1
ad373012: folds
4698ae62: folds
Uncalled bet ($0.05) returned to Hero
*** SHOWDOWN ***
Hero collected $0.12 from pot
*** SUMMARY ***
Total pot $0.12 | Rake $0 | Jackpot $0 | Bingo $0 | Fortune $0 | Tax $0
Seat 1: Hero (button) collected ($0.12)
Seat 2: ad373012 (small blind) folded before Flop
Seat 3: 4698ae62 (big blind) folded before Flop
Seat 4: e5075287 folded before Flop (didn't bet)
Seat 5: 8ebaac0c folded before Flop (didn't bet)
Seat 6: 188a67f6 folded before Flop (didn't bet)


Poker Hand #RC3811177970: Hold'em No Limit ($0.02/$0.05) - 2025/08/16 12:35:19
Table 'RushAndCash843230' 6-max Seat #1 is the button
Seat 1: 5282afa2 ($5.33 in chips)
Seat 2: Hero ($12.98 in chips)
Seat 3: 8ebaac0c ($6.33 in chips)
Seat 4: 73c308f9 ($6.45 in chips)
Seat 5: a9489532 ($5.45 in chips)
Seat 6: 9adeb954 ($5 in chips)
Hero: posts small blind $0.02
8ebaac0c: posts big blind $0.05
*** HOLE CARDS ***
Dealt to 5282afa2 
Dealt to Hero [Qd Ts]
Dealt to 8ebaac0c 
Dealt to 73c308f9 
Dealt to a9489532 
Dealt to 9adeb954 
73c308f9: folds
a9489532: folds
9adeb954: folds
5282afa2: folds
Hero: calls $0.03
8ebaac0c: raises $0.15 to $0.2
Hero: folds
Uncalled bet ($0.15) returned to 8ebaac0c
*** SHOWDOWN ***
8ebaac0c collected $0.1 from pot
*** SUMMARY ***
Total pot $0.1 | Rake $0 | Jackpot $0 | Bingo $0 | Fortune $0 | Tax $0
Seat 1: 5282afa2 (button) folded before Flop (didn't bet)
Seat 2: Hero (small blind) folded before Flop
Seat 3: 8ebaac0c (big blind) collected ($0.1)
Seat 4: 73c308f9 folded before Flop (didn't bet)
Seat 5: a9489532 folded before Flop (didn't bet)
Seat 6: 9adeb954 folded before Flop (didn't bet)


Poker Hand #RC3811177919: Hold'em No Limit ($0.02/$0.05) - 2025/08/16 12:35:07
Table 'RushAndCash843179' 6-max Seat #1 is the button
Seat 1: db06fb37 ($6.51 in chips)
Seat 2: dce7f224 ($18.67 in chips)
Seat 3: Hero ($13.03 in chips)
Seat 4: ee3c195 ($6.74 in chips)
Seat 5: e88b4b2 ($6.18 in chips)
Seat 6: 28fabb2d ($5.14 in chips)
dce7f224: posts small blind $0.02
Hero: posts big blind $0.05
*** HOLE CARDS ***
Dealt to db06fb37 
Dealt to dce7f224 
Dealt to Hero [3d Tc]
Dealt to ee3c195 
Dealt to e88b4b2 
Dealt to 28fabb2d 
ee3c195: raises $0.06 to $0.11
e88b4b2: folds
28fabb2d: folds
db06fb37: folds
dce7f224: folds
Hero: folds
Uncalled bet ($0.06) returned to ee3c195
*** SHOWDOWN ***
ee3c195 collected $0.12 from pot
*** SUMMARY ***
Total pot $0.12 | Rake $0 | Jackpot $0 | Bingo $0 | Fortune $0 | Tax $0
Seat 1: db06fb37 (button) folded before Flop (didn't bet)
Seat 2: dce7f224 (small blind) folded before Flop
Seat 3: Hero (big blind) folded before Flop
Seat 4: ee3c195 collected ($0.12)
Seat 5: e88b4b2 folded before Flop (didn't bet)
Seat 6: 28fabb2d folded before Flop (didn't bet)


Poker Hand #RC3811177906: Hold'em No Limit ($0.02/$0.05) - 2025/08/16 12:35:04
Table 'RushAndCash843166' 6-max Seat #1 is the button
Seat 1: aaae658f ($5.6 in chips)
Seat 2: 343e61a8 ($9.89 in chips)
Seat 3: 9dcd69d5 ($5.39 in chips)
Seat 4: 4ff5126a ($5.48 in chips)
Seat 5: fff58a99 ($5 in chips)
Seat 6: Hero ($13.03 in chips)
343e61a8: posts small blind $0.02
9dcd69d5: posts big blind $0.05
*** HOLE CARDS ***
Dealt to aaae658f 
Dealt to 343e61a8 
Dealt to 9dcd69d5 
Dealt to 4ff5126a 
Dealt to fff58a99 
Dealt to Hero [9s Jd]
4ff5126a: folds
fff58a99: raises $0.08 to $0.13
Hero: folds
aaae658f: folds
343e61a8: folds
9dcd69d5: folds
Uncalled bet ($0.08) returned to fff58a99
*** SHOWDOWN ***
fff58a99 collected $0.12 from pot
*** SUMMARY ***
Total pot $0.12 | Rake $0 | Jackpot $0 | Bingo $0 | Fortune $0 | Tax $0
Seat 1: aaae658f (button) folded before Flop (didn't bet)
Seat 2: 343e61a8 (small blind) folded before Flop
Seat 3: 9dcd69d5 (big blind) folded before Flop
Seat 4: 4ff5126a folded before Flop (didn't bet)
Seat 5: fff58a99 collected ($0.12)
Seat 6: Hero folded before Flop (didn't bet)


Poker Hand #RC3811177889: Hold'em No Limit ($0.02/$0.05) - 2025/08/16 12:35:00
Table 'RushAndCash843149' 6-max Seat #1 is the button
Seat 1: 19480dc1 ($8.4 in chips)
Seat 2: 272dc8b4 ($5.2 in chips)
Seat 3: 343e61a8 ($9.94 in chips)
Seat 4: Hero ($13.03 in chips)
Seat 5: 6e4f3d57 ($5.17 in chips)
Seat 6: aaae658f ($5.6 in chips)
272dc8b4: posts small blind $0.02
343e61a8: posts big blind $0.05
*** HOLE CARDS ***
Dealt to 19480dc1 
Dealt to 272dc8b4 
Dealt to 343e61a8 
Dealt to Hero [As 8c]
Dealt to 6e4f3d57 
Dealt to aaae658f 
Hero: folds
6e4f3d57: raises $0.05 to $0.1
aaae658f: folds
19480dc1: folds
272dc8b4: folds
343e61a8: folds
Uncalled bet ($0.05) returned to 6e4f3d57
*** SHOWDOWN ***
6e4f3d57 collected $0.12 from pot
*** SUMMARY ***
Total pot $0.12 | Rake $0 | Jackpot $0 | Bingo $0 | Fortune $0 | Tax $0
Seat 1: 19480dc1 (button) folded before Flop (didn't bet)
Seat 2: 272dc8b4 (small blind) folded before Flop
Seat 3: 343e61a8 (big blind) folded before Flop
Seat 4: Hero folded before Flop (didn't bet)
Seat 5: 6e4f3d57 collected ($0.12)
Seat 6: aaae658f folded before Flop (didn't bet)


Poker Hand #RC3811177874: Hold'em No Limit ($0.02/$0.05) - 2025/08/16 12:34:56
Table 'RushAndCash843134' 6-max Seat #1 is the button
Seat 1: 188a67f6 ($5 in chips)
Seat 2: 73c308f9 ($6.49 in chips)
Seat 3: 6ad839b8 ($6.86 in chips)
Seat 4: 1651efc4 ($6.44 in chips)
Seat 5: c4b26458 ($6.1 in chips)
Seat 6: Hero ($13.03 in chips)
73c308f9: posts small blind $0.02
6ad839b8: posts big blind $0.05
*** HOLE CARDS ***
Dealt to 188a67f6 
Dealt to 73c308f9 
Dealt to 6ad839b8 
Dealt to 1651efc4 
Dealt to c4b26458 
Dealt to Hero [2d Td]
1651efc4: folds
c4b26458: folds
Hero: folds
188a67f6: folds
73c308f9: folds
Uncalled bet ($0.03) returned to 6ad839b8
*** SHOWDOWN ***
6ad839b8 collected $0.04 from pot
*** SUMMARY ***
Total pot $0.04 | Rake $0 | Jackpot $0 | Bingo $0 | Fortune $0 | Tax $0
Seat 1: 188a67f6 (button) folded before Flop (didn't bet)
Seat 2: 73c308f9 (small blind) folded before Flop
Seat 3: 6ad839b8 (big blind) collected ($0.04)
Seat 4: 1651efc4 folded before Flop (didn't bet)
Seat 5: c4b26458 folded before Flop (didn't bet)
Seat 6: Hero folded before Flop (didn't bet)


Poker Hand #RC3811177656: Hold'em No Limit ($0.02/$0.05) - 2025/08/16 12:34:06
Table 'RushAndCash842916' 6-max Seat #1 is the button
Seat 1: ef9f379b ($5.21 in chips)
Seat 2: Hero ($11.92 in chips)
Seat 3: f5902ff5 ($2.26 in chips)
Seat 4: 83c58815 ($5.38 in chips)
Seat 5: 1c015352 ($5.2 in chips)
Seat 6: 94afcc3f ($10.07 in chips)
Hero: posts small blind $0.02
f5902ff5: posts big blind $0.05
*** HOLE CARDS ***
Dealt to ef9f379b 
Dealt to Hero [Kh As]
Dealt to f5902ff5 
Dealt to 83c58815 
Dealt to 1c015352 
Dealt to 94afcc3f 
83c58815: folds
1c015352: folds
94afcc3f: raises $0.05 to $0.1
ef9f379b: folds
Hero: raises $0.3 to $0.4
f5902ff5: folds
94afcc3f: calls $0.3
*** FLOP *** [8s Ad 7s]
Hero: checks
94afcc3f: bets $0.85
Hero: calls $0.85
*** TURN *** [8s Ad 7s] [7h]
Hero: checks
94afcc3f: checks
*** RIVER *** [8s Ad 7s 7h] [8h]
Hero: bets $1.94
94afcc3f: folds
Uncalled bet ($1.94) returned to Hero
*** SHOWDOWN ***
Hero collected $2.36 from pot
*** SUMMARY ***
Total pot $2.55 | Rake $0.12 | Jackpot $0.07 | Bingo $0 | Fortune $0 | Tax $0
Board [8s Ad 7s 7h 8h]
Seat 1: ef9f379b (button) folded before Flop (didn't bet)
Seat 2: Hero (small blind) won ($2.36)
Seat 3: f5902ff5 (big blind) folded before Flop
Seat 4: 83c58815 folded before Flop (didn't bet)
Seat 5: 1c015352 folded before Flop (didn't bet)
Seat 6: 94afcc3f folded on the River


Poker Hand #RC3811177402: Hold'em No Limit ($0.02/$0.05) - 2025/08/16 12:33:03
Table 'RushAndCash842662' 6-max Seat #1 is the button
Seat 1: 16962fac ($8.32 in chips)
Seat 2: f5902ff5 ($2.46 in chips)
Seat 3: Hero ($12.07 in chips)
Seat 4: 83c58815 ($5.05 in chips)
Seat 5: c21dca76 ($4.09 in chips)
Seat 6: aaae658f ($5.52 in chips)
f5902ff5: posts small blind $0.02
Hero: posts big blind $0.05
*** HOLE CARDS ***
Dealt to 16962fac 
Dealt to f5902ff5 
Dealt to Hero [Ks 3s]
Dealt to 83c58815 
Dealt to c21dca76 
Dealt to aaae658f 
83c58815: raises $0.05 to $0.1
c21dca76: folds
aaae658f: folds
16962fac: folds
f5902ff5: calls $0.08
Hero: calls $0.05
*** FLOP *** [5c 9c Kc]
f5902ff5: checks
Hero: checks
83c58815: checks
*** TURN *** [5c 9c Kc] [7d]
f5902ff5: bets $0.05
Hero: calls $0.05
83c58815: calls $0.05
*** RIVER *** [5c 9c Kc 7d] [2d]
f5902ff5: bets $0.05
Hero: folds
83c58815: calls $0.05
f5902ff5: shows [As 5h] (a pair of Fives)
83c58815: shows [Ad Ah] (a pair of Aces)
*** SHOWDOWN ***
83c58815 collected $0.53 from pot
*** SUMMARY ***
Total pot $0.55 | Rake $0.02 | Jackpot $0 | Bingo $0 | Fortune $0 | Tax $0
Board [5c 9c Kc 7d 2d]
Seat 1: 16962fac (button) folded before Flop (didn't bet)
Seat 2: f5902ff5 (small blind) showed [As 5h] and lost with a pair of Fives
Seat 3: Hero (big blind) folded on the River
Seat 4: 83c58815 showed [Ad Ah] and won ($0.53) with a pair of Aces
Seat 5: c21dca76 folded before Flop (didn't bet)
Seat 6: aaae658f folded before Flop (didn't bet)


Poker Hand #RC3811177225: Hold'em No Limit ($0.02/$0.05) - 2025/08/16 12:32:19
Table 'RushAndCash842485' 6-max Seat #1 is the button
Seat 1: Hero ($11.95 in chips)
Seat 2: a98f555a ($5 in chips)
Seat 3: 9dd8086a ($5.11 in chips)
Seat 4: c21dca76 ($4.14 in chips)
Seat 5: a7b36545 ($5.02 in chips)
Seat 6: 86eef255 ($5.07 in chips)
a98f555a: posts small blind $0.02
9dd8086a: posts big blind $0.05
*** HOLE CARDS ***
Dealt to Hero [Ks Qc]
Dealt to a98f555a 
Dealt to 9dd8086a 
Dealt to c21dca76 
Dealt to a7b36545 
Dealt to 86eef255 
c21dca76: calls $0.05
a7b36545: folds
86eef255: folds
Hero: calls $0.05
a98f555a: folds
9dd8086a: checks
*** FLOP *** [6h 3c Qd]
9dd8086a: checks
c21dca76: checks
Hero: bets $0.09
9dd8086a: folds
c21dca76: folds
Uncalled bet ($0.09) returned to Hero
*** SHOWDOWN ***
Hero collected $0.17 from pot
*** SUMMARY ***
Total pot $0.17 | Rake $0 | Jackpot $0 | Bingo $0 | Fortune $0 | Tax $0
Board [6h 3c Qd]
Seat 1: Hero (button) won ($0.17)
Seat 2: a98f555a (small blind) folded before Flop
Seat 3: 9dd8086a (big blind) folded on the Flop
Seat 4: c21dca76 folded on the Flop
Seat 5: a7b36545 folded before Flop (didn't bet)
Seat 6: 86eef255 folded before Flop (didn't bet)


Poker Hand #RC3811177208: Hold'em No Limit ($0.02/$0.05) - 2025/08/16 12:32:15
Table 'RushAndCash842468' 6-max Seat #1 is the button
Seat 1: 6ae471b6 ($5.14 in chips)
Seat 2: 5ea954db ($5 in chips)
Seat 3: a98f555a ($5 in chips)
Seat 4: Hero ($11.95 in chips)
Seat 5: db06fb37 ($6.28 in chips)
Seat 6: 40c5d9de ($15.03 in chips)
5ea954db: posts small blind $0.02
a98f555a: posts big blind $0.05
*** HOLE CARDS ***
Dealt to 6ae471b6 
Dealt to 5ea954db 
Dealt to a98f555a 
Dealt to Hero [Js 5d]
Dealt to db06fb37 
Dealt to 40c5d9de 
Hero: folds
db06fb37: folds
40c5d9de: raises $0.07 to $0.12
6ae471b6: raises $0.16 to $0.28
5ea954db: folds
a98f555a: folds
40c5d9de: calls $0.16
*** FLOP *** [Qh Th Qc]
40c5d9de: checks
6ae471b6: bets $0.32
40c5d9de: calls $0.32
*** TURN *** [Qh Th Qc] [8d]
40c5d9de: checks
6ae471b6: checks
*** RIVER *** [Qh Th Qc 8d] [Kc]
40c5d9de: checks
6ae471b6: checks
40c5d9de: shows [Tc As] (two pair, Queens and Tens)
6ae471b6: shows [7s 9s] (a pair of Queens)
*** SHOWDOWN ***
40c5d9de collected $1.21 from pot
*** SUMMARY ***
Total pot $1.27 | Rake $0.06 | Jackpot $0 | Bingo $0 | Fortune $0 | Tax $0
Board [Qh Th Qc 8d Kc]
Seat 1: 6ae471b6 (button) showed [7s 9s] and lost with a pair of Queens
Seat 2: 5ea954db (small blind) folded before Flop
Seat 3: a98f555a (big blind) folded before Flop
Seat 4: Hero folded before Flop (didn't bet)
Seat 5: db06fb37 folded before Flop (didn't bet)
Seat 6: 40c5d9de showed [Tc As] and won ($1.21) with two pair, Queens and Tens


Poker Hand #RC3811177196: Hold'em No Limit ($0.02/$0.05) - 2025/08/16 12:32:12
Table 'RushAndCash842456' 6-max Seat #1 is the button
Seat 1: 5183e732 ($3.84 in chips)
Seat 2: 45eea39e ($8.68 in chips)
Seat 3: f4c2b883 ($5 in chips)
Seat 4: Hero ($11.95 in chips)
Seat 5: 6ae471b6 ($5.14 in chips)
Seat 6: c4b26458 ($5.78 in chips)
45eea39e: posts small blind $0.02
f4c2b883: posts big blind $0.05
*** HOLE CARDS ***
Dealt to 5183e732 
Dealt to 45eea39e 
Dealt to f4c2b883 
Dealt to Hero [6h 4h]
Dealt to 6ae471b6 
Dealt to c4b26458 
Hero: folds
6ae471b6: folds
c4b26458: folds
5183e732: raises $0.05 to $0.1
45eea39e: folds
f4c2b883: folds
Uncalled bet ($0.05) returned to 5183e732
*** SHOWDOWN ***
5183e732 collected $0.12 from pot
*** SUMMARY ***
Total pot $0.12 | Rake $0 | Jackpot $0 | Bingo $0 | Fortune $0 | Tax $0
Seat 1: 5183e732 (button) collected ($0.12)
Seat 2: 45eea39e (small blind) folded before Flop
Seat 3: f4c2b883 (big blind) folded before Flop
Seat 4: Hero folded before Flop (didn't bet)
Seat 5: 6ae471b6 folded before Flop (didn't bet)
Seat 6: c4b26458 folded before Flop (didn't bet)


Poker Hand #RC3811177062: Hold'em No Limit ($0.02/$0.05) - 2025/08/16 12:31:38
Table 'RushAndCash842322' 6-max Seat #1 is the button
Seat 1: 3b1d83b5 ($5.04 in chips)
Seat 2: 1c015352 ($5.05 in chips)
Seat 3: 18857e14 ($5.15 in chips)
Seat 4: c4b26458 ($5.57 in chips)
Seat 5: e93099b5 ($5.14 in chips)
Seat 6: Hero ($12.1 in chips)
1c015352: posts small blind $0.02
18857e14: posts big blind $0.05
*** HOLE CARDS ***
Dealt to 3b1d83b5 
Dealt to 1c015352 
Dealt to 18857e14 
Dealt to c4b26458 
Dealt to e93099b5 
Dealt to Hero [9h 9s]
c4b26458: raises $0.05 to $0.1
e93099b5: folds
Hero: raises $0.05 to $0.15
3b1d83b5: folds
1c015352: folds
18857e14: folds
c4b26458: calls $0.05
*** FLOP *** [Kd Qc Qd]
c4b26458: checks
Hero: checks
*** TURN *** [Kd Qc Qd] [Ac]
c4b26458: bets $0.19
Hero: folds
Uncalled bet ($0.19) returned to c4b26458
*** SHOWDOWN ***
c4b26458 collected $0.36 from pot
*** SUMMARY ***
Total pot $0.37 | Rake $0.01 | Jackpot $0 | Bingo $0 | Fortune $0 | Tax $0
Board [Kd Qc Qd Ac]
Seat 1: 3b1d83b5 (button) folded before Flop (didn't bet)
Seat 2: 1c015352 (small blind) folded before Flop
Seat 3: 18857e14 (big blind) folded before Flop
Seat 4: c4b26458 won ($0.36)
Seat 5: e93099b5 folded before Flop (didn't bet)
Seat 6: Hero folded on the Turn


Poker Hand #RC3811176923: Hold'em No Limit ($0.02/$0.05) - 2025/08/16 12:31:05
Table 'RushAndCash842183' 6-max Seat #1 is the button
Seat 1: Hero ($12.25 in chips)
Seat 2: 3b1d83b5 ($4.85 in chips)
Seat 3: 154c971f ($3.53 in chips)
Seat 4: 1597673c ($5.03 in chips)
Seat 5: 872c9862 ($12.54 in chips)
Seat 6: ae25512b ($3.58 in chips)
3b1d83b5: posts small blind $0.02
154c971f: posts big blind $0.05
*** HOLE CARDS ***
Dealt to Hero [9h 7s]
Dealt to 3b1d83b5 
Dealt to 154c971f 
Dealt to 1597673c 
Dealt to 872c9862 
Dealt to ae25512b 
1597673c: folds
872c9862: folds
ae25512b: folds
Hero: raises $0.05 to $0.1
3b1d83b5: calls $0.08
154c971f: folds
*** FLOP *** [Ks 3d 6d]
3b1d83b5: checks
Hero: checks
*** TURN *** [Ks 3d 6d] [5d]
3b1d83b5: checks
Hero: checks
*** RIVER *** [Ks 3d 6d 5d] [3c]
3b1d83b5: checks
Hero: bets $0.05
3b1d83b5: calls $0.05
Hero: shows [9h 7s] (a pair of Threes)
3b1d83b5: shows [Jd Qc] (a pair of Threes)
*** SHOWDOWN ***
3b1d83b5 collected $0.34 from pot
*** SUMMARY ***
Total pot $0.35 | Rake $0.01 | Jackpot $0 | Bingo $0 | Fortune $0 | Tax $0
Board [Ks 3d 6d 5d 3c]
Seat 1: Hero (button) showed [9h 7s] and lost with a pair of Threes
Seat 2: 3b1d83b5 (small blind) showed [Jd Qc] and won ($0.34) with a pair of Threes
Seat 3: 154c971f (big blind) folded before Flop
Seat 4: 1597673c folded before Flop (didn't bet)
Seat 5: 872c9862 folded before Flop (didn't bet)
Seat 6: ae25512b folded before Flop (didn't bet)


Poker Hand #RC3811176748: Hold'em No Limit ($0.02/$0.05) - 2025/08/16 12:30:20
Table 'RushAndCash842008' 6-max Seat #1 is the button
Seat 1: bea85404 ($5 in chips)
Seat 2: 73c308f9 ($6.76 in chips)
Seat 3: Hero ($12.6 in chips)
Seat 4: 786d9656 ($7.97 in chips)
Seat 5: a13cb32e ($5.21 in chips)
Seat 6: 4b999ee3 ($2.43 in chips)
73c308f9: posts small blind $0.02
Hero: posts big blind $0.05
*** HOLE CARDS ***
Dealt to bea85404 
Dealt to 73c308f9 
Dealt to Hero [Ah Qd]
Dealt to 786d9656 
Dealt to a13cb32e 
Dealt to 4b999ee3 
786d9656: raises $0.06 to $0.11
a13cb32e: raises $0.24 to $0.35
4b999ee3: folds
bea85404: folds
73c308f9: folds
Hero: calls $0.3
786d9656: folds
*** FLOP *** [7h 6s 7c]
Hero: checks
a13cb32e: bets $0.25
Hero: folds
Uncalled bet ($0.25) returned to a13cb32e
*** SHOWDOWN ***
a13cb32e collected $0.79 from pot
*** SUMMARY ***
Total pot $0.83 | Rake $0.04 | Jackpot $0 | Bingo $0 | Fortune $0 | Tax $0
Board [7h 6s 7c]
Seat 1: bea85404 (button) folded before Flop (didn't bet)
Seat 2: 73c308f9 (small blind) folded before Flop
Seat 3: Hero (big blind) folded on the Flop
Seat 4: 786d9656 folded before Flop
Seat 5: a13cb32e won ($0.79)
Seat 6: 4b999ee3 folded before Flop (didn't bet)


Poker Hand #RC3811176713: Hold'em No Limit ($0.02/$0.05) - 2025/08/16 12:30:10
Table 'RushAndCash841973' 6-max Seat #1 is the button
Seat 1: c0cdc178 ($6.01 in chips)
Seat 2: Hero ($12.62 in chips)
Seat 3: d9cc8864 ($10.91 in chips)
Seat 4: e3a8fca9 ($8.31 in chips)
Seat 5: d876bedd ($8.32 in chips)
Seat 6: 6b261b81 ($3.69 in chips)
Hero: posts small blind $0.02
d9cc8864: posts big blind $0.05
*** HOLE CARDS ***
Dealt to c0cdc178 
Dealt to Hero [Jd 6s]
Dealt to d9cc8864 
Dealt to e3a8fca9 
Dealt to d876bedd 
Dealt to 6b261b81 
e3a8fca9: calls $0.05
d876bedd: folds
6b261b81: folds
c0cdc178: folds
Hero: folds
d9cc8864: checks
*** FLOP *** [2d 8h Qc]
d9cc8864: checks
e3a8fca9: bets $0.06
d9cc8864: folds
Uncalled bet ($0.06) returned to e3a8fca9
*** SHOWDOWN ***
e3a8fca9 collected $0.12 from pot
*** SUMMARY ***
Total pot $0.12 | Rake $0 | Jackpot $0 | Bingo $0 | Fortune $0 | Tax $0
Board [2d 8h Qc]
Seat 1: c0cdc178 (button) folded before Flop (didn't bet)
Seat 2: Hero (small blind) folded before Flop
Seat 3: d9cc8864 (big blind) folded on the Flop
Seat 4: e3a8fca9 won ($0.12)
Seat 5: d876bedd folded before Flop (didn't bet)
Seat 6: 6b261b81 folded before Flop (didn't bet)


Poker Hand #RC3811176700: Hold'em No Limit ($0.02/$0.05) - 2025/08/16 12:30:07
Table 'RushAndCash841960' 6-max Seat #1 is the button
Seat 1: 786d9656 ($7.97 in chips)
Seat 2: 73c308f9 ($6.85 in chips)
Seat 3: db8a363d ($5 in chips)
Seat 4: 35089a1b ($5 in chips)
Seat 5: Hero ($12.62 in chips)
Seat 6: 19480dc1 ($5.36 in chips)
73c308f9: posts small blind $0.02
db8a363d: posts big blind $0.05
*** HOLE CARDS ***
Dealt to 786d9656 
Dealt to 73c308f9 
Dealt to db8a363d 
Dealt to 35089a1b 
Dealt to Hero [3h 6s]
Dealt to 19480dc1 
35089a1b: raises $0.05 to $0.1
Hero: folds
19480dc1: folds
786d9656: folds
73c308f9: folds
db8a363d: folds
Uncalled bet ($0.05) returned to 35089a1b
*** SHOWDOWN ***
35089a1b collected $0.12 from pot
*** SUMMARY ***
Total pot $0.12 | Rake $0 | Jackpot $0 | Bingo $0 | Fortune $0 | Tax $0
Seat 1: 786d9656 (button) folded before Flop (didn't bet)
Seat 2: 73c308f9 (small blind) folded before Flop
Seat 3: db8a363d (big blind) folded before Flop
Seat 4: 35089a1b collected ($0.12)
Seat 5: Hero folded before Flop (didn't bet)
Seat 6: 19480dc1 folded before Flop (didn't bet)


Poker Hand #RC3811176690: Hold'em No Limit ($0.02/$0.05) - 2025/08/16 12:30:03
Table 'RushAndCash841950' 6-max Seat #1 is the button
Seat 1: f8911f74 ($4.02 in chips)
Seat 2: ab30512 ($9.27 in chips)
Seat 3: d876bedd ($8.37 in chips)
Seat 4: Hero ($12.62 in chips)
Seat 5: 319f9ef4 ($11.83 in chips)
Seat 6: db8a363d ($5 in chips)
ab30512: posts small blind $0.02
d876bedd: posts big blind $0.05
*** HOLE CARDS ***
Dealt to f8911f74 
Dealt to ab30512 
Dealt to d876bedd 
Dealt to Hero [9d 6h]
Dealt to 319f9ef4 
Dealt to db8a363d 
Hero: folds
319f9ef4: raises $0.05 to $0.1
db8a363d: folds
f8911f74: folds
ab30512: folds
d876bedd: folds
Uncalled bet ($0.05) returned to 319f9ef4
*** SHOWDOWN ***
319f9ef4 collected $0.12 from pot
*** SUMMARY ***
Total pot $0.12 | Rake $0 | Jackpot $0 | Bingo $0 | Fortune $0 | Tax $0
Seat 1: f8911f74 (button) folded before Flop (didn't bet)
Seat 2: ab30512 (small blind) folded before Flop
Seat 3: d876bedd (big blind) folded before Flop
Seat 4: Hero folded before Flop (didn't bet)
Seat 5: 319f9ef4 collected ($0.12)
Seat 6: db8a363d folded before Flop (didn't bet)


Poker Hand #RC3811176456: Hold'em No Limit ($0.02/$0.05) - 2025/08/16 12:29:06
Table 'RushAndCash841716' 6-max Seat #1 is the button
Seat 1: cf40af3 ($7.63 in chips)
Seat 2: 43cdc0ba ($5 in chips)
Seat 3: Hero ($12.51 in chips)
Seat 4: c4b26458 ($5 in chips)
Seat 5: 9898070d ($4.85 in chips)
Seat 6: f8911f74 ($4.12 in chips)
43cdc0ba: posts small blind $0.02
Hero: posts big blind $0.05
*** HOLE CARDS ***
Dealt to cf40af3 
Dealt to 43cdc0ba 
Dealt to Hero [Kh Jh]
Dealt to c4b26458 
Dealt to 9898070d 
Dealt to f8911f74 
c4b26458: folds
9898070d: folds
f8911f74: raises $0.05 to $0.1
cf40af3: folds
43cdc0ba: folds
Hero: calls $0.05
*** FLOP *** [4s 3d Jd]
Hero: bets $0.11
f8911f74: folds
Uncalled bet ($0.11) returned to Hero
*** SHOWDOWN ***
Hero collected $0.21 from pot
*** SUMMARY ***
Total pot $0.22 | Rake $0.01 | Jackpot $0 | Bingo $0 | Fortune $0 | Tax $0
Board [4s 3d Jd]
Seat 1: cf40af3 (button) folded before Flop (didn't bet)
Seat 2: 43cdc0ba (small blind) folded before Flop
Seat 3: Hero (big blind) won ($0.21)
Seat 4: c4b26458 folded before Flop (didn't bet)
Seat 5: 9898070d folded before Flop (didn't bet)
Seat 6: f8911f74 folded on the Flop


Poker Hand #RC3811176403: Hold'em No Limit ($0.02/$0.05) - 2025/08/16 12:28:54
Table 'RushAndCash841663' 6-max Seat #1 is the button
Seat 1: 4698ae62 ($9.83 in chips)
Seat 2: Hero ($12.53 in chips)
Seat 3: a84d3f6d ($11.63 in chips)
Seat 4: d1763fe4 ($5 in chips)
Seat 5: af718e4b ($25.54 in chips)
Seat 6: 1f0f0220 ($10.77 in chips)
Hero: posts small blind $0.02
a84d3f6d: posts big blind $0.05
*** HOLE CARDS ***
Dealt to 4698ae62 
Dealt to Hero [6h Jh]
Dealt to a84d3f6d 
Dealt to d1763fe4 
Dealt to af718e4b 
Dealt to 1f0f0220 
d1763fe4: folds
af718e4b: folds
1f0f0220: folds
4698ae62: folds
Hero: folds
Uncalled bet ($0.03) returned to a84d3f6d
*** SHOWDOWN ***
a84d3f6d collected $0.04 from pot
*** SUMMARY ***
Total pot $0.04 | Rake $0 | Jackpot $0 | Bingo $0 | Fortune $0 | Tax $0
Seat 1: 4698ae62 (button) folded before Flop (didn't bet)
Seat 2: Hero (small blind) folded before Flop
Seat 3: a84d3f6d (big blind) collected ($0.04)
Seat 4: d1763fe4 folded before Flop (didn't bet)
Seat 5: af718e4b folded before Flop (didn't bet)
Seat 6: 1f0f0220 folded before Flop (didn't bet)


Poker Hand #RC3811176389: Hold'em No Limit ($0.02/$0.05) - 2025/08/16 12:28:50
Table 'RushAndCash841649' 6-max Seat #1 is the button
Seat 1: 3b1d83b5 ($5.25 in chips)
Seat 2: e8f2f382 ($5 in chips)
Seat 3: aa60f413 ($12.71 in chips)
Seat 4: Hero ($12.53 in chips)
Seat 5: f6a47e9f ($6.9 in chips)
Seat 6: 1a5c24ee ($5.19 in chips)
e8f2f382: posts small blind $0.02
aa60f413: posts big blind $0.05
*** HOLE CARDS ***
Dealt to 3b1d83b5 
Dealt to e8f2f382 
Dealt to aa60f413 
Dealt to Hero [6c 7h]
Dealt to f6a47e9f 
Dealt to 1a5c24ee 
Hero: folds
f6a47e9f: raises $0.05 to $0.1
1a5c24ee: folds
3b1d83b5: folds
e8f2f382: calls $0.08
aa60f413: raises $0.45 to $0.55
f6a47e9f: calls $0.45
e8f2f382: folds
*** FLOP *** [5s Kd 2d]
aa60f413: bets $0.4
f6a47e9f: raises $0.66 to $1.06
aa60f413: raises $11.1 to $12.16 and is all-in
f6a47e9f: calls $5.29 and is all-in
Uncalled bet ($5.81) returned to aa60f413
aa60f413: shows [Ks As] (a pair of Kings)
f6a47e9f: shows [5h Kh] (two pair, Kings and Fives)
*** TURN *** [5s Kd 2d] [2s]
*** RIVER *** [5s Kd 2d 2s] [Th]
*** SHOWDOWN ***
f6a47e9f collected $13.68 from pot
*** SUMMARY ***
Total pot $13.9 | Rake $0.15 | Jackpot $0.07 | Bingo $0 | Fortune $0 | Tax $0
Board [5s Kd 2d 2s Th]
Seat 1: 3b1d83b5 (button) folded before Flop (didn't bet)
Seat 2: e8f2f382 (small blind) folded before Flop
Seat 3: aa60f413 (big blind) showed [Ks As] and lost with two pair, Kings and Twos
Seat 4: Hero folded before Flop (didn't bet)
Seat 5: f6a47e9f showed [5h Kh] and won ($13.68) with two pair, Kings and Fives
Seat 6: 1a5c24ee folded before Flop (didn't bet)


Poker Hand #RC3811176333: Hold'em No Limit ($0.02/$0.05) - 2025/08/16 12:28:38
Table 'RushAndCash841593' 6-max Seat #1 is the button
Seat 1: Hero ($12.53 in chips)
Seat 2: 48f3a354 ($5.07 in chips)
Seat 3: a2fa3bd6 ($5.35 in chips)
Seat 4: 73c308f9 ($7.21 in chips)
Seat 5: 12faa325 ($4.93 in chips)
Seat 6: 53ca4089 ($6.96 in chips)
48f3a354: posts small blind $0.02
a2fa3bd6: posts big blind $0.05
*** HOLE CARDS ***
Dealt to Hero [6d Qd]
Dealt to 48f3a354 
Dealt to a2fa3bd6 
Dealt to 73c308f9 
Dealt to 12faa325 
Dealt to 53ca4089 
73c308f9: folds
12faa325: raises $0.1 to $0.15
53ca4089: folds
Hero: folds
48f3a354: folds
a2fa3bd6: raises $0.45 to $0.6
12faa325: calls $0.45
*** FLOP *** [2c Ts Js]
a2fa3bd6: bets $0.41
12faa325: calls $0.41
*** TURN *** [2c Ts Js] [8s]
a2fa3bd6: checks
12faa325: bets $1.02
a2fa3bd6: calls $1.02
*** RIVER *** [2c Ts Js 8s] [Qh]
a2fa3bd6: checks
12faa325: checks
a2fa3bd6: shows [Kd Kh] (a pair of Kings)
12faa325: shows [Tc Jc] (two pair, Jacks and Tens)
*** SHOWDOWN ***
12faa325 collected $3.86 from pot
*** SUMMARY ***
Total pot $4.08 | Rake $0.15 | Jackpot $0.07 | Bingo $0 | Fortune $0 | Tax $0
Board [2c Ts Js 8s Qh]
Seat 1: Hero (button) folded before Flop (didn't bet)
Seat 2: 48f3a354 (small blind) folded before Flop
Seat 3: a2fa3bd6 (big blind) showed [Kd Kh] and lost with a pair of Kings
Seat 4: 73c308f9 folded before Flop (didn't bet)
Seat 5: 12faa325 showed [Tc Jc] and won ($3.86) with two pair, Jacks and Tens
Seat 6: 53ca4089 folded before Flop (didn't bet)


Poker Hand #RC3811176012: Hold'em No Limit ($0.02/$0.05) - 2025/08/16 12:27:27
Table 'RushAndCash841272' 6-max Seat #1 is the button
Seat 1: ec79c726 ($5.07 in chips)
Seat 2: 69ae3444 ($21.09 in chips)
Seat 3: 92006211 ($5 in chips)
Seat 4: Hero ($12.58 in chips)
Seat 5: 53ca4089 ($7.01 in chips)
Seat 6: d526fb63 ($18.2 in chips)
69ae3444: posts small blind $0.02
92006211: posts big blind $0.05
*** HOLE CARDS ***
Dealt to ec79c726 
Dealt to 69ae3444 
Dealt to 92006211 
Dealt to Hero [Th Kc]
Dealt to 53ca4089 
Dealt to d526fb63 
Hero: calls $0.05
53ca4089: calls $0.05
d526fb63: folds
ec79c726: folds
69ae3444: folds
92006211: checks
*** FLOP *** [Qd 3h 7c]
92006211: checks
Hero: checks
53ca4089: checks
*** TURN *** [Qd 3h 7c] [5s]
92006211: checks
Hero: checks
53ca4089: checks
*** RIVER *** [Qd 3h 7c 5s] [Jd]
92006211: checks
Hero: checks
53ca4089: checks
92006211: shows [3s 7s] (two pair, Sevens and Threes)
Hero: shows [Th Kc] (King high)
53ca4089: shows [8h 8c] (a pair of Eights)
*** SHOWDOWN ***
92006211 collected $0.17 from pot
*** SUMMARY ***
Total pot $0.17 | Rake $0 | Jackpot $0 | Bingo $0 | Fortune $0 | Tax $0
Board [Qd 3h 7c 5s Jd]
Seat 1: ec79c726 (button) folded before Flop (didn't bet)
Seat 2: 69ae3444 (small blind) folded before Flop
Seat 3: 92006211 (big blind) showed [3s 7s] and won ($0.17) with two pair, Sevens and Threes
Seat 4: Hero showed [Th Kc] and lost with King high
Seat 5: 53ca4089 showed [8h 8c] and lost with a pair of Eights
Seat 6: d526fb63 folded before Flop (didn't bet)


Poker Hand #RC3811176000: Hold'em No Limit ($0.02/$0.05) - 2025/08/16 12:27:23
Table 'RushAndCash841260' 6-max Seat #1 is the button
Seat 1: 4163df2c ($18.06 in chips)
Seat 2: e6780e8f ($10.29 in chips)
Seat 3: 28989ffe ($4.89 in chips)
Seat 4: 4bb9e6a6 ($5.64 in chips)
Seat 5: Hero ($12.58 in chips)
Seat 6: 69ae3444 ($21.09 in chips)
e6780e8f: posts small blind $0.02
28989ffe: posts big blind $0.05
*** HOLE CARDS ***
Dealt to 4163df2c 
Dealt to e6780e8f 
Dealt to 28989ffe 
Dealt to 4bb9e6a6 
Dealt to Hero [4c 8s]
Dealt to 69ae3444 
4bb9e6a6: folds
Hero: folds
69ae3444: folds
4163df2c: folds
e6780e8f: raises $0.1 to $0.15
28989ffe: folds
Uncalled bet ($0.1) returned to e6780e8f
*** SHOWDOWN ***
e6780e8f collected $0.1 from pot
*** SUMMARY ***
Total pot $0.1 | Rake $0 | Jackpot $0 | Bingo $0 | Fortune $0 | Tax $0
Seat 1: 4163df2c (button) folded before Flop (didn't bet)
Seat 2: e6780e8f (small blind) collected ($0.1)
Seat 3: 28989ffe (big blind) folded before Flop
Seat 4: 4bb9e6a6 folded before Flop (didn't bet)
Seat 5: Hero folded before Flop (didn't bet)
Seat 6: 69ae3444 folded before Flop (didn't bet)


Poker Hand #RC3811175947: Hold'em No Limit ($0.02/$0.05) - 2025/08/16 12:27:12
Table 'RushAndCash841207' 6-max Seat #1 is the button
Seat 1: 9ff5c314 ($5.24 in chips)
Seat 2: 82c973be ($4.84 in chips)
Seat 3: c86d0ea5 ($5.07 in chips)
Seat 4: b807fa2a ($2.68 in chips)
Seat 5: d290cf59 ($5.59 in chips)
Seat 6: Hero ($12.51 in chips)
82c973be: posts small blind $0.02
c86d0ea5: posts big blind $0.05
*** HOLE CARDS ***
Dealt to 9ff5c314 
Dealt to 82c973be 
Dealt to c86d0ea5 
Dealt to b807fa2a 
Dealt to d290cf59 
Dealt to Hero [Kh Ac]
b807fa2a: folds
d290cf59: folds
Hero: raises $0.06 to $0.11
9ff5c314: folds
82c973be: folds
c86d0ea5: folds
Uncalled bet ($0.06) returned to Hero
*** SHOWDOWN ***
Hero collected $0.12 from pot
*** SUMMARY ***
Total pot $0.12 | Rake $0 | Jackpot $0 | Bingo $0 | Fortune $0 | Tax $0
Seat 1: 9ff5c314 (button) folded before Flop (didn't bet)
Seat 2: 82c973be (small blind) folded before Flop
Seat 3: c86d0ea5 (big blind) folded before Flop
Seat 4: b807fa2a folded before Flop (didn't bet)
Seat 5: d290cf59 folded before Flop (didn't bet)
Seat 6: Hero collected ($0.12)


Poker Hand #RC3811175874: Hold'em No Limit ($0.02/$0.05) - 2025/08/16 12:26:53
Table 'RushAndCash841134' 6-max Seat #1 is the button
Seat 1: Hero ($12.44 in chips)
Seat 2: 70a9354e ($16.06 in chips)
Seat 3: 28989ffe ($4.96 in chips)
Seat 4: b4726d8e ($8.41 in chips)
Seat 5: 63def097 ($10.81 in chips)
Seat 6: 8fb01fb1 ($8.19 in chips)
70a9354e: posts small blind $0.02
28989ffe: posts big blind $0.05
*** HOLE CARDS ***
Dealt to Hero [5h Kc]
Dealt to 70a9354e 
Dealt to 28989ffe 
Dealt to b4726d8e 
Dealt to 63def097 
Dealt to 8fb01fb1 
b4726d8e: folds
63def097: folds
8fb01fb1: folds
Hero: raises $0.05 to $0.1
70a9354e: folds
28989ffe: folds
Uncalled bet ($0.05) returned to Hero
*** SHOWDOWN ***
Hero collected $0.12 from pot
*** SUMMARY ***
Total pot $0.12 | Rake $0 | Jackpot $0 | Bingo $0 | Fortune $0 | Tax $0
Seat 1: Hero (button) collected ($0.12)
Seat 2: 70a9354e (small blind) folded before Flop
Seat 3: 28989ffe (big blind) folded before Flop
Seat 4: b4726d8e folded before Flop (didn't bet)
Seat 5: 63def097 folded before Flop (didn't bet)
Seat 6: 8fb01fb1 folded before Flop (didn't bet)


Poker Hand #RC3811175745: Hold'em No Limit ($0.02/$0.05) - 2025/08/16 12:26:26
Table 'RushAndCash841005' 6-max Seat #1 is the button
Seat 1: e6eebbd8 ($9.95 in chips)
Seat 2: Hero ($12.49 in chips)
Seat 3: 8fb01fb1 ($8.14 in chips)
Seat 4: 8d5c5cb1 ($5.08 in chips)
Seat 5: f9bd9c9a ($6.16 in chips)
Seat 6: 80415c7b ($5.16 in chips)
Hero: posts small blind $0.02
8fb01fb1: posts big blind $0.05
*** HOLE CARDS ***
Dealt to e6eebbd8 
Dealt to Hero [3h 2h]
Dealt to 8fb01fb1 
Dealt to 8d5c5cb1 
Dealt to f9bd9c9a 
Dealt to 80415c7b 
8d5c5cb1: folds
f9bd9c9a: folds
80415c7b: folds
e6eebbd8: folds
Hero: calls $0.03
8fb01fb1: raises $0.16 to $0.21
Hero: folds
Uncalled bet ($0.16) returned to 8fb01fb1
*** SHOWDOWN ***
8fb01fb1 collected $0.1 from pot
*** SUMMARY ***
Total pot $0.1 | Rake $0 | Jackpot $0 | Bingo $0 | Fortune $0 | Tax $0
Seat 1: e6eebbd8 (button) folded before Flop (didn't bet)
Seat 2: Hero (small blind) folded before Flop
Seat 3: 8fb01fb1 (big blind) collected ($0.1)
Seat 4: 8d5c5cb1 folded before Flop (didn't bet)
Seat 5: f9bd9c9a folded before Flop (didn't bet)
Seat 6: 80415c7b folded before Flop (didn't bet)


Poker Hand #RC3811175452: Hold'em No Limit ($0.02/$0.05) - 2025/08/16 12:25:19
Table 'RushAndCash840712' 6-max Seat #1 is the button
Seat 1: db8a363d ($4.18 in chips)
Seat 2: e6eebbd8 ($10.26 in chips)
Seat 3: Hero ($13.21 in chips)
Seat 4: ae25512b ($2.58 in chips)
Seat 5: 73c308f9 ($6.38 in chips)
Seat 6: dea14c7d ($5.07 in chips)
e6eebbd8: posts small blind $0.02
Hero: posts big blind $0.05
*** HOLE CARDS ***
Dealt to db8a363d 
Dealt to e6eebbd8 
Dealt to Hero [7s 8s]
Dealt to ae25512b 
Dealt to 73c308f9 
Dealt to dea14c7d 
ae25512b: raises $0.05 to $0.1
73c308f9: raises $0.21 to $0.31
dea14c7d: folds
db8a363d: folds
e6eebbd8: calls $0.29
Hero: calls $0.26
ae25512b: calls $0.21
*** FLOP *** [Jc 2s 8d]
e6eebbd8: checks
Hero: checks
ae25512b: checks
73c308f9: bets $0.41
e6eebbd8: folds
Hero: calls $0.41
ae25512b: folds
*** TURN *** [Jc 2s 8d] [Kd]
Hero: checks
73c308f9: bets $1.55
Hero: folds
Uncalled bet ($1.55) returned to 73c308f9
*** SHOWDOWN ***
73c308f9 collected $1.89 from pot
*** SUMMARY ***
Total pot $2.06 | Rake $0.1 | Jackpot $0.07 | Bingo $0 | Fortune $0 | Tax $0
Board [Jc 2s 8d Kd]
Seat 1: db8a363d (button) folded before Flop (didn't bet)
Seat 2: e6eebbd8 (small blind) folded on the Flop
Seat 3: Hero (big blind) folded on the Turn
Seat 4: ae25512b folded on the Flop
Seat 5: 73c308f9 won ($1.89)
Seat 6: dea14c7d folded before Flop (didn't bet)


Poker Hand #RC3811175439: Hold'em No Limit ($0.02/$0.05) - 2025/08/16 12:25:16
Table 'RushAndCash840699' 6-max Seat #1 is the button
Seat 1: 673eb114 ($5.57 in chips)
Seat 2: 4b999ee3 ($2.22 in chips)
Seat 3: fd0ae030 ($6.01 in chips)
Seat 4: Hero ($13.21 in chips)
Seat 5: 16962fac ($9.2 in chips)
Seat 6: 41c92275 ($5 in chips)
4b999ee3: posts small blind $0.02
fd0ae030: posts big blind $0.05
*** HOLE CARDS ***
Dealt to 673eb114 
Dealt to 4b999ee3 
Dealt to fd0ae030 
Dealt to Hero [4d 2d]
Dealt to 16962fac 
Dealt to 41c92275 
Hero: folds
16962fac: folds
41c92275: folds
673eb114: raises $0.07 to $0.12
4b999ee3: calls $0.1
fd0ae030: raises $0.58 to $0.7
673eb114: folds
4b999ee3: folds
Uncalled bet ($0.58) returned to fd0ae030
*** SHOWDOWN ***
fd0ae030 collected $0.35 from pot
*** SUMMARY ***
Total pot $0.36 | Rake $0.01 | Jackpot $0 | Bingo $0 | Fortune $0 | Tax $0
Seat 1: 673eb114 (button) folded before Flop
Seat 2: 4b999ee3 (small blind) folded before Flop
Seat 3: fd0ae030 (big blind) collected ($0.35)
Seat 4: Hero folded before Flop (didn't bet)
Seat 5: 16962fac folded before Flop (didn't bet)
Seat 6: 41c92275 folded before Flop (didn't bet)


Poker Hand #RC3811175426: Hold'em No Limit ($0.02/$0.05) - 2025/08/16 12:25:12
Table 'RushAndCash840686' 6-max Seat #1 is the button
Seat 1: d876bedd ($8.13 in chips)
Seat 2: 436e1fd ($4.98 in chips)
Seat 3: 74bbad5f ($4.77 in chips)
Seat 4: Hero ($13.21 in chips)
Seat 5: 73c308f9 ($6.38 in chips)
Seat 6: 872c9862 ($13.16 in chips)
436e1fd: posts small blind $0.02
74bbad5f: posts big blind $0.05
*** HOLE CARDS ***
Dealt to d876bedd 
Dealt to 436e1fd 
Dealt to 74bbad5f 
Dealt to Hero [Td 9s]
Dealt to 73c308f9 
Dealt to 872c9862 
Hero: folds
73c308f9: folds
872c9862: folds
d876bedd: raises $0.05 to $0.1
436e1fd: folds
74bbad5f: calls $0.05
*** FLOP *** [Qd Kd Jd]
74bbad5f: checks
d876bedd: checks
*** TURN *** [Qd Kd Jd] [Ac]
74bbad5f: bets $0.15
d876bedd: calls $0.15
*** RIVER *** [Qd Kd Jd Ac] [4s]
74bbad5f: checks
d876bedd: checks
74bbad5f: shows [Ks 7h] (a pair of Kings)
d876bedd: shows [Qs Jc] (two pair, Queens and Jacks)
*** SHOWDOWN ***
d876bedd collected $0.5 from pot
*** SUMMARY ***
Total pot $0.52 | Rake $0.02 | Jackpot $0 | Bingo $0 | Fortune $0 | Tax $0
Board [Qd Kd Jd Ac 4s]
Seat 1: d876bedd (button) showed [Qs Jc] and won ($0.5) with two pair, Queens and Jacks
Seat 2: 436e1fd (small blind) folded before Flop
Seat 3: 74bbad5f (big blind) showed [Ks 7h] and lost with a pair of Kings
Seat 4: Hero folded before Flop (didn't bet)
Seat 5: 73c308f9 folded before Flop (didn't bet)
Seat 6: 872c9862 folded before Flop (didn't bet)


Poker Hand #RC3811175332: Hold'em No Limit ($0.02/$0.05) - 2025/08/16 12:24:46
Table 'RushAndCash840592' 6-max Seat #1 is the button
Seat 1: e5075287 ($5.96 in chips)
Seat 2: Hero ($13.04 in chips)
Seat 3: cb8bfe18 ($5 in chips)
Seat 4: 6448bce8 ($5 in chips)
Seat 5: 73c308f9 ($6.51 in chips)
Seat 6: d63b83b8 ($10.5 in chips)
Hero: posts small blind $0.02
cb8bfe18: posts big blind $0.05
*** HOLE CARDS ***
Dealt to e5075287 
Dealt to Hero [Ad Qd]
Dealt to cb8bfe18 
Dealt to 6448bce8 
Dealt to 73c308f9 
Dealt to d63b83b8 
6448bce8: folds
73c308f9: raises $0.08 to $0.13
d63b83b8: folds
e5075287: folds
Hero: raises $0.25 to $0.38
cb8bfe18: folds
73c308f9: folds
Uncalled bet ($0.25) returned to Hero
*** SHOWDOWN ***
Hero collected $0.3 from pot
*** SUMMARY ***
Total pot $0.31 | Rake $0.01 | Jackpot $0 | Bingo $0 | Fortune $0 | Tax $0
Seat 1: e5075287 (button) folded before Flop (didn't bet)
Seat 2: Hero (small blind) collected ($0.3)
Seat 3: cb8bfe18 (big blind) folded before Flop
Seat 4: 6448bce8 folded before Flop (didn't bet)
Seat 5: 73c308f9 folded before Flop
Seat 6: d63b83b8 folded before Flop (didn't bet)


Poker Hand #RC3811175305: Hold'em No Limit ($0.02/$0.05) - 2025/08/16 12:24:39
Table 'RushAndCash840565' 6-max Seat #1 is the button
Seat 1: dce7f224 ($18.11 in chips)
Seat 2: af718e4b ($25.52 in chips)
Seat 3: Hero ($13.09 in chips)
Seat 4: 38159ad1 ($5.05 in chips)
Seat 5: 661b630e ($5.15 in chips)
Seat 6: 8930d038 ($5.73 in chips)
af718e4b: posts small blind $0.02
Hero: posts big blind $0.05
*** HOLE CARDS ***
Dealt to dce7f224 
Dealt to af718e4b 
Dealt to Hero [Th 5d]
Dealt to 38159ad1 
Dealt to 661b630e 
Dealt to 8930d038 
38159ad1: folds
661b630e: raises $0.05 to $0.1
8930d038: folds
dce7f224: raises $0.21 to $0.31
af718e4b: folds
Hero: folds
661b630e: folds
Uncalled bet ($0.21) returned to dce7f224
*** SHOWDOWN ***
dce7f224 collected $0.26 from pot
*** SUMMARY ***
Total pot $0.27 | Rake $0.01 | Jackpot $0 | Bingo $0 | Fortune $0 | Tax $0
Seat 1: dce7f224 (button) collected ($0.26)
Seat 2: af718e4b (small blind) folded before Flop
Seat 3: Hero (big blind) folded before Flop
Seat 4: 38159ad1 folded before Flop (didn't bet)
Seat 5: 661b630e folded before Flop
Seat 6: 8930d038 folded before Flop (didn't bet)


Poker Hand #RC3811175068: Hold'em No Limit ($0.02/$0.05) - 2025/08/16 12:23:41
Table 'RushAndCash840328' 6-max Seat #1 is the button
Seat 1: Hero ($12.84 in chips)
Seat 2: f8d1eed ($5 in chips)
Seat 3: 26636f89 ($2.84 in chips)
Seat 4: 6448bce8 ($5.22 in chips)
Seat 5: af718e4b ($25.64 in chips)
Seat 6: 872c9862 ($13.26 in chips)
f8d1eed: posts small blind $0.02
26636f89: posts big blind $0.05
*** HOLE CARDS ***
Dealt to Hero [Kc Qs]
Dealt to f8d1eed 
Dealt to 26636f89 
Dealt to 6448bce8 
Dealt to af718e4b 
Dealt to 872c9862 
6448bce8: folds
af718e4b: raises $0.07 to $0.12
872c9862: folds
Hero: calls $0.12
f8d1eed: folds
26636f89: calls $0.07
*** FLOP *** [5c Qd 6d]
26636f89: checks
af718e4b: checks
Hero: checks
*** TURN *** [5c Qd 6d] [3h]
26636f89: checks
af718e4b: checks
Hero: bets $0.3
26636f89: folds
af718e4b: folds
Uncalled bet ($0.3) returned to Hero
*** SHOWDOWN ***
Hero collected $0.37 from pot
*** SUMMARY ***
Total pot $0.38 | Rake $0.01 | Jackpot $0 | Bingo $0 | Fortune $0 | Tax $0
Board [5c Qd 6d 3h]
Seat 1: Hero (button) won ($0.37)
Seat 2: f8d1eed (small blind) folded before Flop
Seat 3: 26636f89 (big blind) folded on the Turn
Seat 4: 6448bce8 folded before Flop (didn't bet)
Seat 5: af718e4b folded on the Turn
Seat 6: 872c9862 folded before Flop (didn't bet)


Poker Hand #RC3811175056: Hold'em No Limit ($0.02/$0.05) - 2025/08/16 12:23:38
Table 'RushAndCash840316' 6-max Seat #1 is the button
Seat 1: 18857e14 ($5.05 in chips)
Seat 2: 26636f89 ($2.86 in chips)
Seat 3: 4f12aa47 ($5.27 in chips)
Seat 4: Hero ($12.84 in chips)
Seat 5: f3c409bd ($5.16 in chips)
Seat 6: a73fa84f ($5.04 in chips)
26636f89: posts small blind $0.02
4f12aa47: posts big blind $0.05
*** HOLE CARDS ***
Dealt to 18857e14 
Dealt to 26636f89 
Dealt to 4f12aa47 
Dealt to Hero [Js 3c]
Dealt to f3c409bd 
Dealt to a73fa84f 
Hero: folds
f3c409bd: raises $0.08 to $0.13
a73fa84f: folds
18857e14: folds
26636f89: folds
4f12aa47: calls $0.08
*** FLOP *** [Td 4d 4h]
4f12aa47: checks
f3c409bd: bets $0.1
4f12aa47: folds
Uncalled bet ($0.1) returned to f3c409bd
*** SHOWDOWN ***
f3c409bd collected $0.27 from pot
*** SUMMARY ***
Total pot $0.28 | Rake $0.01 | Jackpot $0 | Bingo $0 | Fortune $0 | Tax $0
Board [Td 4d 4h]
Seat 1: 18857e14 (button) folded before Flop (didn't bet)
Seat 2: 26636f89 (small blind) folded before Flop
Seat 3: 4f12aa47 (big blind) folded on the Flop
Seat 4: Hero folded before Flop (didn't bet)
Seat 5: f3c409bd won ($0.27)
Seat 6: a73fa84f folded before Flop (didn't bet)


Poker Hand #RC3811175011: Hold'em No Limit ($0.02/$0.05) - 2025/08/16 12:23:26
Table 'RushAndCash840271' 6-max Seat #1 is the button
Seat 1: c86d0ea5 ($5 in chips)
Seat 2: ee5d5dac ($5.72 in chips)
Seat 3: 6ad839b8 ($6.23 in chips)
Seat 4: e0547449 ($5.23 in chips)
Seat 5: 436e1fd ($10.1 in chips)
Seat 6: Hero ($12.77 in chips)
ee5d5dac: posts small blind $0.02
6ad839b8: posts big blind $0.05
*** HOLE CARDS ***
Dealt to c86d0ea5 
Dealt to ee5d5dac 
Dealt to 6ad839b8 
Dealt to e0547449 
Dealt to 436e1fd 
Dealt to Hero [Ah Tc]
e0547449: folds
436e1fd: folds
Hero: raises $0.05 to $0.1
c86d0ea5: folds
ee5d5dac: folds
6ad839b8: folds
Uncalled bet ($0.05) returned to Hero
*** SHOWDOWN ***
Hero collected $0.12 from pot
*** SUMMARY ***
Total pot $0.12 | Rake $0 | Jackpot $0 | Bingo $0 | Fortune $0 | Tax $0
Seat 1: c86d0ea5 (button) folded before Flop (didn't bet)
Seat 2: ee5d5dac (small blind) folded before Flop
Seat 3: 6ad839b8 (big blind) folded before Flop
Seat 4: e0547449 folded before Flop (didn't bet)
Seat 5: 436e1fd folded before Flop (didn't bet)
Seat 6: Hero collected ($0.12)


Poker Hand #RC3811174994: Hold'em No Limit ($0.02/$0.05) - 2025/08/16 12:23:22
Table 'RushAndCash840254' 6-max Seat #1 is the button
Seat 1: 2684d7a4 ($5 in chips)
Seat 2: dc6b3f2e ($6.19 in chips)
Seat 3: c21dca76 ($3.92 in chips)
Seat 4: f44e7589 ($4.94 in chips)
Seat 5: 26636f89 ($2.86 in chips)
Seat 6: Hero ($12.77 in chips)
dc6b3f2e: posts small blind $0.02
c21dca76: posts big blind $0.05
*** HOLE CARDS ***
Dealt to 2684d7a4 
Dealt to dc6b3f2e 
Dealt to c21dca76 
Dealt to f44e7589 
Dealt to 26636f89 
Dealt to Hero [3h Th]
f44e7589: raises $0.05 to $0.1
26636f89: folds
Hero: folds
2684d7a4: folds
dc6b3f2e: folds
c21dca76: calls $0.05
*** FLOP *** [2d Qd 5d]
c21dca76: checks
f44e7589: checks
*** TURN *** [2d Qd 5d] [5s]
c21dca76: checks
f44e7589: bets $0.13
c21dca76: folds
Uncalled bet ($0.13) returned to f44e7589
*** SHOWDOWN ***
f44e7589 collected $0.21 from pot
*** SUMMARY ***
Total pot $0.22 | Rake $0.01 | Jackpot $0 | Bingo $0 | Fortune $0 | Tax $0
Board [2d Qd 5d 5s]
Seat 1: 2684d7a4 (button) folded before Flop (didn't bet)
Seat 2: dc6b3f2e (small blind) folded before Flop
Seat 3: c21dca76 (big blind) folded on the Turn
Seat 4: f44e7589 won ($0.21)
Seat 5: 26636f89 folded before Flop (didn't bet)
Seat 6: Hero folded before Flop (didn't bet)


Poker Hand #RC3811174862: Hold'em No Limit ($0.02/$0.05) - 2025/08/16 12:22:49
Table 'RushAndCash840122' 6-max Seat #1 is the button
Seat 1: Hero ($13.19 in chips)
Seat 2: cd245036 ($5.94 in chips)
Seat 3: f8911f74 ($3.65 in chips)
Seat 4: c21dca76 ($3.47 in chips)
Seat 5: ad373012 ($6.19 in chips)
Seat 6: 10398182 ($5 in chips)
cd245036: posts small blind $0.02
f8911f74: posts big blind $0.05
*** HOLE CARDS ***
Dealt to Hero [Qd Jc]
Dealt to cd245036 
Dealt to f8911f74 
Dealt to c21dca76 
Dealt to ad373012 
Dealt to 10398182 
c21dca76: raises $0.05 to $0.1
ad373012: folds
10398182: folds
Hero: raises $0.32 to $0.42
cd245036: folds
f8911f74: folds
c21dca76: raises $3.05 to $3.47 and is all-in
Hero: folds
Uncalled bet ($3.05) returned to c21dca76
*** SHOWDOWN ***
c21dca76 collected $0.87 from pot
*** SUMMARY ***
Total pot $0.91 | Rake $0.04 | Jackpot $0 | Bingo $0 | Fortune $0 | Tax $0
Seat 1: Hero (button) folded before Flop
Seat 2: cd245036 (small blind) folded before Flop
Seat 3: f8911f74 (big blind) folded before Flop
Seat 4: c21dca76 collected ($0.87)
Seat 5: ad373012 folded before Flop (didn't bet)
Seat 6: 10398182 folded before Flop (didn't bet)


Poker Hand #RC3811174847: Hold'em No Limit ($0.02/$0.05) - 2025/08/16 12:22:45
Table 'RushAndCash840107' 6-max Seat #1 is the button
Seat 1: 8d5c5cb1 ($5.16 in chips)
Seat 2: 7d698db1 ($5.09 in chips)
Seat 3: 73c308f9 ($5.6 in chips)
Seat 4: Hero ($13.19 in chips)
Seat 5: 60ffc042 ($5.51 in chips)
Seat 6: b7caf1ee ($9.22 in chips)
7d698db1: posts small blind $0.02
73c308f9: posts big blind $0.05
*** HOLE CARDS ***
Dealt to 8d5c5cb1 
Dealt to 7d698db1 
Dealt to 73c308f9 
Dealt to Hero [9s 8c]
Dealt to 60ffc042 
Dealt to b7caf1ee 
Hero: folds
60ffc042: raises $0.07 to $0.12
b7caf1ee: folds
8d5c5cb1: folds
7d698db1: calls $0.1
73c308f9: folds
*** FLOP *** [4h 4d Jh]
7d698db1: checks
60ffc042: checks
*** TURN *** [4h 4d Jh] [7s]
7d698db1: checks
60ffc042: checks
*** RIVER *** [4h 4d Jh 7s] [6d]
7d698db1: bets $0.29
60ffc042: folds
Uncalled bet ($0.29) returned to 7d698db1
*** SHOWDOWN ***
7d698db1 collected $0.28 from pot
*** SUMMARY ***
Total pot $0.29 | Rake $0.01 | Jackpot $0 | Bingo $0 | Fortune $0 | Tax $0
Board [4h 4d Jh 7s 6d]
Seat 1: 8d5c5cb1 (button) folded before Flop (didn't bet)
Seat 2: 7d698db1 (small blind) won ($0.28)
Seat 3: 73c308f9 (big blind) folded before Flop
Seat 4: Hero folded before Flop (didn't bet)
Seat 5: 60ffc042 folded on the River
Seat 6: b7caf1ee folded before Flop (didn't bet)


Poker Hand #RC3811174833: Hold'em No Limit ($0.02/$0.05) - 2025/08/16 12:22:42
Table 'RushAndCash840093' 6-max Seat #1 is the button
Seat 1: c2e64210 ($16.85 in chips)
Seat 2: Hero ($13.21 in chips)
Seat 3: f3c409bd ($5.23 in chips)
Seat 4: 7d698db1 ($5.02 in chips)
Seat 5: 2a30c87e ($7.46 in chips)
Seat 6: 80415c7b ($6.08 in chips)
Hero: posts small blind $0.02
f3c409bd: posts big blind $0.05
*** HOLE CARDS ***
Dealt to c2e64210 
Dealt to Hero [3h 5c]
Dealt to f3c409bd 
Dealt to 7d698db1 
Dealt to 2a30c87e 
Dealt to 80415c7b 
7d698db1: folds
2a30c87e: raises $0.05 to $0.1
80415c7b: folds
c2e64210: folds
Hero: folds
f3c409bd: folds
Uncalled bet ($0.05) returned to 2a30c87e
*** SHOWDOWN ***
2a30c87e collected $0.12 from pot
*** SUMMARY ***
Total pot $0.12 | Rake $0 | Jackpot $0 | Bingo $0 | Fortune $0 | Tax $0
Seat 1: c2e64210 (button) folded before Flop (didn't bet)
Seat 2: Hero (small blind) folded before Flop
Seat 3: f3c409bd (big blind) folded before Flop
Seat 4: 7d698db1 folded before Flop (didn't bet)
Seat 5: 2a30c87e collected ($0.12)
Seat 6: 80415c7b folded before Flop (didn't bet)


Poker Hand #RC3811174759: Hold'em No Limit ($0.02/$0.05) - 2025/08/16 12:22:24
Table 'RushAndCash840019' 6-max Seat #1 is the button
Seat 1: 5282afa2 ($5.5 in chips)
Seat 2: 4a5bf4d4 ($5.36 in chips)
Seat 3: Hero ($13.19 in chips)
Seat 4: 6176a717 ($5.21 in chips)
Seat 5: e767dc8d ($6.99 in chips)
Seat 6: e88b4b2 ($5.54 in chips)
4a5bf4d4: posts small blind $0.02
Hero: posts big blind $0.05
*** HOLE CARDS ***
Dealt to 5282afa2 
Dealt to 4a5bf4d4 
Dealt to Hero [9d 7c]
Dealt to 6176a717 
Dealt to e767dc8d 
Dealt to e88b4b2 
6176a717: folds
e767dc8d: folds
e88b4b2: folds
5282afa2: folds
4a5bf4d4: folds
Uncalled bet ($0.03) returned to Hero
*** SHOWDOWN ***
Hero collected $0.04 from pot
*** SUMMARY ***
Total pot $0.04 | Rake $0 | Jackpot $0 | Bingo $0 | Fortune $0 | Tax $0
Seat 1: 5282afa2 (button) folded before Flop (didn't bet)
Seat 2: 4a5bf4d4 (small blind) folded before Flop
Seat 3: Hero (big blind) collected ($0.04)
Seat 4: 6176a717 folded before Flop (didn't bet)
Seat 5: e767dc8d folded before Flop (didn't bet)
Seat 6: e88b4b2 folded before Flop (didn't bet)


Poker Hand #RC3811174743: Hold'em No Limit ($0.02/$0.05) - 2025/08/16 12:22:20
Table 'RushAndCash840003' 6-max Seat #1 is the button
Seat 1: f3c409bd ($5.23 in chips)
Seat 2: 5eaf1ccd ($24.38 in chips)
Seat 3: d61bfbfd ($5 in chips)
Seat 4: da69d85 ($2.53 in chips)
Seat 5: b3891cc0 ($23.07 in chips)
Seat 6: Hero ($13.19 in chips)
5eaf1ccd: posts small blind $0.02
d61bfbfd: posts big blind $0.05
*** HOLE CARDS ***
Dealt to f3c409bd 
Dealt to 5eaf1ccd 
Dealt to d61bfbfd 
Dealt to da69d85 
Dealt to b3891cc0 
Dealt to Hero [5h 2h]
da69d85: raises $0.05 to $0.1
b3891cc0: calls $0.1
Hero: folds
f3c409bd: folds
5eaf1ccd: raises $0.52 to $0.62
d61bfbfd: folds
da69d85: calls $0.52
b3891cc0: folds
*** FLOP *** [7h Qh 9d]
5eaf1ccd: bets $0.42
da69d85: calls $0.42
*** TURN *** [7h Qh 9d] [2s]
5eaf1ccd: bets $2.9
da69d85: folds
Uncalled bet ($2.9) returned to 5eaf1ccd
*** SHOWDOWN ***
5eaf1ccd collected $2.06 from pot
*** SUMMARY ***
Total pot $2.23 | Rake $0.1 | Jackpot $0.07 | Bingo $0 | Fortune $0 | Tax $0
Board [7h Qh 9d 2s]
Seat 1: f3c409bd (button) folded before Flop (didn't bet)
Seat 2: 5eaf1ccd (small blind) won ($2.06)
Seat 3: d61bfbfd (big blind) folded before Flop
Seat 4: da69d85 folded on the Turn
Seat 5: b3891cc0 folded before Flop
Seat 6: Hero folded before Flop (didn't bet)


Poker Hand #RC3811134693: Hold'em No Limit ($0.02/$0.05) - 2025/08/16 12:22:08
Table 'RushAndCash839953' 6-max Seat #1 is the button
Seat 1: ca814da5 ($5.21 in chips)
Seat 2: f3cd5849 ($5.78 in chips)
Seat 3: cf20b2f9 ($5.91 in chips)
Seat 4: 713c6250 ($5.67 in chips)
Seat 5: 3a31005b ($13.32 in chips)
Seat 6: Hero ($13.19 in chips)
f3cd5849: posts small blind $0.02
cf20b2f9: posts big blind $0.05
*** HOLE CARDS ***
Dealt to ca814da5 
Dealt to f3cd5849 
Dealt to cf20b2f9 
Dealt to 713c6250 
Dealt to 3a31005b 
Dealt to Hero [Qc Th]
713c6250: raises $0.06 to $0.11
3a31005b: folds
Hero: folds
ca814da5: folds
f3cd5849: folds
cf20b2f9: folds
Uncalled bet ($0.06) returned to 713c6250
*** SHOWDOWN ***
713c6250 collected $0.12 from pot
*** SUMMARY ***
Total pot $0.12 | Rake $0 | Jackpot $0 | Bingo $0 | Fortune $0 | Tax $0
Seat 1: ca814da5 (button) folded before Flop (didn't bet)
Seat 2: f3cd5849 (small blind) folded before Flop
Seat 3: cf20b2f9 (big blind) folded before Flop
Seat 4: 713c6250 collected ($0.12)
Seat 5: 3a31005b folded before Flop (didn't bet)
Seat 6: Hero folded before Flop (didn't bet)


Poker Hand #RC3811134446: Hold'em No Limit ($0.02/$0.05) - 2025/08/16 12:21:07
Table 'RushAndCash839706' 6-max Seat #1 is the button
Seat 1: ce10015c ($5.55 in chips)
Seat 2: ca814da5 ($5.98 in chips)
Seat 3: 4d159d0 ($6.07 in chips)
Seat 4: 2ec3a054 ($19.87 in chips)
Seat 5: d39a7ce4 ($5 in chips)
Seat 6: Hero ($12.51 in chips)
ca814da5: posts small blind $0.02
4d159d0: posts big blind $0.05
*** HOLE CARDS ***
Dealt to ce10015c 
Dealt to ca814da5 
Dealt to 4d159d0 
Dealt to 2ec3a054 
Dealt to d39a7ce4 
Dealt to Hero [8d 9d]
2ec3a054: folds
d39a7ce4: folds
Hero: raises $0.05 to $0.1
ce10015c: folds
ca814da5: raises $0.35 to $0.45
4d159d0: folds
Hero: calls $0.35
*** FLOP *** [Ad 7s 6d]
ca814da5: bets $0.32
Hero: raises $0.96 to $1.28
ca814da5: folds
Uncalled bet ($0.96) returned to Hero
*** SHOWDOWN ***
Hero collected $1.45 from pot
*** SUMMARY ***
Total pot $1.59 | Rake $0.07 | Jackpot $0.07 | Bingo $0 | Fortune $0 | Tax $0
Board [Ad 7s 6d]
Seat 1: ce10015c (button) folded before Flop (didn't bet)
Seat 2: ca814da5 (small blind) folded on the Flop
Seat 3: 4d159d0 (big blind) folded before Flop
Seat 4: 2ec3a054 folded before Flop (didn't bet)
Seat 5: d39a7ce4 folded before Flop (didn't bet)
Seat 6: Hero won ($1.45)


Poker Hand #RC3811134401: Hold'em No Limit ($0.02/$0.05) - 2025/08/16 12:20:56
Table 'RushAndCash839661' 6-max Seat #1 is the button
Seat 1: Hero ($12.51 in chips)
Seat 2: f20f327e ($5.83 in chips)
Seat 3: d1dcc2bd ($7.82 in chips)
Seat 4: b5e17286 ($28.52 in chips)
Seat 5: e6a5b6ba ($14.23 in chips)
Seat 6: fa5b6c27 ($5.13 in chips)
f20f327e: posts small blind $0.02
d1dcc2bd: posts big blind $0.05
*** HOLE CARDS ***
Dealt to Hero [Ts 7d]
Dealt to f20f327e 
Dealt to d1dcc2bd 
Dealt to b5e17286 
Dealt to e6a5b6ba 
Dealt to fa5b6c27 
b5e17286: raises $0.05 to $0.1
e6a5b6ba: folds
fa5b6c27: folds
Hero: folds
f20f327e: folds
d1dcc2bd: folds
Uncalled bet ($0.05) returned to b5e17286
*** SHOWDOWN ***
b5e17286 collected $0.12 from pot
*** SUMMARY ***
Total pot $0.12 | Rake $0 | Jackpot $0 | Bingo $0 | Fortune $0 | Tax $0
Seat 1: Hero (button) folded before Flop (didn't bet)
Seat 2: f20f327e (small blind) folded before Flop
Seat 3: d1dcc2bd (big blind) folded before Flop
Seat 4: b5e17286 collected ($0.12)
Seat 5: e6a5b6ba folded before Flop (didn't bet)
Seat 6: fa5b6c27 folded before Flop (didn't bet)


Poker Hand #RC3811134335: Hold'em No Limit ($0.02/$0.05) - 2025/08/16 12:20:41
Table 'RushAndCash839595' 6-max Seat #1 is the button
Seat 1: ba2360a0 ($4.27 in chips)
Seat 2: Hero ($12.53 in chips)
Seat 3: 3b1d83b5 ($5 in chips)
Seat 4: 526c467b ($9.25 in chips)
Seat 5: 19480dc1 ($5.1 in chips)
Seat 6: 402b3007 ($2.44 in chips)
Hero: posts small blind $0.02
3b1d83b5: posts big blind $0.05
*** HOLE CARDS ***
Dealt to ba2360a0 
Dealt to Hero [5h Qd]
Dealt to 3b1d83b5 
Dealt to 526c467b 
Dealt to 19480dc1 
Dealt to 402b3007 
526c467b: folds
19480dc1: folds
402b3007: raises $0.05 to $0.1
ba2360a0: raises $0.19 to $0.29
Hero: folds
3b1d83b5: folds
402b3007: folds
Uncalled bet ($0.19) returned to ba2360a0
*** SHOWDOWN ***
ba2360a0 collected $0.26 from pot
*** SUMMARY ***
Total pot $0.27 | Rake $0.01 | Jackpot $0 | Bingo $0 | Fortune $0 | Tax $0
Seat 1: ba2360a0 (button) collected ($0.26)
Seat 2: Hero (small blind) folded before Flop
Seat 3: 3b1d83b5 (big blind) folded before Flop
Seat 4: 526c467b folded before Flop (didn't bet)
Seat 5: 19480dc1 folded before Flop (didn't bet)
Seat 6: 402b3007 folded before Flop


Poker Hand #RC3811134178: Hold'em No Limit ($0.02/$0.05) - 2025/08/16 12:19:57
Table 'RushAndCash839438' 6-max Seat #1 is the button
Seat 1: e93099b5 ($5 in chips)
Seat 2: ba2360a0 ($4.4 in chips)
Seat 3: Hero ($12.41 in chips)
Seat 4: 84ca68df ($2.01 in chips)
Seat 5: f4a9cda4 ($5.13 in chips)
Seat 6: f7caa1e7 ($9.13 in chips)
ba2360a0: posts small blind $0.02
Hero: posts big blind $0.05
*** HOLE CARDS ***
Dealt to e93099b5 
Dealt to ba2360a0 
Dealt to Hero [7d 2d]
Dealt to 84ca68df 
Dealt to f4a9cda4 
Dealt to f7caa1e7 
84ca68df: folds
f4a9cda4: folds
f7caa1e7: folds
e93099b5: folds
ba2360a0: raises $0.08 to $0.13
Hero: raises $0.31 to $0.44
ba2360a0: folds
Uncalled bet ($0.31) returned to Hero
*** SHOWDOWN ***
Hero collected $0.25 from pot
*** SUMMARY ***
Total pot $0.26 | Rake $0.01 | Jackpot $0 | Bingo $0 | Fortune $0 | Tax $0
Seat 1: e93099b5 (button) folded before Flop (didn't bet)
Seat 2: ba2360a0 (small blind) folded before Flop
Seat 3: Hero (big blind) collected ($0.25)
Seat 4: 84ca68df folded before Flop (didn't bet)
Seat 5: f4a9cda4 folded before Flop (didn't bet)
Seat 6: f7caa1e7 folded before Flop (didn't bet)


Poker Hand #RC3811134074: Hold'em No Limit ($0.02/$0.05) - 2025/08/16 12:19:28
Table 'RushAndCash839334' 6-max Seat #1 is the button
Seat 1: b0933ab ($6.55 in chips)
Seat 2: c0cdc178 ($5.95 in chips)
Seat 3: db06fb37 ($5.54 in chips)
Seat 4: Hero ($12.56 in chips)
Seat 5: dd892d5c ($4.3 in chips)
Seat 6: 5eaf1ccd ($21.7 in chips)
c0cdc178: posts small blind $0.02
db06fb37: posts big blind $0.05
*** HOLE CARDS ***
Dealt to b0933ab 
Dealt to c0cdc178 
Dealt to db06fb37 
Dealt to Hero [Jh Jd]
Dealt to dd892d5c 
Dealt to 5eaf1ccd 
Hero: raises $0.05 to $0.1
dd892d5c: folds
5eaf1ccd: folds
b0933ab: folds
c0cdc178: calls $0.08
db06fb37: folds
*** FLOP *** [Ks Ac Ah]
c0cdc178: checks
Hero: checks
*** TURN *** [Ks Ac Ah] [7h]
c0cdc178: checks
Hero: bets $0.05
c0cdc178: calls $0.05
*** RIVER *** [Ks Ac Ah 7h] [Qd]
c0cdc178: checks
Hero: checks
c0cdc178: shows [Kd Qc] (two pair, Aces and Kings)
Hero: shows [Jh Jd] (two pair, Aces and Jacks)
*** SHOWDOWN ***
c0cdc178 collected $0.34 from pot
*** SUMMARY ***
Total pot $0.35 | Rake $0.01 | Jackpot $0 | Bingo $0 | Fortune $0 | Tax $0
Board [Ks Ac Ah 7h Qd]
Seat 1: b0933ab (button) folded before Flop (didn't bet)
Seat 2: c0cdc178 (small blind) showed [Kd Qc] and won ($0.34) with two pair, Aces and Kings
Seat 3: db06fb37 (big blind) folded before Flop
Seat 4: Hero showed [Jh Jd] and lost with two pair, Aces and Jacks
Seat 5: dd892d5c folded before Flop (didn't bet)
Seat 6: 5eaf1ccd folded before Flop (didn't bet)


Poker Hand #RC3811134060: Hold'em No Limit ($0.02/$0.05) - 2025/08/16 12:19:25
Table 'RushAndCash839320' 6-max Seat #1 is the button
Seat 1: f7466ced ($4.91 in chips)
Seat 2: 84ca68df ($1.94 in chips)
Seat 3: b5b007b9 ($7.38 in chips)
Seat 4: db06fb37 ($5.54 in chips)
Seat 5: Hero ($12.56 in chips)
Seat 6: 319f9ef4 ($12.59 in chips)
84ca68df: posts small blind $0.02
b5b007b9: posts big blind $0.05
*** HOLE CARDS ***
Dealt to f7466ced 
Dealt to 84ca68df 
Dealt to b5b007b9 
Dealt to db06fb37 
Dealt to Hero [4d 7c]
Dealt to 319f9ef4 
db06fb37: folds
Hero: folds
319f9ef4: raises $0.05 to $0.1
f7466ced: calls $0.1
84ca68df: folds
b5b007b9: calls $0.05
*** FLOP *** [9d 2h 5d]
b5b007b9: checks
319f9ef4: checks
f7466ced: checks
*** TURN *** [9d 2h 5d] [Js]
b5b007b9: checks
319f9ef4: checks
f7466ced: bets $0.24
b5b007b9: calls $0.24
319f9ef4: folds
*** RIVER *** [9d 2h 5d Js] [2s]
b5b007b9: checks
f7466ced: bets $0.4
b5b007b9: folds
Uncalled bet ($0.4) returned to f7466ced
*** SHOWDOWN ***
f7466ced collected $0.76 from pot
*** SUMMARY ***
Total pot $0.8 | Rake $0.04 | Jackpot $0 | Bingo $0 | Fortune $0 | Tax $0
Board [9d 2h 5d Js 2s]
Seat 1: f7466ced (button) won ($0.76)
Seat 2: 84ca68df (small blind) folded before Flop
Seat 3: b5b007b9 (big blind) folded on the River
Seat 4: db06fb37 folded before Flop (didn't bet)
Seat 5: Hero folded before Flop (didn't bet)
Seat 6: 319f9ef4 folded on the Turn


Poker Hand #RC3811133802: Hold'em No Limit ($0.02/$0.05) - 2025/08/16 12:18:21
Table 'RushAndCash839062' 6-max Seat #1 is the button
Seat 1: 1ee209b0 ($6 in chips)
Seat 2: b5b007b9 ($7.51 in chips)
Seat 3: f8984e80 ($2.24 in chips)
Seat 4: 81a34e09 ($5.37 in chips)
Seat 5: 16962fac ($5.23 in chips)
Seat 6: Hero ($12.69 in chips)
b5b007b9: posts small blind $0.02
f8984e80: posts big blind $0.05
*** HOLE CARDS ***
Dealt to 1ee209b0 
Dealt to b5b007b9 
Dealt to f8984e80 
Dealt to 81a34e09 
Dealt to 16962fac 
Dealt to Hero [6d 6s]
81a34e09: folds
16962fac: raises $0.08 to $0.13
Hero: calls $0.13
1ee209b0: folds
b5b007b9: calls $0.11
f8984e80: calls $0.08
*** FLOP *** [Ks Kh Jh]
b5b007b9: checks
f8984e80: checks
16962fac: bets $0.3
Hero: folds
b5b007b9: folds
f8984e80: folds
Uncalled bet ($0.3) returned to 16962fac
*** SHOWDOWN ***
16962fac collected $0.5 from pot
*** SUMMARY ***
Total pot $0.52 | Rake $0.02 | Jackpot $0 | Bingo $0 | Fortune $0 | Tax $0
Board [Ks Kh Jh]
Seat 1: 1ee209b0 (button) folded before Flop (didn't bet)
Seat 2: b5b007b9 (small blind) folded on the Flop
Seat 3: f8984e80 (big blind) folded on the Flop
Seat 4: 81a34e09 folded before Flop (didn't bet)
Seat 5: 16962fac won ($0.5)
Seat 6: Hero folded on the Flop


Poker Hand #RC3811133743: Hold'em No Limit ($0.02/$0.05) - 2025/08/16 12:18:04
Table 'RushAndCash839003' 6-max Seat #1 is the button
Seat 1: Hero ($12.62 in chips)
Seat 2: 37c2e948 ($13.6 in chips)
Seat 3: 154c971f ($3.14 in chips)
Seat 4: fff58a99 ($5.07 in chips)
Seat 5: c3755d18 ($5.02 in chips)
Seat 6: 10398182 ($5.24 in chips)
37c2e948: posts small blind $0.02
154c971f: posts big blind $0.05
*** HOLE CARDS ***
Dealt to Hero [Jd Jh]
Dealt to 37c2e948 
Dealt to 154c971f 
Dealt to fff58a99 
Dealt to c3755d18 
Dealt to 10398182 
fff58a99: folds
c3755d18: folds
10398182: folds
Hero: raises $0.1 to $0.15
37c2e948: folds
154c971f: folds
Uncalled bet ($0.1) returned to Hero
*** SHOWDOWN ***
Hero collected $0.12 from pot
*** SUMMARY ***
Total pot $0.12 | Rake $0 | Jackpot $0 | Bingo $0 | Fortune $0 | Tax $0
Seat 1: Hero (button) collected ($0.12)
Seat 2: 37c2e948 (small blind) folded before Flop
Seat 3: 154c971f (big blind) folded before Flop
Seat 4: fff58a99 folded before Flop (didn't bet)
Seat 5: c3755d18 folded before Flop (didn't bet)
Seat 6: 10398182 folded before Flop (didn't bet)


Poker Hand #RC3811133684: Hold'em No Limit ($0.02/$0.05) - 2025/08/16 12:17:48
Table 'RushAndCash838944' 6-max Seat #1 is the button
Seat 1: f4a9cda4 ($5.34 in chips)
Seat 2: 673eb114 ($5.86 in chips)
Seat 3: Hero ($12.67 in chips)
Seat 4: 2ec3a054 ($19.42 in chips)
Seat 5: 4698ae62 ($5.61 in chips)
Seat 6: 71776f32 ($5.75 in chips)
673eb114: posts small blind $0.02
Hero: posts big blind $0.05
*** HOLE CARDS ***
Dealt to f4a9cda4 
Dealt to 673eb114 
Dealt to Hero [Ts 4h]
Dealt to 2ec3a054 
Dealt to 4698ae62 
Dealt to 71776f32 
2ec3a054: folds
4698ae62: folds
71776f32: folds
f4a9cda4: raises $0.08 to $0.13
673eb114: folds
Hero: folds
Uncalled bet ($0.08) returned to f4a9cda4
*** SHOWDOWN ***
f4a9cda4 collected $0.12 from pot
*** SUMMARY ***
Total pot $0.12 | Rake $0 | Jackpot $0 | Bingo $0 | Fortune $0 | Tax $0
Seat 1: f4a9cda4 (button) collected ($0.12)
Seat 2: 673eb114 (small blind) folded before Flop
Seat 3: Hero (big blind) folded before Flop
Seat 4: 2ec3a054 folded before Flop (didn't bet)
Seat 5: 4698ae62 folded before Flop (didn't bet)
Seat 6: 71776f32 folded before Flop (didn't bet)


Poker Hand #RC3811133656: Hold'em No Limit ($0.02/$0.05) - 2025/08/16 12:17:40
Table 'RushAndCash838916' 6-max Seat #1 is the button
Seat 1: 42836787 ($0.87 in chips)
Seat 2: Hero ($12.69 in chips)
Seat 3: 3d5cc442 ($3.43 in chips)
Seat 4: df91ffd8 ($6.12 in chips)
Seat 5: 8e0daf4 ($5.86 in chips)
Seat 6: 18857e14 ($5.23 in chips)
Hero: posts small blind $0.02
3d5cc442: posts big blind $0.05
*** HOLE CARDS ***
Dealt to 42836787 
Dealt to Hero [As 9c]
Dealt to 3d5cc442 
Dealt to df91ffd8 
Dealt to 8e0daf4 
Dealt to 18857e14 
df91ffd8: folds
8e0daf4: folds
18857e14: raises $0.08 to $0.13
42836787: folds
Hero: folds
3d5cc442: calls $0.08
*** FLOP *** [5h 3c Jh]
3d5cc442: bets $0.1
18857e14: folds
Uncalled bet ($0.1) returned to 3d5cc442
*** SHOWDOWN ***
3d5cc442 collected $0.27 from pot
*** SUMMARY ***
Total pot $0.28 | Rake $0.01 | Jackpot $0 | Bingo $0 | Fortune $0 | Tax $0
Board [5h 3c Jh]
Seat 1: 42836787 (button) folded before Flop (didn't bet)
Seat 2: Hero (small blind) folded before Flop
Seat 3: 3d5cc442 (big blind) won ($0.27)
Seat 4: df91ffd8 folded before Flop (didn't bet)
Seat 5: 8e0daf4 folded before Flop (didn't bet)
Seat 6: 18857e14 folded on the Flop


Poker Hand #RC3811133633: Hold'em No Limit ($0.02/$0.05) - 2025/08/16 12:17:33
Table 'RushAndCash838893' 6-max Seat #1 is the button
Seat 1: be02a95d ($5.8 in chips)
Seat 2: 88f2ba0f ($5 in chips)
Seat 3: 5d37f8e8 ($6.28 in chips)
Seat 4: f58c1fbe ($7.31 in chips)
Seat 5: 5eaf1ccd ($23.21 in chips)
Seat 6: Hero ($12.69 in chips)
88f2ba0f: posts small blind $0.02
5d37f8e8: posts big blind $0.05
*** HOLE CARDS ***
Dealt to be02a95d 
Dealt to 88f2ba0f 
Dealt to 5d37f8e8 
Dealt to f58c1fbe 
Dealt to 5eaf1ccd 
Dealt to Hero [Kc Jh]
f58c1fbe: folds
5eaf1ccd: raises $0.05 to $0.1
Hero: folds
be02a95d: raises $0.27 to $0.37
88f2ba0f: folds
5d37f8e8: folds
5eaf1ccd: raises $0.71 to $1.08
be02a95d: calls $0.71
*** FLOP *** [7d 5d 9s]
5eaf1ccd: bets $0.64
be02a95d: calls $0.64
*** TURN *** [7d 5d 9s] [Tc]
5eaf1ccd: checks
be02a95d: bets $1.76
5eaf1ccd: folds
Uncalled bet ($1.76) returned to be02a95d
*** SHOWDOWN ***
be02a95d collected $3.29 from pot
*** SUMMARY ***
Total pot $3.51 | Rake $0.15 | Jackpot $0.07 | Bingo $0 | Fortune $0 | Tax $0
Board [7d 5d 9s Tc]
Seat 1: be02a95d (button) won ($3.29)
Seat 2: 88f2ba0f (small blind) folded before Flop
Seat 3: 5d37f8e8 (big blind) folded before Flop
Seat 4: f58c1fbe folded before Flop (didn't bet)
Seat 5: 5eaf1ccd folded on the Turn
Seat 6: Hero folded before Flop (didn't bet)


Poker Hand #RC3811133621: Hold'em No Limit ($0.02/$0.05) - 2025/08/16 12:17:29
Table 'RushAndCash838881' 6-max Seat #1 is the button
Seat 1: ab4c77fd ($5.14 in chips)
Seat 2: 8f9f7e16 ($5 in chips)
Seat 3: 82c973be ($1.87 in chips)
Seat 4: f58c1fbe ($7.31 in chips)
Seat 5: Hero ($12.69 in chips)
Seat 6: 16962fac ($5 in chips)
8f9f7e16: posts small blind $0.02
82c973be: posts big blind $0.05
*** HOLE CARDS ***
Dealt to ab4c77fd 
Dealt to 8f9f7e16 
Dealt to 82c973be 
Dealt to f58c1fbe 
Dealt to Hero [6s Ad]
Dealt to 16962fac 
f58c1fbe: folds
Hero: folds
16962fac: raises $0.08 to $0.13
ab4c77fd: folds
8f9f7e16: folds
82c973be: calls $0.08
*** FLOP *** [7d 8d Jh]
82c973be: checks
16962fac: checks
*** TURN *** [7d 8d Jh] [4h]
82c973be: bets $0.1
16962fac: raises $4.77 to $4.87 and is all-in
82c973be: folds
Uncalled bet ($4.77) returned to 16962fac
*** SHOWDOWN ***
16962fac collected $0.46 from pot
*** SUMMARY ***
Total pot $0.48 | Rake $0.02 | Jackpot $0 | Bingo $0 | Fortune $0 | Tax $0
Board [7d 8d Jh 4h]
Seat 1: ab4c77fd (button) folded before Flop (didn't bet)
Seat 2: 8f9f7e16 (small blind) folded before Flop
Seat 3: 82c973be (big blind) folded on the Turn
Seat 4: f58c1fbe folded before Flop (didn't bet)
Seat 5: Hero folded before Flop (didn't bet)
Seat 6: 16962fac won ($0.46)


Poker Hand #RC3811133611: Hold'em No Limit ($0.02/$0.05) - 2025/08/16 12:17:26
Table 'RushAndCash838871' 6-max Seat #1 is the button
Seat 1: 63def097 ($11.49 in chips)
Seat 2: 7925797d ($6.52 in chips)
Seat 3: 91e98b4e ($5.45 in chips)
Seat 4: 16962fac ($5 in chips)
Seat 5: Hero ($12.69 in chips)
Seat 6: d290cf59 ($5 in chips)
7925797d: posts small blind $0.02
91e98b4e: posts big blind $0.05
*** HOLE CARDS ***
Dealt to 63def097 
Dealt to 7925797d 
Dealt to 91e98b4e 
Dealt to 16962fac 
Dealt to Hero [7h Kh]
Dealt to d290cf59 
16962fac: folds
Hero: folds
d290cf59: raises $0.1 to $0.15
63def097: folds
7925797d: folds
91e98b4e: calls $0.1
*** FLOP *** [9c 4h Jd]
91e98b4e: checks
d290cf59: bets $0.11
91e98b4e: calls $0.11
*** TURN *** [9c 4h Jd] [8h]
91e98b4e: checks
d290cf59: checks
*** RIVER *** [9c 4h Jd 8h] [8c]
91e98b4e: checks
d290cf59: bets $0.41
91e98b4e: folds
Uncalled bet ($0.41) returned to d290cf59
*** SHOWDOWN ***
d290cf59 collected $0.52 from pot
*** SUMMARY ***
Total pot $0.54 | Rake $0.02 | Jackpot $0 | Bingo $0 | Fortune $0 | Tax $0
Board [9c 4h Jd 8h 8c]
Seat 1: 63def097 (button) folded before Flop (didn't bet)
Seat 2: 7925797d (small blind) folded before Flop
Seat 3: 91e98b4e (big blind) folded on the River
Seat 4: 16962fac folded before Flop (didn't bet)
Seat 5: Hero folded before Flop (didn't bet)
Seat 6: d290cf59 won ($0.52)


Poker Hand #RC3811133595: Hold'em No Limit ($0.02/$0.05) - 2025/08/16 12:17:20
Table 'RushAndCash838855' 6-max Seat #1 is the button
Seat 1: f562f667 ($3.37 in chips)
Seat 2: Hero ($12.71 in chips)
Seat 3: cb8bfe18 ($10.68 in chips)
Seat 4: cf40af3 ($7.56 in chips)
Seat 5: d03898d9 ($2.33 in chips)
Seat 6: 7925797d ($6.52 in chips)
Hero: posts small blind $0.02
cb8bfe18: posts big blind $0.05
*** HOLE CARDS ***
Dealt to f562f667 
Dealt to Hero [5s Td]
Dealt to cb8bfe18 
Dealt to cf40af3 
Dealt to d03898d9 
Dealt to 7925797d 
cf40af3: folds
d03898d9: folds
7925797d: folds
f562f667: folds
Hero: folds
Uncalled bet ($0.03) returned to cb8bfe18
*** SHOWDOWN ***
cb8bfe18 collected $0.04 from pot
*** SUMMARY ***
Total pot $0.04 | Rake $0 | Jackpot $0 | Bingo $0 | Fortune $0 | Tax $0
Seat 1: f562f667 (button) folded before Flop (didn't bet)
Seat 2: Hero (small blind) folded before Flop
Seat 3: cb8bfe18 (big blind) collected ($0.04)
Seat 4: cf40af3 folded before Flop (didn't bet)
Seat 5: d03898d9 folded before Flop (didn't bet)
Seat 6: 7925797d folded before Flop (didn't bet)


Poker Hand #RC3811133576: Hold'em No Limit ($0.02/$0.05) - 2025/08/16 12:17:15
Table 'RushAndCash838836' 6-max Seat #1 is the button
Seat 1: Hero ($12.71 in chips)
Seat 2: bd4ea4b9 ($4.73 in chips)
Seat 3: 2a30c87e ($8.08 in chips)
Seat 4: 6ad839b8 ($6.25 in chips)
Seat 5: f58c1fbe ($7.31 in chips)
Seat 6: d03898d9 ($2.33 in chips)
bd4ea4b9: posts small blind $0.02
2a30c87e: posts big blind $0.05
*** HOLE CARDS ***
Dealt to Hero [4d 8c]
Dealt to bd4ea4b9 
Dealt to 2a30c87e 
Dealt to 6ad839b8 
Dealt to f58c1fbe 
Dealt to d03898d9 
6ad839b8: folds
f58c1fbe: folds
d03898d9: folds
Hero: folds
bd4ea4b9: raises $0.1 to $0.15
2a30c87e: folds
Uncalled bet ($0.1) returned to bd4ea4b9
*** SHOWDOWN ***
bd4ea4b9 collected $0.1 from pot
*** SUMMARY ***
Total pot $0.1 | Rake $0 | Jackpot $0 | Bingo $0 | Fortune $0 | Tax $0
Seat 1: Hero (button) folded before Flop (didn't bet)
Seat 2: bd4ea4b9 (small blind) collected ($0.1)
Seat 3: 2a30c87e (big blind) folded before Flop
Seat 4: 6ad839b8 folded before Flop (didn't bet)
Seat 5: f58c1fbe folded before Flop (didn't bet)
Seat 6: d03898d9 folded before Flop (didn't bet)


Poker Hand #RC3811132835: Hold'em No Limit ($0.02/$0.05) - 2025/08/16 12:13:55
Table 'RushAndCash838095' 6-max Seat #1 is the button
Seat 1: 92be137 ($6.28 in chips)
Seat 2: 14d9c001 ($5.49 in chips)
Seat 3: Hero ($12.76 in chips)
Seat 4: be24990e ($5.25 in chips)
Seat 5: 1a5c24ee ($5.21 in chips)
Seat 6: e767dc8d ($5.3 in chips)
14d9c001: posts small blind $0.02
Hero: posts big blind $0.05
*** HOLE CARDS ***
Dealt to 92be137 
Dealt to 14d9c001 
Dealt to Hero [4c Td]
Dealt to be24990e 
Dealt to 1a5c24ee 
Dealt to e767dc8d 
be24990e: folds
1a5c24ee: folds
e767dc8d: folds
92be137: raises $0.05 to $0.1
14d9c001: calls $0.08
Hero: folds
*** FLOP *** [7s 5h 9d]
14d9c001: checks
92be137: bets $0.17
14d9c001: folds
Uncalled bet ($0.17) returned to 92be137
*** SHOWDOWN ***
92be137 collected $0.24 from pot
*** SUMMARY ***
Total pot $0.25 | Rake $0.01 | Jackpot $0 | Bingo $0 | Fortune $0 | Tax $0
Board [7s 5h 9d]
Seat 1: 92be137 (button) won ($0.24)
Seat 2: 14d9c001 (small blind) folded on the Flop
Seat 3: Hero (big blind) folded before Flop
Seat 4: be24990e folded before Flop (didn't bet)
Seat 5: 1a5c24ee folded before Flop (didn't bet)
Seat 6: e767dc8d folded before Flop (didn't bet)


Poker Hand #RC3811132821: Hold'em No Limit ($0.02/$0.05) - 2025/08/16 12:13:51
Table 'RushAndCash838081' 6-max Seat #1 is the button
Seat 1: fc3a5395 ($8.4 in chips)
Seat 2: cf40af3 ($7.21 in chips)
Seat 3: b0a17de1 ($5.17 in chips)
Seat 4: Hero ($12.76 in chips)
Seat 5: de4fa5a4 ($6.78 in chips)
Seat 6: df91ffd8 ($6.34 in chips)
cf40af3: posts small blind $0.02
b0a17de1: posts big blind $0.05
*** HOLE CARDS ***
Dealt to fc3a5395 
Dealt to cf40af3 
Dealt to b0a17de1 
Dealt to Hero [Qd Tc]
Dealt to de4fa5a4 
Dealt to df91ffd8 
Hero: folds
de4fa5a4: folds
df91ffd8: folds
fc3a5395: folds
cf40af3: raises $0.08 to $0.13
b0a17de1: calls $0.08
*** FLOP *** [5c Qh 2s]
cf40af3: checks
b0a17de1: checks
*** TURN *** [5c Qh 2s] [4h]
cf40af3: bets $0.2
b0a17de1: calls $0.2
*** RIVER *** [5c Qh 2s 4h] [9c]
cf40af3: checks
b0a17de1: bets $0.42
cf40af3: calls $0.42
b0a17de1: shows [6s 7h] (Queen high)
cf40af3: shows [Td Th] (a pair of Tens)
*** SHOWDOWN ***
cf40af3 collected $1.36 from pot
*** SUMMARY ***
Total pot $1.5 | Rake $0.07 | Jackpot $0.07 | Bingo $0 | Fortune $0 | Tax $0
Board [5c Qh 2s 4h 9c]
Seat 1: fc3a5395 (button) folded before Flop (didn't bet)
Seat 2: cf40af3 (small blind) showed [Td Th] and won ($1.36) with a pair of Tens
Seat 3: b0a17de1 (big blind) showed [6s 7h] and lost with Queen high
Seat 4: Hero folded before Flop (didn't bet)
Seat 5: de4fa5a4 folded before Flop (didn't bet)
Seat 6: df91ffd8 folded before Flop (didn't bet)


Poker Hand #RC3811132809: Hold'em No Limit ($0.02/$0.05) - 2025/08/16 12:13:47
Table 'RushAndCash838069' 6-max Seat #1 is the button
Seat 1: 372c0091 ($2.7 in chips)
Seat 2: ef51a607 ($14.22 in chips)
Seat 3: 4d80824 ($5.25 in chips)
Seat 4: 9870a6c2 ($10.54 in chips)
Seat 5: Hero ($12.76 in chips)
Seat 6: e6780e8f ($11.85 in chips)
ef51a607: posts small blind $0.02
4d80824: posts big blind $0.05
*** HOLE CARDS ***
Dealt to 372c0091 
Dealt to ef51a607 
Dealt to 4d80824 
Dealt to 9870a6c2 
Dealt to Hero [3s 5d]
Dealt to e6780e8f 
9870a6c2: folds
Hero: folds
e6780e8f: folds
372c0091: raises $0.05 to $0.1
ef51a607: folds
4d80824: folds
Uncalled bet ($0.05) returned to 372c0091
*** SHOWDOWN ***
372c0091 collected $0.12 from pot
*** SUMMARY ***
Total pot $0.12 | Rake $0 | Jackpot $0 | Bingo $0 | Fortune $0 | Tax $0
Seat 1: 372c0091 (button) collected ($0.12)
Seat 2: ef51a607 (small blind) folded before Flop
Seat 3: 4d80824 (big blind) folded before Flop
Seat 4: 9870a6c2 folded before Flop (didn't bet)
Seat 5: Hero folded before Flop (didn't bet)
Seat 6: e6780e8f folded before Flop (didn't bet)


Poker Hand #RC3811132668: Hold'em No Limit ($0.02/$0.05) - 2025/08/16 12:13:10
Table 'RushAndCash837928' 6-max Seat #1 is the button
Seat 1: 60b4cd20 ($4.25 in chips)
Seat 2: 42836787 ($1.5 in chips)
Seat 3: 9870a6c2 ($10.77 in chips)
Seat 4: a4bb7c21 ($9.67 in chips)
Seat 5: Hero ($12.43 in chips)
Seat 6: 90cc5954 ($6.94 in chips)
42836787: posts small blind $0.02
9870a6c2: posts big blind $0.05
*** HOLE CARDS ***
Dealt to 60b4cd20 
Dealt to 42836787 
Dealt to 9870a6c2 
Dealt to a4bb7c21 
Dealt to Hero [8d 8h]
Dealt to 90cc5954 
a4bb7c21: raises $0.06 to $0.11
Hero: calls $0.11
90cc5954: folds
60b4cd20: folds
42836787: folds
9870a6c2: calls $0.06
*** FLOP *** [Ah 6d 5h]
9870a6c2: checks
a4bb7c21: checks
Hero: checks
*** TURN *** [Ah 6d 5h] [Ad]
9870a6c2: bets $0.12
a4bb7c21: folds
Hero: raises $0.38 to $0.5
9870a6c2: folds
Uncalled bet ($0.38) returned to Hero
*** SHOWDOWN ***
Hero collected $0.56 from pot
*** SUMMARY ***
Total pot $0.59 | Rake $0.03 | Jackpot $0 | Bingo $0 | Fortune $0 | Tax $0
Board [Ah 6d 5h Ad]
Seat 1: 60b4cd20 (button) folded before Flop (didn't bet)
Seat 2: 42836787 (small blind) folded before Flop
Seat 3: 9870a6c2 (big blind) folded on the Turn
Seat 4: a4bb7c21 folded on the Turn
Seat 5: Hero won ($0.56)
Seat 6: 90cc5954 folded before Flop (didn't bet)


Poker Hand #RC3811132641: Hold'em No Limit ($0.02/$0.05) - 2025/08/16 12:13:03
Table 'RushAndCash837901' 6-max Seat #1 is the button
Seat 1: Hero ($12.43 in chips)
Seat 2: d513e299 ($6.02 in chips)
Seat 3: 7948444c ($6.49 in chips)
Seat 4: d352a56e ($5 in chips)
Seat 5: e4e308e3 ($5.35 in chips)
Seat 6: dea14c7d ($5.19 in chips)
d513e299: posts small blind $0.02
7948444c: posts big blind $0.05
*** HOLE CARDS ***
Dealt to Hero [Qd 3c]
Dealt to d513e299 
Dealt to 7948444c 
Dealt to d352a56e 
Dealt to e4e308e3 
Dealt to dea14c7d 
d352a56e: folds
e4e308e3: folds
dea14c7d: folds
Hero: folds
d513e299: folds
Uncalled bet ($0.03) returned to 7948444c
*** SHOWDOWN ***
7948444c collected $0.04 from pot
*** SUMMARY ***
Total pot $0.04 | Rake $0 | Jackpot $0 | Bingo $0 | Fortune $0 | Tax $0
Seat 1: Hero (button) folded before Flop (didn't bet)
Seat 2: d513e299 (small blind) folded before Flop
Seat 3: 7948444c (big blind) collected ($0.04)
Seat 4: d352a56e folded before Flop (didn't bet)
Seat 5: e4e308e3 folded before Flop (didn't bet)
Seat 6: dea14c7d folded before Flop (didn't bet)


Poker Hand #RC3811132565: Hold'em No Limit ($0.02/$0.05) - 2025/08/16 12:12:40
Table 'RushAndCash837825' 6-max Seat #1 is the button
Seat 1: 5c2562 ($9.23 in chips)
Seat 2: Hero ($12.38 in chips)
Seat 3: fdba6534 ($9.94 in chips)
Seat 4: de4fa5a4 ($6.49 in chips)
Seat 5: 893981cc ($6.51 in chips)
Seat 6: 319f9ef4 ($12.56 in chips)
Hero: posts small blind $0.02
fdba6534: posts big blind $0.05
*** HOLE CARDS ***
Dealt to 5c2562 
Dealt to Hero [7c 3c]
Dealt to fdba6534 
Dealt to de4fa5a4 
Dealt to 893981cc 
Dealt to 319f9ef4 
de4fa5a4: folds
893981cc: folds
319f9ef4: folds
5c2562: folds
Hero: calls $0.03
fdba6534: checks
*** FLOP *** [Js Jd As]
Hero: checks
fdba6534: checks
*** TURN *** [Js Jd As] [5d]
Hero: checks
fdba6534: checks
*** RIVER *** [Js Jd As 5d] [Th]
Hero: bets $0.05
fdba6534: folds
Uncalled bet ($0.05) returned to Hero
*** SHOWDOWN ***
Hero collected $0.1 from pot
*** SUMMARY ***
Total pot $0.1 | Rake $0 | Jackpot $0 | Bingo $0 | Fortune $0 | Tax $0
Board [Js Jd As 5d Th]
Seat 1: 5c2562 (button) folded before Flop (didn't bet)
Seat 2: Hero (small blind) won ($0.1)
Seat 3: fdba6534 (big blind) folded on the River
Seat 4: de4fa5a4 folded before Flop (didn't bet)
Seat 5: 893981cc folded before Flop (didn't bet)
Seat 6: 319f9ef4 folded before Flop (didn't bet)


Poker Hand #RC3811132340: Hold'em No Limit ($0.02/$0.05) - 2025/08/16 12:11:35
Table 'RushAndCash837600' 6-max Seat #1 is the button
Seat 1: a8007a19 ($6.7 in chips)
Seat 2: eb793e0e ($6.18 in chips)
Seat 3: Hero ($12.48 in chips)
Seat 4: 7d698db1 ($5 in chips)
Seat 5: e06e7451 ($4.57 in chips)
Seat 6: 36ee6aa6 ($5.93 in chips)
eb793e0e: posts small blind $0.02
Hero: posts big blind $0.05
*** HOLE CARDS ***
Dealt to a8007a19 
Dealt to eb793e0e 
Dealt to Hero [Jc 9c]
Dealt to 7d698db1 
Dealt to e06e7451 
Dealt to 36ee6aa6 
7d698db1: folds
e06e7451: raises $0.05 to $0.1
36ee6aa6: folds
a8007a19: folds
eb793e0e: folds
Hero: calls $0.05
*** FLOP *** [Kc Qh As]
Hero: checks
e06e7451: checks
*** TURN *** [Kc Qh As] [7s]
Hero: checks
e06e7451: bets $0.06
Hero: folds
Uncalled bet ($0.06) returned to e06e7451
*** SHOWDOWN ***
e06e7451 collected $0.21 from pot
*** SUMMARY ***
Total pot $0.22 | Rake $0.01 | Jackpot $0 | Bingo $0 | Fortune $0 | Tax $0
Board [Kc Qh As 7s]
Seat 1: a8007a19 (button) folded before Flop (didn't bet)
Seat 2: eb793e0e (small blind) folded before Flop
Seat 3: Hero (big blind) folded on the Turn
Seat 4: 7d698db1 folded before Flop (didn't bet)
Seat 5: e06e7451 won ($0.21)
Seat 6: 36ee6aa6 folded before Flop (didn't bet)


Poker Hand #RC3811132325: Hold'em No Limit ($0.02/$0.05) - 2025/08/16 12:11:31
Table 'RushAndCash837585' 6-max Seat #1 is the button
Seat 1: 7d698db1 ($5 in chips)
Seat 2: e767dc8d ($5 in chips)
Seat 3: bda04d60 ($4.02 in chips)
Seat 4: Hero ($12.48 in chips)
Seat 5: 7c0e033d ($14.58 in chips)
Seat 6: a13cb32e ($5.52 in chips)
e767dc8d: posts small blind $0.02
bda04d60: posts big blind $0.05
*** HOLE CARDS ***
Dealt to 7d698db1 
Dealt to e767dc8d 
Dealt to bda04d60 
Dealt to Hero [8h Qc]
Dealt to 7c0e033d 
Dealt to a13cb32e 
Hero: folds
7c0e033d: raises $0.05 to $0.1
a13cb32e: folds
7d698db1: folds
e767dc8d: folds
bda04d60: folds
Uncalled bet ($0.05) returned to 7c0e033d
*** SHOWDOWN ***
7c0e033d collected $0.12 from pot
*** SUMMARY ***
Total pot $0.12 | Rake $0 | Jackpot $0 | Bingo $0 | Fortune $0 | Tax $0
Seat 1: 7d698db1 (button) folded before Flop (didn't bet)
Seat 2: e767dc8d (small blind) folded before Flop
Seat 3: bda04d60 (big blind) folded before Flop
Seat 4: Hero folded before Flop (didn't bet)
Seat 5: 7c0e033d collected ($0.12)
Seat 6: a13cb32e folded before Flop (didn't bet)


Poker Hand #RC3811132223: Hold'em No Limit ($0.02/$0.05) - 2025/08/16 12:11:06
Table 'RushAndCash837483' 6-max Seat #1 is the button
Seat 1: 7dcc690a ($5 in chips)
Seat 2: a597ffcf ($5 in chips)
Seat 3: 3041c488 ($6.85 in chips)
Seat 4: 3b1d83b5 ($7.25 in chips)
Seat 5: Hero ($12.41 in chips)
Seat 6: 9870a6c2 ($10.67 in chips)
a597ffcf: posts small blind $0.02
3041c488: posts big blind $0.05
*** HOLE CARDS ***
Dealt to 7dcc690a 
Dealt to a597ffcf 
Dealt to 3041c488 
Dealt to 3b1d83b5 
Dealt to Hero [As Js]
Dealt to 9870a6c2 
3b1d83b5: folds
Hero: calls $0.05
9870a6c2: folds
7dcc690a: folds
a597ffcf: folds
3041c488: checks
*** FLOP *** [2s Qs Td]
3041c488: checks
Hero: bets $0.14
3041c488: folds
Uncalled bet ($0.14) returned to Hero
*** SHOWDOWN ***
Hero collected $0.12 from pot
*** SUMMARY ***
Total pot $0.12 | Rake $0 | Jackpot $0 | Bingo $0 | Fortune $0 | Tax $0
Board [2s Qs Td]
Seat 1: 7dcc690a (button) folded before Flop (didn't bet)
Seat 2: a597ffcf (small blind) folded before Flop
Seat 3: 3041c488 (big blind) folded on the Flop
Seat 4: 3b1d83b5 folded before Flop (didn't bet)
Seat 5: Hero won ($0.12)
Seat 6: 9870a6c2 folded before Flop (didn't bet)


Poker Hand #RC3811132173: Hold'em No Limit ($0.02/$0.05) - 2025/08/16 12:10:52
Table 'RushAndCash837433' 6-max Seat #1 is the button
Seat 1: ca814da5 ($6.24 in chips)
Seat 2: a13cb32e ($5.52 in chips)
Seat 3: c0cdc178 ($7.35 in chips)
Seat 4: Hero ($12.34 in chips)
Seat 5: ef51a607 ($15.05 in chips)
Seat 6: d5778e5c ($11.93 in chips)
a13cb32e: posts small blind $0.02
c0cdc178: posts big blind $0.05
*** HOLE CARDS ***
Dealt to ca814da5 
Dealt to a13cb32e 
Dealt to c0cdc178 
Dealt to Hero [Ac Qc]
Dealt to ef51a607 
Dealt to d5778e5c 
Hero: raises $0.05 to $0.1
ef51a607: folds
d5778e5c: folds
ca814da5: folds
a13cb32e: folds
c0cdc178: folds
Uncalled bet ($0.05) returned to Hero
*** SHOWDOWN ***
Hero collected $0.12 from pot
*** SUMMARY ***
Total pot $0.12 | Rake $0 | Jackpot $0 | Bingo $0 | Fortune $0 | Tax $0
Seat 1: ca814da5 (button) folded before Flop (didn't bet)
Seat 2: a13cb32e (small blind) folded before Flop
Seat 3: c0cdc178 (big blind) folded before Flop
Seat 4: Hero collected ($0.12)
Seat 5: ef51a607 folded before Flop (didn't bet)
Seat 6: d5778e5c folded before Flop (didn't bet)


Poker Hand #RC3811132130: Hold'em No Limit ($0.02/$0.05) - 2025/08/16 12:10:40
Table 'RushAndCash837390' 6-max Seat #1 is the button
Seat 1: bc8cce8e ($5.18 in chips)
Seat 2: Hero ($12.36 in chips)
Seat 3: 1a55751a ($3.55 in chips)
Seat 4: 79affc61 ($6.07 in chips)
Seat 5: 256b76ed ($5.51 in chips)
Seat 6: c1fb3acb ($2.58 in chips)
Hero: posts small blind $0.02
1a55751a: posts big blind $0.05
*** HOLE CARDS ***
Dealt to bc8cce8e 
Dealt to Hero [8h 2d]
Dealt to 1a55751a 
Dealt to 79affc61 
Dealt to 256b76ed 
Dealt to c1fb3acb 
79affc61: folds
256b76ed: folds
c1fb3acb: folds
bc8cce8e: folds
Hero: folds
Uncalled bet ($0.03) returned to 1a55751a
*** SHOWDOWN ***
1a55751a collected $0.04 from pot
*** SUMMARY ***
Total pot $0.04 | Rake $0 | Jackpot $0 | Bingo $0 | Fortune $0 | Tax $0
Seat 1: bc8cce8e (button) folded before Flop (didn't bet)
Seat 2: Hero (small blind) folded before Flop
Seat 3: 1a55751a (big blind) collected ($0.04)
Seat 4: 79affc61 folded before Flop (didn't bet)
Seat 5: 256b76ed folded before Flop (didn't bet)
Seat 6: c1fb3acb folded before Flop (didn't bet)


Poker Hand #RC3811132113: Hold'em No Limit ($0.02/$0.05) - 2025/08/16 12:10:36
Table 'RushAndCash837373' 6-max Seat #1 is the button
Seat 1: Hero ($12.36 in chips)
Seat 2: 69e53926 ($5 in chips)
Seat 3: c678170b ($5 in chips)
Seat 4: dce7f224 ($12.36 in chips)
Seat 5: 972b1851 ($5.3 in chips)
Seat 6: 31092ba3 ($6.23 in chips)
69e53926: posts small blind $0.02
c678170b: posts big blind $0.05
*** HOLE CARDS ***
Dealt to Hero [2h Qd]
Dealt to 69e53926 
Dealt to c678170b 
Dealt to dce7f224 
Dealt to 972b1851 
Dealt to 31092ba3 
dce7f224: raises $0.05 to $0.1
972b1851: folds
31092ba3: folds
Hero: folds
69e53926: folds
c678170b: calls $0.05
*** FLOP *** [2d 4c Kh]
c678170b: checks
dce7f224: checks
*** TURN *** [2d 4c Kh] [Ah]
c678170b: checks
dce7f224: bets $0.11
c678170b: calls $0.11
*** RIVER *** [2d 4c Kh Ah] [9c]
c678170b: checks
dce7f224: checks
c678170b: shows [Ad Qh] (a pair of Aces)
dce7f224: shows [Qs Qc] (a pair of Queens)
*** SHOWDOWN ***
c678170b collected $0.42 from pot
*** SUMMARY ***
Total pot $0.44 | Rake $0.02 | Jackpot $0 | Bingo $0 | Fortune $0 | Tax $0
Board [2d 4c Kh Ah 9c]
Seat 1: Hero (button) folded before Flop (didn't bet)
Seat 2: 69e53926 (small blind) folded before Flop
Seat 3: c678170b (big blind) showed [Ad Qh] and won ($0.42) with a pair of Aces
Seat 4: dce7f224 showed [Qs Qc] and lost with a pair of Queens
Seat 5: 972b1851 folded before Flop (didn't bet)
Seat 6: 31092ba3 folded before Flop (didn't bet)


Poker Hand #RC3811132064: Hold'em No Limit ($0.02/$0.05) - 2025/08/16 12:10:22
Table 'RushAndCash837324' 6-max Seat #1 is the button
Seat 1: 92006211 ($6.05 in chips)
Seat 2: e741ecde ($9.85 in chips)
Seat 3: Hero ($12.34 in chips)
Seat 4: 8fb01fb1 ($9.51 in chips)
Seat 5: c58b8609 ($14.37 in chips)
Seat 6: c923a998 ($5.07 in chips)
e741ecde: posts small blind $0.02
Hero: posts big blind $0.05
*** HOLE CARDS ***
Dealt to 92006211 
Dealt to e741ecde 
Dealt to Hero [Qh 3d]
Dealt to 8fb01fb1 
Dealt to c58b8609 
Dealt to c923a998 
8fb01fb1: folds
c58b8609: folds
c923a998: folds
92006211: folds
e741ecde: folds
Uncalled bet ($0.03) returned to Hero
*** SHOWDOWN ***
Hero collected $0.04 from pot
*** SUMMARY ***
Total pot $0.04 | Rake $0 | Jackpot $0 | Bingo $0 | Fortune $0 | Tax $0
Seat 1: 92006211 (button) folded before Flop (didn't bet)
Seat 2: e741ecde (small blind) folded before Flop
Seat 3: Hero (big blind) collected ($0.04)
Seat 4: 8fb01fb1 folded before Flop (didn't bet)
Seat 5: c58b8609 folded before Flop (didn't bet)
Seat 6: c923a998 folded before Flop (didn't bet)


Poker Hand #RC3811132052: Hold'em No Limit ($0.02/$0.05) - 2025/08/16 12:10:19
Table 'RushAndCash837312' 6-max Seat #1 is the button
Seat 1: f3cd5849 ($5.26 in chips)
Seat 2: 5eaf1ccd ($23.69 in chips)
Seat 3: 41e95a30 ($5.42 in chips)
Seat 4: Hero ($12.34 in chips)
Seat 5: e6a5b6ba ($8.27 in chips)
Seat 6: 673eb114 ($5 in chips)
5eaf1ccd: posts small blind $0.02
41e95a30: posts big blind $0.05
*** HOLE CARDS ***
Dealt to f3cd5849 
Dealt to 5eaf1ccd 
Dealt to 41e95a30 
Dealt to Hero [Ah 7c]
Dealt to e6a5b6ba 
Dealt to 673eb114 
Hero: folds
e6a5b6ba: raises $0.05 to $0.1
673eb114: folds
f3cd5849: folds
5eaf1ccd: folds
41e95a30: calls $0.05
*** FLOP *** [6h Ts 3s]
41e95a30: checks
e6a5b6ba: bets $0.08
41e95a30: calls $0.08
*** TURN *** [6h Ts 3s] [Jd]
41e95a30: checks
e6a5b6ba: checks
*** RIVER *** [6h Ts 3s Jd] [Js]
41e95a30: bets $0.19
e6a5b6ba: folds
Uncalled bet ($0.19) returned to 41e95a30
*** SHOWDOWN ***
41e95a30 collected $0.37 from pot
*** SUMMARY ***
Total pot $0.38 | Rake $0.01 | Jackpot $0 | Bingo $0 | Fortune $0 | Tax $0
Board [6h Ts 3s Jd Js]
Seat 1: f3cd5849 (button) folded before Flop (didn't bet)
Seat 2: 5eaf1ccd (small blind) folded before Flop
Seat 3: 41e95a30 (big blind) won ($0.37)
Seat 4: Hero folded before Flop (didn't bet)
Seat 5: e6a5b6ba folded on the River
Seat 6: 673eb114 folded before Flop (didn't bet)


Poker Hand #RC3811132039: Hold'em No Limit ($0.02/$0.05) - 2025/08/16 12:10:15
Table 'RushAndCash837299' 6-max Seat #1 is the button
Seat 1: 1754459b ($3.86 in chips)
Seat 2: bc622757 ($12.53 in chips)
Seat 3: 47a81dc7 ($4.26 in chips)
Seat 4: 5c2562 ($9.26 in chips)
Seat 5: c58b8609 ($14.37 in chips)
Seat 6: Hero ($12.34 in chips)
bc622757: posts small blind $0.02
47a81dc7: posts big blind $0.05
*** HOLE CARDS ***
Dealt to 1754459b 
Dealt to bc622757 
Dealt to 47a81dc7 
Dealt to 5c2562 
Dealt to c58b8609 
Dealt to Hero [4h Ks]
5c2562: folds
c58b8609: folds
Hero: folds
1754459b: raises $0.1 to $0.15
bc622757: folds
47a81dc7: raises $0.32 to $0.47
1754459b: calls $0.32
*** FLOP *** [9d 9h Kd]
47a81dc7: bets $0.32
1754459b: folds
Uncalled bet ($0.32) returned to 47a81dc7
*** SHOWDOWN ***
47a81dc7 collected $0.92 from pot
*** SUMMARY ***
Total pot $0.96 | Rake $0.04 | Jackpot $0 | Bingo $0 | Fortune $0 | Tax $0
Board [9d 9h Kd]
Seat 1: 1754459b (button) folded on the Flop
Seat 2: bc622757 (small blind) folded before Flop
Seat 3: 47a81dc7 (big blind) won ($0.92)
Seat 4: 5c2562 folded before Flop (didn't bet)
Seat 5: c58b8609 folded before Flop (didn't bet)
Seat 6: Hero folded before Flop (didn't bet)


Poker Hand #RC3811132025: Hold'em No Limit ($0.02/$0.05) - 2025/08/16 12:10:11
Table 'RushAndCash837285' 6-max Seat #1 is the button
Seat 1: cc6cbf1d ($5.98 in chips)
Seat 2: b0933ab ($7 in chips)
Seat 3: 9ebb6429 ($5 in chips)
Seat 4: d03898d9 ($1.7 in chips)
Seat 5: a88aff05 ($1.49 in chips)
Seat 6: Hero ($12.34 in chips)
b0933ab: posts small blind $0.02
9ebb6429: posts big blind $0.05
*** HOLE CARDS ***
Dealt to cc6cbf1d 
Dealt to b0933ab 
Dealt to 9ebb6429 
Dealt to d03898d9 
Dealt to a88aff05 
Dealt to Hero [8h Qd]
d03898d9: calls $0.05
a88aff05: folds
Hero: folds
cc6cbf1d: folds
b0933ab: folds
9ebb6429: checks
*** FLOP *** [As 4s 8d]
9ebb6429: checks
d03898d9: bets $0.05
9ebb6429: folds
Uncalled bet ($0.05) returned to d03898d9
*** SHOWDOWN ***
d03898d9 collected $0.12 from pot
*** SUMMARY ***
Total pot $0.12 | Rake $0 | Jackpot $0 | Bingo $0 | Fortune $0 | Tax $0
Board [As 4s 8d]
Seat 1: cc6cbf1d (button) folded before Flop (didn't bet)
Seat 2: b0933ab (small blind) folded before Flop
Seat 3: 9ebb6429 (big blind) folded on the Flop
Seat 4: d03898d9 won ($0.12)
Seat 5: a88aff05 folded before Flop (didn't bet)
Seat 6: Hero folded before Flop (didn't bet)


Poker Hand #RC3811131887: Hold'em No Limit ($0.02/$0.05) - 2025/08/16 12:09:34
Table 'RushAndCash837147' 6-max Seat #1 is the button
Seat 1: Hero ($12.18 in chips)
Seat 2: d876bedd ($7.62 in chips)
Seat 3: d03898d9 ($1.85 in chips)
Seat 4: 3bf36a6c ($5.05 in chips)
Seat 5: b0c51124 ($10.25 in chips)
Seat 6: d513e299 ($5.46 in chips)
d876bedd: posts small blind $0.02
d03898d9: posts big blind $0.05
*** HOLE CARDS ***
Dealt to Hero [As 4h]
Dealt to d876bedd 
Dealt to d03898d9 
Dealt to 3bf36a6c 
Dealt to b0c51124 
Dealt to d513e299 
3bf36a6c: folds
b0c51124: folds
d513e299: folds
Hero: raises $0.05 to $0.1
d876bedd: folds
d03898d9: calls $0.05
*** FLOP *** [2s 7d 2c]
d03898d9: checks
Hero: checks
*** TURN *** [2s 7d 2c] [7h]
d03898d9: bets $0.05
Hero: raises $0.11 to $0.16
d03898d9: folds
Uncalled bet ($0.11) returned to Hero
*** SHOWDOWN ***
Hero collected $0.31 from pot
*** SUMMARY ***
Total pot $0.32 | Rake $0.01 | Jackpot $0 | Bingo $0 | Fortune $0 | Tax $0
Board [2s 7d 2c 7h]
Seat 1: Hero (button) won ($0.31)
Seat 2: d876bedd (small blind) folded before Flop
Seat 3: d03898d9 (big blind) folded on the Turn
Seat 4: 3bf36a6c folded before Flop (didn't bet)
Seat 5: b0c51124 folded before Flop (didn't bet)
Seat 6: d513e299 folded before Flop (didn't bet)


Poker Hand #RC3811131848: Hold'em No Limit ($0.02/$0.05) - 2025/08/16 12:09:24
Table 'RushAndCash837108' 6-max Seat #1 is the button
Seat 1: 91e0daba ($8.33 in chips)
Seat 2: Hero ($12.2 in chips)
Seat 3: eb793e0e ($6.19 in chips)
Seat 4: 7ec23878 ($6.49 in chips)
Seat 5: 45eea39e ($8.04 in chips)
Seat 6: da69d85 ($8.36 in chips)
Hero: posts small blind $0.02
eb793e0e: posts big blind $0.05
*** HOLE CARDS ***
Dealt to 91e0daba 
Dealt to Hero [7s As]
Dealt to eb793e0e 
Dealt to 7ec23878 
Dealt to 45eea39e 
Dealt to da69d85 
7ec23878: raises $0.05 to $0.1
45eea39e: folds
da69d85: folds
91e0daba: raises $0.23 to $0.33
Hero: folds
eb793e0e: folds
7ec23878: calls $0.23
*** FLOP *** [2h Ts 4d]
7ec23878: checks
91e0daba: bets $0.25
7ec23878: calls $0.25
*** TURN *** [2h Ts 4d] [3d]
7ec23878: checks
91e0daba: checks
*** RIVER *** [2h Ts 4d 3d] [Ks]
7ec23878: checks
91e0daba: bets $0.45
7ec23878: folds
Uncalled bet ($0.45) returned to 91e0daba
*** SHOWDOWN ***
91e0daba collected $1.17 from pot
*** SUMMARY ***
Total pot $1.23 | Rake $0.06 | Jackpot $0 | Bingo $0 | Fortune $0 | Tax $0
Board [2h Ts 4d 3d Ks]
Seat 1: 91e0daba (button) won ($1.17)
Seat 2: Hero (small blind) folded before Flop
Seat 3: eb793e0e (big blind) folded before Flop
Seat 4: 7ec23878 folded on the River
Seat 5: 45eea39e folded before Flop (didn't bet)
Seat 6: da69d85 folded before Flop (didn't bet)


Poker Hand #RC3811131630: Hold'em No Limit ($0.02/$0.05) - 2025/08/16 12:08:28
Table 'RushAndCash836890' 6-max Seat #1 is the button
Seat 1: 29a82c5b ($11.45 in chips)
Seat 2: 1754459b ($1.99 in chips)
Seat 3: Hero ($11.56 in chips)
Seat 4: 25859f34 ($5.08 in chips)
Seat 5: da69d85 ($9.12 in chips)
Seat 6: b0933ab ($8.42 in chips)
1754459b: posts small blind $0.02
Hero: posts big blind $0.05
*** HOLE CARDS ***
Dealt to 29a82c5b 
Dealt to 1754459b 
Dealt to Hero [9d Td]
Dealt to 25859f34 
Dealt to da69d85 
Dealt to b0933ab 
25859f34: folds
da69d85: raises $0.05 to $0.1
b0933ab: folds
29a82c5b: folds
1754459b: folds
Hero: raises $0.26 to $0.36
da69d85: calls $0.26
*** FLOP *** [8s 7h 8d]
Hero: bets $0.4
da69d85: calls $0.4
*** TURN *** [8s 7h 8d] [Ah]
Hero: bets $1.82
da69d85: folds
Uncalled bet ($1.82) returned to Hero
*** SHOWDOWN ***
Hero collected $1.4 from pot
*** SUMMARY ***
Total pot $1.54 | Rake $0.07 | Jackpot $0.07 | Bingo $0 | Fortune $0 | Tax $0
Board [8s 7h 8d Ah]
Seat 1: 29a82c5b (button) folded before Flop (didn't bet)
Seat 2: 1754459b (small blind) folded before Flop
Seat 3: Hero (big blind) won ($1.4)
Seat 4: 25859f34 folded before Flop (didn't bet)
Seat 5: da69d85 folded on the Turn
Seat 6: b0933ab folded before Flop (didn't bet)


Poker Hand #RC3811131425: Hold'em No Limit ($0.02/$0.05) - 2025/08/16 12:07:38
Table 'RushAndCash836685' 6-max Seat #1 is the button
Seat 1: e725801b ($6.18 in chips)
Seat 2: e06e7451 ($5 in chips)
Seat 3: 1754459b ($2 in chips)
Seat 4: Hero ($11.57 in chips)
Seat 5: be24990e ($6.23 in chips)
Seat 6: 968d1ea3 ($5.43 in chips)
e06e7451: posts small blind $0.02
1754459b: posts big blind $0.05
*** HOLE CARDS ***
Dealt to e725801b 
Dealt to e06e7451 
Dealt to 1754459b 
Dealt to Hero [Ac 2c]
Dealt to be24990e 
Dealt to 968d1ea3 
Hero: raises $0.05 to $0.1
be24990e: folds
968d1ea3: folds
e725801b: folds
e06e7451: folds
1754459b: calls $0.05
*** FLOP *** [Js Jc As]
1754459b: checks
Hero: checks
*** TURN *** [Js Jc As] [Qc]
1754459b: checks
Hero: bets $0.18
1754459b: raises $0.2 to $0.38
Hero: calls $0.2
*** RIVER *** [Js Jc As Qc] [Td]
1754459b: checks
Hero: checks
1754459b: shows [Ah 4d] (two pair, Aces and Jacks)
Hero: shows [Ac 2c] (two pair, Aces and Jacks)
*** SHOWDOWN ***
1754459b collected $0.47 from pot
Hero collected $0.47 from pot
*** SUMMARY ***
Total pot $0.98 | Rake $0.04 | Jackpot $0 | Bingo $0 | Fortune $0 | Tax $0
Board [Js Jc As Qc Td]
Seat 1: e725801b (button) folded before Flop (didn't bet)
Seat 2: e06e7451 (small blind) folded before Flop
Seat 3: 1754459b (big blind) showed [Ah 4d] and won ($0.47) with two pair, Aces and Jacks
Seat 4: Hero showed [Ac 2c] and won ($0.47) with two pair, Aces and Jacks
Seat 5: be24990e folded before Flop (didn't bet)
Seat 6: 968d1ea3 folded before Flop (didn't bet)


Poker Hand #RC3811131409: Hold'em No Limit ($0.02/$0.05) - 2025/08/16 12:07:34
Table 'RushAndCash836669' 6-max Seat #1 is the button
Seat 1: e06e7451 ($5 in chips)
Seat 2: 8e98b00 ($5.4 in chips)
Seat 3: e725801b ($6.23 in chips)
Seat 4: b4726d8e ($9.25 in chips)
Seat 5: Hero ($11.57 in chips)
Seat 6: 5c2562 ($9.53 in chips)
8e98b00: posts small blind $0.02
e725801b: posts big blind $0.05
*** HOLE CARDS ***
Dealt to e06e7451 
Dealt to 8e98b00 
Dealt to e725801b 
Dealt to b4726d8e 
Dealt to Hero [Ks 7c]
Dealt to 5c2562 
b4726d8e: raises $0.05 to $0.1
Hero: folds
5c2562: raises $0.21 to $0.31
e06e7451: folds
8e98b00: folds
e725801b: folds
b4726d8e: calls $0.21
*** FLOP *** [9c 7h 4s]
b4726d8e: checks
5c2562: checks
*** TURN *** [9c 7h 4s] [8c]
b4726d8e: checks
5c2562: bets $0.37
b4726d8e: folds
Uncalled bet ($0.37) returned to 5c2562
*** SHOWDOWN ***
5c2562 collected $0.66 from pot
*** SUMMARY ***
Total pot $0.69 | Rake $0.03 | Jackpot $0 | Bingo $0 | Fortune $0 | Tax $0
Board [9c 7h 4s 8c]
Seat 1: e06e7451 (button) folded before Flop (didn't bet)
Seat 2: 8e98b00 (small blind) folded before Flop
Seat 3: e725801b (big blind) folded before Flop
Seat 4: b4726d8e folded on the Turn
Seat 5: Hero folded before Flop (didn't bet)
Seat 6: 5c2562 won ($0.66)


Poker Hand #RC3811131392: Hold'em No Limit ($0.02/$0.05) - 2025/08/16 12:07:31
Table 'RushAndCash836652' 6-max Seat #1 is the button
Seat 1: 25859f34 ($5.25 in chips)
Seat 2: ab4c77fd ($5 in chips)
Seat 3: ead66908 ($3.26 in chips)
Seat 4: Hero ($11.57 in chips)
Seat 5: fd16d07b ($5.14 in chips)
Seat 6: ea5cec14 ($3.38 in chips)
ab4c77fd: posts small blind $0.02
ead66908: posts big blind $0.05
*** HOLE CARDS ***
Dealt to 25859f34 
Dealt to ab4c77fd 
Dealt to ead66908 
Dealt to Hero [7h Jc]
Dealt to fd16d07b 
Dealt to ea5cec14 
Hero: folds
fd16d07b: folds
ea5cec14: folds
25859f34: folds
ab4c77fd: raises $0.1 to $0.15
ead66908: calls $0.1
*** FLOP *** [3s Kc Jd]
ab4c77fd: bets $0.23
ead66908: folds
Uncalled bet ($0.23) returned to ab4c77fd
*** SHOWDOWN ***
ab4c77fd collected $0.29 from pot
*** SUMMARY ***
Total pot $0.3 | Rake $0.01 | Jackpot $0 | Bingo $0 | Fortune $0 | Tax $0
Board [3s Kc Jd]
Seat 1: 25859f34 (button) folded before Flop (didn't bet)
Seat 2: ab4c77fd (small blind) won ($0.29)
Seat 3: ead66908 (big blind) folded on the Flop
Seat 4: Hero folded before Flop (didn't bet)
Seat 5: fd16d07b folded before Flop (didn't bet)
Seat 6: ea5cec14 folded before Flop (didn't bet)


Poker Hand #RC3811131375: Hold'em No Limit ($0.02/$0.05) - 2025/08/16 12:07:27
Table 'RushAndCash836635' 6-max Seat #1 is the button
Seat 1: d39a7ce4 ($8.77 in chips)
Seat 2: 84248106 ($12.83 in chips)
Seat 3: 147c24ba ($6.41 in chips)
Seat 4: af718e4b ($24.97 in chips)
Seat 5: 6f824e82 ($13.15 in chips)
Seat 6: Hero ($11.57 in chips)
84248106: posts small blind $0.02
147c24ba: posts big blind $0.05
*** HOLE CARDS ***
Dealt to d39a7ce4 
Dealt to 84248106 
Dealt to 147c24ba 
Dealt to af718e4b 
Dealt to 6f824e82 
Dealt to Hero [9d Ah]
af718e4b: raises $0.07 to $0.12
6f824e82: folds
Hero: folds
d39a7ce4: folds
84248106: folds
147c24ba: folds
Uncalled bet ($0.07) returned to af718e4b
*** SHOWDOWN ***
af718e4b collected $0.12 from pot
*** SUMMARY ***
Total pot $0.12 | Rake $0 | Jackpot $0 | Bingo $0 | Fortune $0 | Tax $0
Seat 1: d39a7ce4 (button) folded before Flop (didn't bet)
Seat 2: 84248106 (small blind) folded before Flop
Seat 3: 147c24ba (big blind) folded before Flop
Seat 4: af718e4b collected ($0.12)
Seat 5: 6f824e82 folded before Flop (didn't bet)
Seat 6: Hero folded before Flop (didn't bet)


Poker Hand #RC3811131148: Hold'em No Limit ($0.02/$0.05) - 2025/08/16 12:06:35
Table 'RushAndCash836408' 6-max Seat #1 is the button
Seat 1: 2994fd3 ($6.25 in chips)
Seat 2: Hero ($11.43 in chips)
Seat 3: d39a7ce4 ($8.92 in chips)
Seat 4: c678170b ($5.06 in chips)
Seat 5: 826c9705 ($7.59 in chips)
Seat 6: a597ffcf ($5.07 in chips)
Hero: posts small blind $0.02
d39a7ce4: posts big blind $0.05
*** HOLE CARDS ***
Dealt to 2994fd3 
Dealt to Hero [6h 4d]
Dealt to d39a7ce4 
Dealt to c678170b 
Dealt to 826c9705 
Dealt to a597ffcf 
c678170b: folds
826c9705: folds
a597ffcf: folds
2994fd3: folds
Hero: calls $0.03
d39a7ce4: checks
*** FLOP *** [4h 5s 9s]
Hero: bets $0.05
d39a7ce4: calls $0.05
*** TURN *** [4h 5s 9s] [3s]
Hero: bets $0.05
d39a7ce4: calls $0.05
*** RIVER *** [4h 5s 9s 3s] [4c]
Hero: bets $0.36
d39a7ce4: folds
Uncalled bet ($0.36) returned to Hero
*** SHOWDOWN ***
Hero collected $0.29 from pot
*** SUMMARY ***
Total pot $0.3 | Rake $0.01 | Jackpot $0 | Bingo $0 | Fortune $0 | Tax $0
Board [4h 5s 9s 3s 4c]
Seat 1: 2994fd3 (button) folded before Flop (didn't bet)
Seat 2: Hero (small blind) showed [6h] and won ($0.29)
Seat 3: d39a7ce4 (big blind) folded on the River
Seat 4: c678170b folded before Flop (didn't bet)
Seat 5: 826c9705 folded before Flop (didn't bet)
Seat 6: a597ffcf folded before Flop (didn't bet)


Poker Hand #RC3811130957: Hold'em No Limit ($0.02/$0.05) - 2025/08/16 12:05:52
Table 'RushAndCash836217' 6-max Seat #1 is the button
Seat 1: Hero ($11.11 in chips)
Seat 2: 893981cc ($5.68 in chips)
Seat 3: c1fb3acb ($4.03 in chips)
Seat 4: d19e9e2b ($5 in chips)
Seat 5: 60ffc042 ($5 in chips)
Seat 6: 91e0daba ($9.32 in chips)
893981cc: posts small blind $0.02
c1fb3acb: posts big blind $0.05
*** HOLE CARDS ***
Dealt to Hero [Ts Ac]
Dealt to 893981cc 
Dealt to c1fb3acb 
Dealt to d19e9e2b 
Dealt to 60ffc042 
Dealt to 91e0daba 
d19e9e2b: folds
60ffc042: raises $0.07 to $0.12
91e0daba: folds
Hero: calls $0.12
893981cc: folds
c1fb3acb: folds
*** FLOP *** [6c 5c Jd]
60ffc042: bets $0.16
Hero: calls $0.16
*** TURN *** [6c 5c Jd] [2c]
60ffc042: checks
Hero: bets $0.75
60ffc042: folds
Uncalled bet ($0.75) returned to Hero
*** SHOWDOWN ***
Hero collected $0.6 from pot
*** SUMMARY ***
Total pot $0.63 | Rake $0.03 | Jackpot $0 | Bingo $0 | Fortune $0 | Tax $0
Board [6c 5c Jd 2c]
Seat 1: Hero (button) showed [Ac] and won ($0.6)
Seat 2: 893981cc (small blind) folded before Flop
Seat 3: c1fb3acb (big blind) folded before Flop
Seat 4: d19e9e2b folded before Flop (didn't bet)
Seat 5: 60ffc042 folded on the Turn
Seat 6: 91e0daba folded before Flop (didn't bet)


Poker Hand #RC3811130939: Hold'em No Limit ($0.02/$0.05) - 2025/08/16 12:05:48
Table 'RushAndCash836199' 6-max Seat #1 is the button
Seat 1: ead66908 ($2.41 in chips)
Seat 2: 8dd091bb ($1.95 in chips)
Seat 3: 99d6a030 ($7.59 in chips)
Seat 4: Hero ($11.11 in chips)
Seat 5: 90cc5954 ($5 in chips)
Seat 6: cce63a01 ($5 in chips)
8dd091bb: posts small blind $0.02
99d6a030: posts big blind $0.05
*** HOLE CARDS ***
Dealt to ead66908 
Dealt to 8dd091bb 
Dealt to 99d6a030 
Dealt to Hero [2d 3h]
Dealt to 90cc5954 
Dealt to cce63a01 
Hero: folds
90cc5954: folds
cce63a01: folds
ead66908: raises $0.05 to $0.1
8dd091bb: folds
99d6a030: calls $0.05
*** FLOP *** [8c Qd Tc]
99d6a030: checks
ead66908: bets $0.11
99d6a030: calls $0.11
*** TURN *** [8c Qd Tc] [2s]
99d6a030: checks
ead66908: checks
*** RIVER *** [8c Qd Tc 2s] [7s]
99d6a030: checks
ead66908: checks
99d6a030: shows [7h 9h] (a pair of Sevens)
ead66908: shows [Th Kd] (a pair of Tens)
*** SHOWDOWN ***
ead66908 collected $0.42 from pot
*** SUMMARY ***
Total pot $0.44 | Rake $0.02 | Jackpot $0 | Bingo $0 | Fortune $0 | Tax $0
Board [8c Qd Tc 2s 7s]
Seat 1: ead66908 (button) showed [Th Kd] and won ($0.42) with a pair of Tens
Seat 2: 8dd091bb (small blind) folded before Flop
Seat 3: 99d6a030 (big blind) showed [7h 9h] and lost with a pair of Sevens
Seat 4: Hero folded before Flop (didn't bet)
Seat 5: 90cc5954 folded before Flop (didn't bet)
Seat 6: cce63a01 folded before Flop (didn't bet)


Poker Hand #RC3811130905: Hold'em No Limit ($0.02/$0.05) - 2025/08/16 12:05:41
Table 'RushAndCash836165' 6-max Seat #1 is the button
Seat 1: 3b5cc3d ($5.21 in chips)
Seat 2: bbe10a97 ($5.11 in chips)
Seat 3: Hero ($11.16 in chips)
Seat 4: b827826f ($5.35 in chips)
Seat 5: 3bf36a6c ($5.23 in chips)
Seat 6: 1b827e92 ($4.35 in chips)
bbe10a97: posts small blind $0.02
Hero: posts big blind $0.05
*** HOLE CARDS ***
Dealt to 3b5cc3d 
Dealt to bbe10a97 
Dealt to Hero [Qd 3h]
Dealt to b827826f 
Dealt to 3bf36a6c 
Dealt to 1b827e92 
b827826f: raises $0.05 to $0.1
3bf36a6c: folds
1b827e92: folds
3b5cc3d: folds
bbe10a97: folds
Hero: folds
Uncalled bet ($0.05) returned to b827826f
*** SHOWDOWN ***
b827826f collected $0.12 from pot
*** SUMMARY ***
Total pot $0.12 | Rake $0 | Jackpot $0 | Bingo $0 | Fortune $0 | Tax $0
Seat 1: 3b5cc3d (button) folded before Flop (didn't bet)
Seat 2: bbe10a97 (small blind) folded before Flop
Seat 3: Hero (big blind) folded before Flop
Seat 4: b827826f collected ($0.12)
Seat 5: 3bf36a6c folded before Flop (didn't bet)
Seat 6: 1b827e92 folded before Flop (didn't bet)


Poker Hand #RC3811130716: Hold'em No Limit ($0.02/$0.05) - 2025/08/16 12:04:57
Table 'RushAndCash835976' 6-max Seat #1 is the button
Seat 1: edb2fce5 ($5.48 in chips)
Seat 2: c115d312 ($17.27 in chips)
Seat 3: bbe10a97 ($5 in chips)
Seat 4: Hero ($11.26 in chips)
Seat 5: b5b007b9 ($6.26 in chips)
Seat 6: 91120328 ($5.07 in chips)
c115d312: posts small blind $0.02
bbe10a97: posts big blind $0.05
*** HOLE CARDS ***
Dealt to edb2fce5 
Dealt to c115d312 
Dealt to bbe10a97 
Dealt to Hero [Qh As]
Dealt to b5b007b9 
Dealt to 91120328 
Hero: raises $0.05 to $0.1
b5b007b9: folds
91120328: folds
edb2fce5: folds
c115d312: folds
bbe10a97: calls $0.05
*** FLOP *** [3c Kc 5s]
bbe10a97: checks
Hero: checks
*** TURN *** [3c Kc 5s] [7s]
bbe10a97: bets $0.37
Hero: folds
Uncalled bet ($0.37) returned to bbe10a97
*** SHOWDOWN ***
bbe10a97 collected $0.21 from pot
*** SUMMARY ***
Total pot $0.22 | Rake $0.01 | Jackpot $0 | Bingo $0 | Fortune $0 | Tax $0
Board [3c Kc 5s 7s]
Seat 1: edb2fce5 (button) folded before Flop (didn't bet)
Seat 2: c115d312 (small blind) folded before Flop
Seat 3: bbe10a97 (big blind) won ($0.21)
Seat 4: Hero folded on the Turn
Seat 5: b5b007b9 folded before Flop (didn't bet)
Seat 6: 91120328 folded before Flop (didn't bet)


Poker Hand #RC3811130701: Hold'em No Limit ($0.02/$0.05) - 2025/08/16 12:04:53
Table 'RushAndCash835961' 6-max Seat #1 is the button
Seat 1: d513e299 ($5 in chips)
Seat 2: fd16d07b ($4.72 in chips)
Seat 3: e06e7451 ($1.77 in chips)
Seat 4: Hero ($11.26 in chips)
Seat 5: 1aaefd7c ($5.08 in chips)
Seat 6: 37c2e948 ($10.19 in chips)
fd16d07b: posts small blind $0.02
e06e7451: posts big blind $0.05
*** HOLE CARDS ***
Dealt to d513e299 
Dealt to fd16d07b 
Dealt to e06e7451 
Dealt to Hero [2c Js]
Dealt to 1aaefd7c 
Dealt to 37c2e948 
Hero: folds
1aaefd7c: folds
37c2e948: folds
d513e299: raises $0.06 to $0.11
fd16d07b: folds
e06e7451: calls $0.06
*** FLOP *** [Ks Th 9d]
e06e7451: checks
d513e299: bets $0.08
e06e7451: raises $0.3 to $0.38
d513e299: calls $0.3
*** TURN *** [Ks Th 9d] [5c]
e06e7451: bets $0.5
d513e299: calls $0.5
*** RIVER *** [Ks Th 9d 5c] [Tc]
e06e7451: bets $0.78 and is all-in
d513e299: folds
Uncalled bet ($0.78) returned to e06e7451
*** SHOWDOWN ***
e06e7451 collected $1.84 from pot
*** SUMMARY ***
Total pot $2 | Rake $0.09 | Jackpot $0.07 | Bingo $0 | Fortune $0 | Tax $0
Board [Ks Th 9d 5c Tc]
Seat 1: d513e299 (button) folded on the River
Seat 2: fd16d07b (small blind) folded before Flop
Seat 3: e06e7451 (big blind) won ($1.84)
Seat 4: Hero folded before Flop (didn't bet)
Seat 5: 1aaefd7c folded before Flop (didn't bet)
Seat 6: 37c2e948 folded before Flop (didn't bet)


Poker Hand #RC3811130671: Hold'em No Limit ($0.02/$0.05) - 2025/08/16 12:04:47
Table 'RushAndCash835931' 6-max Seat #1 is the button
Seat 1: 41e95a30 ($5 in chips)
Seat 2: Hero ($11.28 in chips)
Seat 3: 7d65956 ($3.7 in chips)
Seat 4: 3600837f ($10.04 in chips)
Seat 5: 4b999ee3 ($5.02 in chips)
Seat 6: 154c971f ($2.33 in chips)
Hero: posts small blind $0.02
7d65956: posts big blind $0.05
*** HOLE CARDS ***
Dealt to 41e95a30 
Dealt to Hero [4s 8h]
Dealt to 7d65956 
Dealt to 3600837f 
Dealt to 4b999ee3 
Dealt to 154c971f 
3600837f: folds
4b999ee3: folds
154c971f: folds
41e95a30: folds
Hero: folds
Uncalled bet ($0.03) returned to 7d65956
*** SHOWDOWN ***
7d65956 collected $0.04 from pot
*** SUMMARY ***
Total pot $0.04 | Rake $0 | Jackpot $0 | Bingo $0 | Fortune $0 | Tax $0
Seat 1: 41e95a30 (button) folded before Flop (didn't bet)
Seat 2: Hero (small blind) folded before Flop
Seat 3: 7d65956 (big blind) collected ($0.04)
Seat 4: 3600837f folded before Flop (didn't bet)
Seat 5: 4b999ee3 folded before Flop (didn't bet)
Seat 6: 154c971f folded before Flop (didn't bet)


Poker Hand #RC3811130452: Hold'em No Limit ($0.02/$0.05) - 2025/08/16 12:03:51
Table 'RushAndCash835712' 6-max Seat #1 is the button
Seat 1: 1862c639 ($5.07 in chips)
Seat 2: 98569691 ($5.1 in chips)
Seat 3: Hero ($10.74 in chips)
Seat 4: 7d65956 ($4.27 in chips)
Seat 5: 6da9cdea ($5.61 in chips)
Seat 6: 6f824e82 ($11.94 in chips)
98569691: posts small blind $0.02
Hero: posts big blind $0.05
*** HOLE CARDS ***
Dealt to 1862c639 
Dealt to 98569691 
Dealt to Hero [9d Kd]
Dealt to 7d65956 
Dealt to 6da9cdea 
Dealt to 6f824e82 
7d65956: raises $0.05 to $0.1
6da9cdea: folds
6f824e82: folds
1862c639: folds
98569691: folds
Hero: calls $0.05
*** FLOP *** [Kc Qc 5c]
Hero: checks
7d65956: bets $0.06
Hero: calls $0.06
*** TURN *** [Kc Qc 5c] [6c]
Hero: bets $0.41
7d65956: calls $0.41
*** RIVER *** [Kc Qc 5c 6c] [7d]
Hero: bets $1.37
7d65956: folds
Uncalled bet ($1.37) returned to Hero
*** SHOWDOWN ***
Hero collected $1.11 from pot
*** SUMMARY ***
Total pot $1.16 | Rake $0.05 | Jackpot $0 | Bingo $0 | Fortune $0 | Tax $0
Board [Kc Qc 5c 6c 7d]
Seat 1: 1862c639 (button) folded before Flop (didn't bet)
Seat 2: 98569691 (small blind) folded before Flop
Seat 3: Hero (big blind) won ($1.11)
Seat 4: 7d65956 folded on the River
Seat 5: 6da9cdea folded before Flop (didn't bet)
Seat 6: 6f824e82 folded before Flop (didn't bet)


Poker Hand #RC3811130406: Hold'em No Limit ($0.02/$0.05) - 2025/08/16 12:03:40
Table 'RushAndCash835666' 6-max Seat #1 is the button
Seat 1: Hero ($10.67 in chips)
Seat 2: 343e61a8 ($7.46 in chips)
Seat 3: e5075287 ($5.67 in chips)
Seat 4: 8b7f3f95 ($5.57 in chips)
Seat 5: e767dc8d ($5.05 in chips)
Seat 6: 5f9faf68 ($5.13 in chips)
343e61a8: posts small blind $0.02
e5075287: posts big blind $0.05
*** HOLE CARDS ***
Dealt to Hero [9c Ts]
Dealt to 343e61a8 
Dealt to e5075287 
Dealt to 8b7f3f95 
Dealt to e767dc8d 
Dealt to 5f9faf68 
8b7f3f95: folds
e767dc8d: folds
5f9faf68: folds
Hero: raises $0.05 to $0.1
343e61a8: folds
e5075287: folds
Uncalled bet ($0.05) returned to Hero
*** SHOWDOWN ***
Hero collected $0.12 from pot
*** SUMMARY ***
Total pot $0.12 | Rake $0 | Jackpot $0 | Bingo $0 | Fortune $0 | Tax $0
Seat 1: Hero (button) collected ($0.12)
Seat 2: 343e61a8 (small blind) folded before Flop
Seat 3: e5075287 (big blind) folded before Flop
Seat 4: 8b7f3f95 folded before Flop (didn't bet)
Seat 5: e767dc8d folded before Flop (didn't bet)
Seat 6: 5f9faf68 folded before Flop (didn't bet)


Poker Hand #RC3811130392: Hold'em No Limit ($0.02/$0.05) - 2025/08/16 12:03:36
Table 'RushAndCash835652' 6-max Seat #1 is the button
Seat 1: e52162d4 ($5.02 in chips)
Seat 2: cf20b2f9 ($5.06 in chips)
Seat 3: 1a5c24ee ($12.54 in chips)
Seat 4: Hero ($10.67 in chips)
Seat 5: c0cdc178 ($5.38 in chips)
Seat 6: 637b142c ($5.82 in chips)
cf20b2f9: posts small blind $0.02
1a5c24ee: posts big blind $0.05
*** HOLE CARDS ***
Dealt to e52162d4 
Dealt to cf20b2f9 
Dealt to 1a5c24ee 
Dealt to Hero [Qd 3s]
Dealt to c0cdc178 
Dealt to 637b142c 
Hero: folds
c0cdc178: folds
637b142c: folds
e52162d4: folds
cf20b2f9: raises $0.09 to $0.14
1a5c24ee: raises $0.31 to $0.45
cf20b2f9: raises $0.68 to $1.13
1a5c24ee: calls $0.68
*** FLOP *** [2s 8s 4h]
cf20b2f9: bets $0.75
1a5c24ee: calls $0.75
*** TURN *** [2s 8s 4h] [6c]
cf20b2f9: bets $3.18 and is all-in
1a5c24ee: folds
Uncalled bet ($3.18) returned to cf20b2f9
*** SHOWDOWN ***
cf20b2f9 collected $3.54 from pot
*** SUMMARY ***
Total pot $3.76 | Rake $0.15 | Jackpot $0.07 | Bingo $0 | Fortune $0 | Tax $0
Board [2s 8s 4h 6c]
Seat 1: e52162d4 (button) folded before Flop (didn't bet)
Seat 2: cf20b2f9 (small blind) won ($3.54)
Seat 3: 1a5c24ee (big blind) folded on the Turn
Seat 4: Hero folded before Flop (didn't bet)
Seat 5: c0cdc178 folded before Flop (didn't bet)
Seat 6: 637b142c folded before Flop (didn't bet)


Poker Hand #RC3811130373: Hold'em No Limit ($0.02/$0.05) - 2025/08/16 12:03:32
Table 'RushAndCash835633' 6-max Seat #1 is the button
Seat 1: 71776f32 ($5.56 in chips)
Seat 2: c5849feb ($5.82 in chips)
Seat 3: fd16d07b ($4.45 in chips)
Seat 4: 319f9ef4 ($11.07 in chips)
Seat 5: Hero ($10.67 in chips)
Seat 6: a699aebd ($6.59 in chips)
c5849feb: posts small blind $0.02
fd16d07b: posts big blind $0.05
*** HOLE CARDS ***
Dealt to 71776f32 
Dealt to c5849feb 
Dealt to fd16d07b 
Dealt to 319f9ef4 
Dealt to Hero [6h 9h]
Dealt to a699aebd 
319f9ef4: folds
Hero: folds
a699aebd: folds
71776f32: folds
c5849feb: folds
Uncalled bet ($0.03) returned to fd16d07b
*** SHOWDOWN ***
fd16d07b collected $0.04 from pot
*** SUMMARY ***
Total pot $0.04 | Rake $0 | Jackpot $0 | Bingo $0 | Fortune $0 | Tax $0
Seat 1: 71776f32 (button) folded before Flop (didn't bet)
Seat 2: c5849feb (small blind) folded before Flop
Seat 3: fd16d07b (big blind) collected ($0.04)
Seat 4: 319f9ef4 folded before Flop (didn't bet)
Seat 5: Hero folded before Flop (didn't bet)
Seat 6: a699aebd folded before Flop (didn't bet)


Poker Hand #RC3811130318: Hold'em No Limit ($0.02/$0.05) - 2025/08/16 12:03:18
Table 'RushAndCash835578' 6-max Seat #1 is the button
Seat 1: Hero ($10.67 in chips)
Seat 2: f4a09c50 ($6.14 in chips)
Seat 3: 91e0daba ($9.64 in chips)
Seat 4: 3415db9 ($20.57 in chips)
Seat 5: 72f3bb5c ($6.25 in chips)
Seat 6: 8b3d6303 ($5.19 in chips)
f4a09c50: posts small blind $0.02
91e0daba: posts big blind $0.05
*** HOLE CARDS ***
Dealt to Hero [9s 8h]
Dealt to f4a09c50 
Dealt to 91e0daba 
Dealt to 3415db9 
Dealt to 72f3bb5c 
Dealt to 8b3d6303 
3415db9: folds
72f3bb5c: folds
8b3d6303: raises $0.08 to $0.13
Hero: folds
f4a09c50: folds
91e0daba: raises $0.24 to $0.37
8b3d6303: folds
Uncalled bet ($0.24) returned to 91e0daba
*** SHOWDOWN ***
91e0daba collected $0.27 from pot
*** SUMMARY ***
Total pot $0.28 | Rake $0.01 | Jackpot $0 | Bingo $0 | Fortune $0 | Tax $0
Seat 1: Hero (button) folded before Flop (didn't bet)
Seat 2: f4a09c50 (small blind) folded before Flop
Seat 3: 91e0daba (big blind) collected ($0.27)
Seat 4: 3415db9 folded before Flop (didn't bet)
Seat 5: 72f3bb5c folded before Flop (didn't bet)
Seat 6: 8b3d6303 folded before Flop


Poker Hand #RC3811130288: Hold'em No Limit ($0.02/$0.05) - 2025/08/16 12:03:11
Table 'RushAndCash835548' 6-max Seat #1 is the button
Seat 1: fad7a12d ($5 in chips)
Seat 2: 5eb32c86 ($4.75 in chips)
Seat 3: Hero ($10.72 in chips)
Seat 4: a394e4ae ($5 in chips)
Seat 5: a214d20f ($6.08 in chips)
Seat 6: ea5cec14 ($3.68 in chips)
5eb32c86: posts small blind $0.02
Hero: posts big blind $0.05
*** HOLE CARDS ***
Dealt to fad7a12d 
Dealt to 5eb32c86 
Dealt to Hero [3d Jh]
Dealt to a394e4ae 
Dealt to a214d20f 
Dealt to ea5cec14 
a394e4ae: folds
a214d20f: raises $0.05 to $0.1
ea5cec14: raises $0.14 to $0.24
fad7a12d: calls $0.24
5eb32c86: calls $0.22
Hero: folds
a214d20f: folds
*** FLOP *** [6s 8h 6d]
5eb32c86: checks
ea5cec14: checks
fad7a12d: bets $0.29
5eb32c86: folds
ea5cec14: folds
Uncalled bet ($0.29) returned to fad7a12d
*** SHOWDOWN ***
fad7a12d collected $0.83 from pot
*** SUMMARY ***
Total pot $0.87 | Rake $0.04 | Jackpot $0 | Bingo $0 | Fortune $0 | Tax $0
Board [6s 8h 6d]
Seat 1: fad7a12d (button) won ($0.83)
Seat 2: 5eb32c86 (small blind) folded on the Flop
Seat 3: Hero (big blind) folded before Flop
Seat 4: a394e4ae folded before Flop (didn't bet)
Seat 5: a214d20f folded before Flop
Seat 6: ea5cec14 folded on the Flop


Poker Hand #RC3811130265: Hold'em No Limit ($0.02/$0.05) - 2025/08/16 12:03:06
Table 'RushAndCash835525' 6-max Seat #1 is the button
Seat 1: e18a2e35 ($5 in chips)
Seat 2: Hero ($10.74 in chips)
Seat 3: 3bc9dc9 ($6.33 in chips)
Seat 4: aba29e24 ($8.42 in chips)
Seat 5: eb0e7b62 ($10.27 in chips)
Seat 6: af718e4b ($24.81 in chips)
Hero: posts small blind $0.02
3bc9dc9: posts big blind $0.05
*** HOLE CARDS ***
Dealt to e18a2e35 
Dealt to Hero [Js 2c]
Dealt to 3bc9dc9 
Dealt to aba29e24 
Dealt to eb0e7b62 
Dealt to af718e4b 
aba29e24: folds
eb0e7b62: folds
af718e4b: folds
e18a2e35: raises $0.05 to $0.1
Hero: folds
3bc9dc9: raises $0.11 to $0.21
e18a2e35: folds
Uncalled bet ($0.11) returned to 3bc9dc9
*** SHOWDOWN ***
3bc9dc9 collected $0.21 from pot
*** SUMMARY ***
Total pot $0.22 | Rake $0.01 | Jackpot $0 | Bingo $0 | Fortune $0 | Tax $0
Seat 1: e18a2e35 (button) folded before Flop
Seat 2: Hero (small blind) folded before Flop
Seat 3: 3bc9dc9 (big blind) collected ($0.21)
Seat 4: aba29e24 folded before Flop (didn't bet)
Seat 5: eb0e7b62 folded before Flop (didn't bet)
Seat 6: af718e4b folded before Flop (didn't bet)


Poker Hand #RC3811130014: Hold'em No Limit ($0.02/$0.05) - 2025/08/16 12:02:04
Table 'RushAndCash835274' 6-max Seat #1 is the button
Seat 1: ad373012 ($8.64 in chips)
Seat 2: fd0ae030 ($10 in chips)
Seat 3: eb0e7b62 ($10.52 in chips)
Seat 4: 9c1a625d ($5.05 in chips)
Seat 5: af718e4b ($24.93 in chips)
Seat 6: Hero ($10.38 in chips)
fd0ae030: posts small blind $0.02
eb0e7b62: posts big blind $0.05
*** HOLE CARDS ***
Dealt to ad373012 
Dealt to fd0ae030 
Dealt to eb0e7b62 
Dealt to 9c1a625d 
Dealt to af718e4b 
Dealt to Hero [9c 8c]
9c1a625d: folds
af718e4b: raises $0.07 to $0.12
Hero: calls $0.12
ad373012: folds
fd0ae030: folds
eb0e7b62: calls $0.07
*** FLOP *** [Jh Td 2c]
eb0e7b62: bets $0.13
af718e4b: folds
Hero: calls $0.13
*** TURN *** [Jh Td 2c] [2d]
eb0e7b62: checks
Hero: bets $0.42
eb0e7b62: folds
Uncalled bet ($0.42) returned to Hero
*** SHOWDOWN ***
Hero collected $0.61 from pot
*** SUMMARY ***
Total pot $0.64 | Rake $0.03 | Jackpot $0 | Bingo $0 | Fortune $0 | Tax $0
Board [Jh Td 2c 2d]
Seat 1: ad373012 (button) folded before Flop (didn't bet)
Seat 2: fd0ae030 (small blind) folded before Flop
Seat 3: eb0e7b62 (big blind) folded on the Turn
Seat 4: 9c1a625d folded before Flop (didn't bet)
Seat 5: af718e4b folded on the Flop
Seat 6: Hero won ($0.61)


Poker Hand #RC3811129831: Hold'em No Limit ($0.02/$0.05) - 2025/08/16 12:01:20
Table 'RushAndCash835091' 6-max Seat #1 is the button
Seat 1: 4c7edfe6 ($8.24 in chips)
Seat 2: 4698ae62 ($5.73 in chips)
Seat 3: fd0ae030 ($10.1 in chips)
Seat 4: Hero ($10.27 in chips)
Seat 5: 4ab51d0d ($2.85 in chips)
Seat 6: 74bbad5f ($2.65 in chips)
4698ae62: posts small blind $0.02
fd0ae030: posts big blind $0.05
*** HOLE CARDS ***
Dealt to 4c7edfe6 
Dealt to 4698ae62 
Dealt to fd0ae030 
Dealt to Hero [Jh Qh]
Dealt to 4ab51d0d 
Dealt to 74bbad5f 
Hero: raises $0.05 to $0.1
4ab51d0d: folds
74bbad5f: folds
4c7edfe6: folds
4698ae62: folds
fd0ae030: calls $0.05
*** FLOP *** [2s 3h 3c]
fd0ae030: checks
Hero: checks
*** TURN *** [2s 3h 3c] [Ks]
fd0ae030: checks
Hero: checks
*** RIVER *** [2s 3h 3c Ks] [4s]
fd0ae030: checks
Hero: checks
fd0ae030: shows [8c 7c] (a pair of Threes)
Hero: shows [Jh Qh] (a pair of Threes)
*** SHOWDOWN ***
Hero collected $0.21 from pot
*** SUMMARY ***
Total pot $0.22 | Rake $0.01 | Jackpot $0 | Bingo $0 | Fortune $0 | Tax $0
Board [2s 3h 3c Ks 4s]
Seat 1: 4c7edfe6 (button) folded before Flop (didn't bet)
Seat 2: 4698ae62 (small blind) folded before Flop
Seat 3: fd0ae030 (big blind) showed [8c 7c] and lost with a pair of Threes
Seat 4: Hero showed [Jh Qh] and won ($0.21) with a pair of Threes
Seat 5: 4ab51d0d folded before Flop (didn't bet)
Seat 6: 74bbad5f folded before Flop (didn't bet)


Poker Hand #RC3811129811: Hold'em No Limit ($0.02/$0.05) - 2025/08/16 12:01:16
Table 'RushAndCash835071' 6-max Seat #1 is the button
Seat 1: 7feebb96 ($5.32 in chips)
Seat 2: 92be137 ($5.41 in chips)
Seat 3: f4a09c50 ($5 in chips)
Seat 4: Hero ($10.27 in chips)
Seat 5: 1ea904d2 ($5.4 in chips)
Seat 6: 256b76ed ($5.09 in chips)
92be137: posts small blind $0.02
f4a09c50: posts big blind $0.05
*** HOLE CARDS ***
Dealt to 7feebb96 
Dealt to 92be137 
Dealt to f4a09c50 
Dealt to Hero [Jd Th]
Dealt to 1ea904d2 
Dealt to 256b76ed 
Hero: folds
1ea904d2: folds
256b76ed: folds
7feebb96: folds
92be137: folds
Uncalled bet ($0.03) returned to f4a09c50
*** SHOWDOWN ***
f4a09c50 collected $0.04 from pot
*** SUMMARY ***
Total pot $0.04 | Rake $0 | Jackpot $0 | Bingo $0 | Fortune $0 | Tax $0
Seat 1: 7feebb96 (button) folded before Flop (didn't bet)
Seat 2: 92be137 (small blind) folded before Flop
Seat 3: f4a09c50 (big blind) collected ($0.04)
Seat 4: Hero folded before Flop (didn't bet)
Seat 5: 1ea904d2 folded before Flop (didn't bet)
Seat 6: 256b76ed folded before Flop (didn't bet)


Poker Hand #RC3811129782: Hold'em No Limit ($0.02/$0.05) - 2025/08/16 12:01:10
Table 'RushAndCash835042' 6-max Seat #1 is the button
Seat 1: Hero ($10.27 in chips)
Seat 2: fe7378e3 ($6.02 in chips)
Seat 3: f1e6db21 ($8.26 in chips)
Seat 4: ad373012 ($8.64 in chips)
Seat 5: 75fa1380 ($6.64 in chips)
Seat 6: b6adb304 ($13.38 in chips)
fe7378e3: posts small blind $0.02
f1e6db21: posts big blind $0.05
*** HOLE CARDS ***
Dealt to Hero [6h Ah]
Dealt to fe7378e3 
Dealt to f1e6db21 
Dealt to ad373012 
Dealt to 75fa1380 
Dealt to b6adb304 
ad373012: folds
75fa1380: raises $0.08 to $0.13
b6adb304: folds
Hero: folds
fe7378e3: folds
f1e6db21: calls $0.08
*** FLOP *** [7s Qc 2s]
f1e6db21: checks
75fa1380: bets $0.14
f1e6db21: folds
Uncalled bet ($0.14) returned to 75fa1380
*** SHOWDOWN ***
75fa1380 collected $0.27 from pot
*** SUMMARY ***
Total pot $0.28 | Rake $0.01 | Jackpot $0 | Bingo $0 | Fortune $0 | Tax $0
Board [7s Qc 2s]
Seat 1: Hero (button) folded before Flop (didn't bet)
Seat 2: fe7378e3 (small blind) folded before Flop
Seat 3: f1e6db21 (big blind) folded on the Flop
Seat 4: ad373012 folded before Flop (didn't bet)
Seat 5: 75fa1380 won ($0.27)
Seat 6: b6adb304 folded before Flop (didn't bet)


Poker Hand #RC3811129721: Hold'em No Limit ($0.02/$0.05) - 2025/08/16 12:00:57
Table 'RushAndCash834981' 6-max Seat #1 is the button
Seat 1: b6e03a16 ($5.07 in chips)
Seat 2: Hero ($10.29 in chips)
Seat 3: 616cdf4a ($21.68 in chips)
Seat 4: c58b8609 ($15.34 in chips)
Seat 5: aecbb8f2 ($5.26 in chips)
Seat 6: 6ad839b8 ($8.12 in chips)
Hero: posts small blind $0.02
616cdf4a: posts big blind $0.05
*** HOLE CARDS ***
Dealt to b6e03a16 
Dealt to Hero [3s 4c]
Dealt to 616cdf4a 
Dealt to c58b8609 
Dealt to aecbb8f2 
Dealt to 6ad839b8 
c58b8609: folds
aecbb8f2: folds
6ad839b8: folds
b6e03a16: folds
Hero: folds
Uncalled bet ($0.03) returned to 616cdf4a
*** SHOWDOWN ***
616cdf4a collected $0.04 from pot
*** SUMMARY ***
Total pot $0.04 | Rake $0 | Jackpot $0 | Bingo $0 | Fortune $0 | Tax $0
Seat 1: b6e03a16 (button) folded before Flop (didn't bet)
Seat 2: Hero (small blind) folded before Flop
Seat 3: 616cdf4a (big blind) collected ($0.04)
Seat 4: c58b8609 folded before Flop (didn't bet)
Seat 5: aecbb8f2 folded before Flop (didn't bet)
Seat 6: 6ad839b8 folded before Flop (didn't bet)


Poker Hand #RC3811129646: Hold'em No Limit ($0.02/$0.05) - 2025/08/16 12:00:41
Table 'RushAndCash834906' 6-max Seat #1 is the button
Seat 1: 74466d2f ($12.69 in chips)
Seat 2: 767ec7ee ($7.17 in chips)
Seat 3: Hero ($10.34 in chips)
Seat 4: cf40af3 ($7.26 in chips)
Seat 5: 1806aafc ($5.6 in chips)
Seat 6: 42836787 ($2.52 in chips)
767ec7ee: posts small blind $0.02
Hero: posts big blind $0.05
*** HOLE CARDS ***
Dealt to 74466d2f 
Dealt to 767ec7ee 
Dealt to Hero [5c 8s]
Dealt to cf40af3 
Dealt to 1806aafc 
Dealt to 42836787 
cf40af3: folds
1806aafc: raises $0.08 to $0.13
42836787: folds
74466d2f: raises $0.27 to $0.4
767ec7ee: folds
Hero: folds
1806aafc: raises $1 to $1.4
74466d2f: folds
Uncalled bet ($1) returned to 1806aafc
*** SHOWDOWN ***
1806aafc collected $0.83 from pot
*** SUMMARY ***
Total pot $0.87 | Rake $0.04 | Jackpot $0 | Bingo $0 | Fortune $0 | Tax $0
Seat 1: 74466d2f (button) folded before Flop
Seat 2: 767ec7ee (small blind) folded before Flop
Seat 3: Hero (big blind) folded before Flop
Seat 4: cf40af3 folded before Flop (didn't bet)
Seat 5: 1806aafc collected ($0.83)
Seat 6: 42836787 folded before Flop (didn't bet)


Poker Hand #RC3811129630: Hold'em No Limit ($0.02/$0.05) - 2025/08/16 12:00:38
Table 'RushAndCash834890' 6-max Seat #1 is the button
Seat 1: 319f9ef4 ($10.81 in chips)
Seat 2: c923a998 ($6.22 in chips)
Seat 3: 9931181d ($6.8 in chips)
Seat 4: 82c973be ($1.73 in chips)
Seat 5: Hero ($10.34 in chips)
Seat 6: cf40af3 ($7.26 in chips)
c923a998: posts small blind $0.02
9931181d: posts big blind $0.05
*** HOLE CARDS ***
Dealt to 319f9ef4 
Dealt to c923a998 
Dealt to 9931181d 
Dealt to 82c973be 
Dealt to Hero [4c 8d]
Dealt to cf40af3 
82c973be: folds
Hero: folds
cf40af3: folds
319f9ef4: raises $0.06 to $0.11
c923a998: folds
9931181d: folds
Uncalled bet ($0.06) returned to 319f9ef4
*** SHOWDOWN ***
319f9ef4 collected $0.12 from pot
*** SUMMARY ***
Total pot $0.12 | Rake $0 | Jackpot $0 | Bingo $0 | Fortune $0 | Tax $0
Seat 1: 319f9ef4 (button) collected ($0.12)
Seat 2: c923a998 (small blind) folded before Flop
Seat 3: 9931181d (big blind) folded before Flop
Seat 4: 82c973be folded before Flop (didn't bet)
Seat 5: Hero folded before Flop (didn't bet)
Seat 6: cf40af3 folded before Flop (didn't bet)


Poker Hand #RC3811129613: Hold'em No Limit ($0.02/$0.05) - 2025/08/16 12:00:34
Table 'RushAndCash834873' 6-max Seat #1 is the button
Seat 1: be02a95d ($5.23 in chips)
Seat 2: 9870a6c2 ($10.5 in chips)
Seat 3: a4bb7c21 ($8.66 in chips)
Seat 4: 581c82a8 ($5.83 in chips)
Seat 5: Hero ($10.34 in chips)
Seat 6: e725801b ($7.66 in chips)
9870a6c2: posts small blind $0.02
a4bb7c21: posts big blind $0.05
*** HOLE CARDS ***
Dealt to be02a95d 
Dealt to 9870a6c2 
Dealt to a4bb7c21 
Dealt to 581c82a8 
Dealt to Hero [2c 8c]
Dealt to e725801b 
581c82a8: folds
Hero: folds
e725801b: folds
be02a95d: raises $0.05 to $0.1
9870a6c2: folds
a4bb7c21: folds
Uncalled bet ($0.05) returned to be02a95d
*** SHOWDOWN ***
be02a95d collected $0.12 from pot
*** SUMMARY ***
Total pot $0.12 | Rake $0 | Jackpot $0 | Bingo $0 | Fortune $0 | Tax $0
Seat 1: be02a95d (button) collected ($0.12)
Seat 2: 9870a6c2 (small blind) folded before Flop
Seat 3: a4bb7c21 (big blind) folded before Flop
Seat 4: 581c82a8 folded before Flop (didn't bet)
Seat 5: Hero folded before Flop (didn't bet)
Seat 6: e725801b folded before Flop (didn't bet)


Poker Hand #RC3811129600: Hold'em No Limit ($0.02/$0.05) - 2025/08/16 12:00:31
Table 'RushAndCash834860' 6-max Seat #1 is the button
Seat 1: 4698ae62 ($5.71 in chips)
Seat 2: 154c971f ($2.81 in chips)
Seat 3: b37bc552 ($5.05 in chips)
Seat 4: Hero ($10.34 in chips)
Seat 5: d4b5e46b ($6.33 in chips)
Seat 6: 1f6b6ee5 ($2.79 in chips)
154c971f: posts small blind $0.02
b37bc552: posts big blind $0.05
*** HOLE CARDS ***
Dealt to 4698ae62 
Dealt to 154c971f 
Dealt to b37bc552 
Dealt to Hero [3s 4s]
Dealt to d4b5e46b 
Dealt to 1f6b6ee5 
Hero: folds
d4b5e46b: folds
1f6b6ee5: folds
4698ae62: raises $0.06 to $0.11
154c971f: folds
b37bc552: folds
Uncalled bet ($0.06) returned to 4698ae62
*** SHOWDOWN ***
4698ae62 collected $0.12 from pot
*** SUMMARY ***
Total pot $0.12 | Rake $0 | Jackpot $0 | Bingo $0 | Fortune $0 | Tax $0
Seat 1: 4698ae62 (button) collected ($0.12)
Seat 2: 154c971f (small blind) folded before Flop
Seat 3: b37bc552 (big blind) folded before Flop
Seat 4: Hero folded before Flop (didn't bet)
Seat 5: d4b5e46b folded before Flop (didn't bet)
Seat 6: 1f6b6ee5 folded before Flop (didn't bet)


Poker Hand #RC3811129394: Hold'em No Limit ($0.02/$0.05) - 2025/08/16 11:59:48
Table 'RushAndCash834654' 6-max Seat #1 is the button
Seat 1: c47cf5c4 ($5.2 in chips)
Seat 2: 61984ece ($5 in chips)
Seat 3: 4339513e ($10.66 in chips)
Seat 4: c923a998 ($6.32 in chips)
Seat 5: Hero ($10.18 in chips)
Seat 6: 42836787 ($2.72 in chips)
61984ece: posts small blind $0.02
4339513e: posts big blind $0.05
*** HOLE CARDS ***
Dealt to c47cf5c4 
Dealt to 61984ece 
Dealt to 4339513e 
Dealt to c923a998 
Dealt to Hero [Js Ks]
Dealt to 42836787 
c923a998: folds
Hero: raises $0.05 to $0.1
42836787: folds
c47cf5c4: folds
61984ece: folds
4339513e: calls $0.05
*** FLOP *** [Qd Jc Qc]
4339513e: checks
Hero: bets $0.05
4339513e: calls $0.05
*** TURN *** [Qd Jc Qc] [7c]
4339513e: checks
Hero: checks
*** RIVER *** [Qd Jc Qc 7c] [9s]
4339513e: checks
Hero: checks
4339513e: shows [9d Jd] (two pair, Queens and Jacks)
Hero: shows [Js Ks] (two pair, Queens and Jacks)
*** SHOWDOWN ***
Hero collected $0.31 from pot
*** SUMMARY ***
Total pot $0.32 | Rake $0.01 | Jackpot $0 | Bingo $0 | Fortune $0 | Tax $0
Board [Qd Jc Qc 7c 9s]
Seat 1: c47cf5c4 (button) folded before Flop (didn't bet)
Seat 2: 61984ece (small blind) folded before Flop
Seat 3: 4339513e (big blind) showed [9d Jd] and lost with two pair, Queens and Jacks
Seat 4: c923a998 folded before Flop (didn't bet)
Seat 5: Hero showed [Js Ks] and won ($0.31) with two pair, Queens and Jacks
Seat 6: 42836787 folded before Flop (didn't bet)


Poker Hand #RC3811129356: Hold'em No Limit ($0.02/$0.05) - 2025/08/16 11:59:40
Table 'RushAndCash834616' 6-max Seat #1 is the button
Seat 1: edb2fce5 ($5.49 in chips)
Seat 2: Hero ($10.2 in chips)
Seat 3: 60ffc042 ($5 in chips)
Seat 4: 73c308f9 ($11.7 in chips)
Seat 5: 192378e6 ($12.15 in chips)
Seat 6: b90b0181 ($4.41 in chips)
Hero: posts small blind $0.02
60ffc042: posts big blind $0.05
*** HOLE CARDS ***
Dealt to edb2fce5 
Dealt to Hero [4s 9h]
Dealt to 60ffc042 
Dealt to 73c308f9 
Dealt to 192378e6 
Dealt to b90b0181 
73c308f9: folds
192378e6: folds
b90b0181: raises $0.07 to $0.12
edb2fce5: folds
Hero: folds
60ffc042: folds
Uncalled bet ($0.07) returned to b90b0181
*** SHOWDOWN ***
b90b0181 collected $0.12 from pot
*** SUMMARY ***
Total pot $0.12 | Rake $0 | Jackpot $0 | Bingo $0 | Fortune $0 | Tax $0
Seat 1: edb2fce5 (button) folded before Flop (didn't bet)
Seat 2: Hero (small blind) folded before Flop
Seat 3: 60ffc042 (big blind) folded before Flop
Seat 4: 73c308f9 folded before Flop (didn't bet)
Seat 5: 192378e6 folded before Flop (didn't bet)
Seat 6: b90b0181 collected ($0.12)


Poker Hand #RC3811129269: Hold'em No Limit ($0.02/$0.05) - 2025/08/16 11:59:20
Table 'RushAndCash834529' 6-max Seat #1 is the button
Seat 1: 4107b3e9 ($6.21 in chips)
Seat 2: 814da7d0 ($5.33 in chips)
Seat 3: Hero ($10.25 in chips)
Seat 4: 1f0f0220 ($8.22 in chips)
Seat 5: fb15cb1a ($10.17 in chips)
Seat 6: 7ed759c7 ($8.26 in chips)
814da7d0: posts small blind $0.02
Hero: posts big blind $0.05
*** HOLE CARDS ***
Dealt to 4107b3e9 
Dealt to 814da7d0 
Dealt to Hero [Qc 2s]
Dealt to 1f0f0220 
Dealt to fb15cb1a 
Dealt to 7ed759c7 
1f0f0220: raises $0.05 to $0.1
fb15cb1a: folds
7ed759c7: folds
4107b3e9: raises $0.27 to $0.37
814da7d0: folds
Hero: folds
1f0f0220: folds
Uncalled bet ($0.27) returned to 4107b3e9
*** SHOWDOWN ***
4107b3e9 collected $0.26 from pot
*** SUMMARY ***
Total pot $0.27 | Rake $0.01 | Jackpot $0 | Bingo $0 | Fortune $0 | Tax $0
Seat 1: 4107b3e9 (button) collected ($0.26)
Seat 2: 814da7d0 (small blind) folded before Flop
Seat 3: Hero (big blind) folded before Flop
Seat 4: 1f0f0220 folded before Flop
Seat 5: fb15cb1a folded before Flop (didn't bet)
Seat 6: 7ed759c7 folded before Flop (didn't bet)


Poker Hand #RC3811129203: Hold'em No Limit ($0.02/$0.05) - 2025/08/16 11:59:06
Table 'RushAndCash834463' 6-max Seat #1 is the button
Seat 1: Hero ($10.25 in chips)
Seat 2: f206638a ($5 in chips)
Seat 3: be02a95d ($5.03 in chips)
Seat 4: 952ffa9e ($5.57 in chips)
Seat 5: 810ffb46 ($5.72 in chips)
Seat 6: c0d7b925 ($4.93 in chips)
f206638a: posts small blind $0.02
be02a95d: posts big blind $0.05
*** HOLE CARDS ***
Dealt to Hero [2d 6s]
Dealt to f206638a 
Dealt to be02a95d 
Dealt to 952ffa9e 
Dealt to 810ffb46 
Dealt to c0d7b925 
952ffa9e: raises $0.08 to $0.13
810ffb46: folds
c0d7b925: folds
Hero: folds
f206638a: folds
be02a95d: folds
Uncalled bet ($0.08) returned to 952ffa9e
*** SHOWDOWN ***
952ffa9e collected $0.12 from pot
*** SUMMARY ***
Total pot $0.12 | Rake $0 | Jackpot $0 | Bingo $0 | Fortune $0 | Tax $0
Seat 1: Hero (button) folded before Flop (didn't bet)
Seat 2: f206638a (small blind) folded before Flop
Seat 3: be02a95d (big blind) folded before Flop
Seat 4: 952ffa9e collected ($0.12)
Seat 5: 810ffb46 folded before Flop (didn't bet)
Seat 6: c0d7b925 folded before Flop (didn't bet)


Poker Hand #RC3811129185: Hold'em No Limit ($0.02/$0.05) - 2025/08/16 11:59:02
Table 'RushAndCash834445' 6-max Seat #1 is the button
Seat 1: 8c34cbdf ($5.09 in chips)
Seat 2: 6ad839b8 ($8.14 in chips)
Seat 3: c47cf5c4 ($5.34 in chips)
Seat 4: e9d8387a ($8.88 in chips)
Seat 5: Hero ($10.25 in chips)
Seat 6: 45eea39e ($8.56 in chips)
6ad839b8: posts small blind $0.02
c47cf5c4: posts big blind $0.05
*** HOLE CARDS ***
Dealt to 8c34cbdf 
Dealt to 6ad839b8 
Dealt to c47cf5c4 
Dealt to e9d8387a 
Dealt to Hero [Ks 4s]
Dealt to 45eea39e 
e9d8387a: folds
Hero: folds
45eea39e: raises $0.07 to $0.12
8c34cbdf: folds
6ad839b8: folds
c47cf5c4: folds
Uncalled bet ($0.07) returned to 45eea39e
*** SHOWDOWN ***
45eea39e collected $0.12 from pot
*** SUMMARY ***
Total pot $0.12 | Rake $0 | Jackpot $0 | Bingo $0 | Fortune $0 | Tax $0
Seat 1: 8c34cbdf (button) folded before Flop (didn't bet)
Seat 2: 6ad839b8 (small blind) folded before Flop
Seat 3: c47cf5c4 (big blind) folded before Flop
Seat 4: e9d8387a folded before Flop (didn't bet)
Seat 5: Hero folded before Flop (didn't bet)
Seat 6: 45eea39e collected ($0.12)


Poker Hand #RC3811129159: Hold'em No Limit ($0.02/$0.05) - 2025/08/16 11:58:56
Table 'RushAndCash834419' 6-max Seat #1 is the button
Seat 1: d9cc8864 ($5.34 in chips)
Seat 2: 71776f32 ($5.39 in chips)
Seat 3: 7558dbe ($4.31 in chips)
Seat 4: Hero ($10.25 in chips)
Seat 5: 256b76ed ($5 in chips)
Seat 6: 8b7f3f95 ($6.44 in chips)
71776f32: posts small blind $0.02
7558dbe: posts big blind $0.05
*** HOLE CARDS ***
Dealt to d9cc8864 
Dealt to 71776f32 
Dealt to 7558dbe 
Dealt to Hero [Th Qd]
Dealt to 256b76ed 
Dealt to 8b7f3f95 
Hero: folds
256b76ed: raises $0.08 to $0.13
8b7f3f95: folds
d9cc8864: folds
71776f32: folds
7558dbe: folds
Uncalled bet ($0.08) returned to 256b76ed
*** SHOWDOWN ***
256b76ed collected $0.12 from pot
*** SUMMARY ***
Total pot $0.12 | Rake $0 | Jackpot $0 | Bingo $0 | Fortune $0 | Tax $0
Seat 1: d9cc8864 (button) folded before Flop (didn't bet)
Seat 2: 71776f32 (small blind) folded before Flop
Seat 3: 7558dbe (big blind) folded before Flop
Seat 4: Hero folded before Flop (didn't bet)
Seat 5: 256b76ed collected ($0.12)
Seat 6: 8b7f3f95 folded before Flop (didn't bet)


Poker Hand #RC3811128966: Hold'em No Limit ($0.02/$0.05) - 2025/08/16 11:58:12
Table 'RushAndCash834226' 6-max Seat #1 is the button
Seat 1: 47a81dc7 ($4.72 in chips)
Seat 2: e1ee42f0 ($9.53 in chips)
Seat 3: 7d65956 ($5.51 in chips)
Seat 4: ffbe87fb ($5.43 in chips)
Seat 5: Hero ($10.05 in chips)
Seat 6: 8e98b00 ($5.17 in chips)
e1ee42f0: posts small blind $0.02
7d65956: posts big blind $0.05
*** HOLE CARDS ***
Dealt to 47a81dc7 
Dealt to e1ee42f0 
Dealt to 7d65956 
Dealt to ffbe87fb 
Dealt to Hero [Jd Jc]
Dealt to 8e98b00 
ffbe87fb: folds
Hero: raises $0.05 to $0.1
8e98b00: folds
47a81dc7: folds
e1ee42f0: folds
7d65956: calls $0.05
*** FLOP *** [Qc Js 8s]
7d65956: checks
Hero: bets $0.1
7d65956: calls $0.1
*** TURN *** [Qc Js 8s] [Qs]
7d65956: checks
Hero: bets $0.3
7d65956: folds
Uncalled bet ($0.3) returned to Hero
*** SHOWDOWN ***
Hero collected $0.4 from pot
*** SUMMARY ***
Total pot $0.42 | Rake $0.02 | Jackpot $0 | Bingo $0 | Fortune $0 | Tax $0
Board [Qc Js 8s Qs]
Seat 1: 47a81dc7 (button) folded before Flop (didn't bet)
Seat 2: e1ee42f0 (small blind) folded before Flop
Seat 3: 7d65956 (big blind) folded on the Turn
Seat 4: ffbe87fb folded before Flop (didn't bet)
Seat 5: Hero won ($0.4)
Seat 6: 8e98b00 folded before Flop (didn't bet)


Poker Hand #RC3811128474: Hold'em No Limit ($0.02/$0.05) - 2025/08/16 11:56:13
Table 'RushAndCash833734' 6-max Seat #1 is the button
Seat 1: 3415db9 ($20.78 in chips)
Seat 2: Hero ($10.07 in chips)
Seat 3: deff20a0 ($7.75 in chips)
Seat 4: c47cf5c4 ($7.56 in chips)
Seat 5: 526c467b ($0.76 in chips)
Seat 6: 1a5c24ee ($11.89 in chips)
Hero: posts small blind $0.02
deff20a0: posts big blind $0.05
*** HOLE CARDS ***
Dealt to 3415db9 
Dealt to Hero [6d 9c]
Dealt to deff20a0 
Dealt to c47cf5c4 
Dealt to 526c467b 
Dealt to 1a5c24ee 
c47cf5c4: folds
526c467b: raises $0.71 to $0.76 and is all-in
1a5c24ee: folds
3415db9: calls $0.76
Hero: folds
deff20a0: folds
526c467b: shows [9h Qd]
3415db9: shows [Ts Ah]
*** FIRST FLOP *** [8d Qs 7d]
*** FIRST TURN *** [8d Qs 7d] [Js]
*** FIRST RIVER *** [8d Qs 7d Js] [2c]
*** SECOND FLOP *** [4d 4s Qh]
*** SECOND TURN *** [4d 4s Qh] [6h]
*** SECOND RIVER *** [4d 4s Qh 6h] [4c]
*** FIRST SHOWDOWN ***
526c467b collected $0.73 from pot
*** SECOND SHOWDOWN ***
526c467b collected $0.73 from pot
*** SUMMARY ***
Total pot $1.59 | Rake $0.06 | Jackpot $0.07 | Bingo $0 | Fortune $0 | Tax $0
Hand was run two times
FIRST Board [8d Qs 7d Js 2c]
SECOND Board [4d 4s Qh 6h 4c]
Seat 1: 3415db9 (button) showed [Ts Ah] and lost with Ace high, and lost with three of a kind, Fours
Seat 2: Hero (small blind) folded before Flop
Seat 3: deff20a0 (big blind) folded before Flop
Seat 4: c47cf5c4 folded before Flop (didn't bet)
Seat 5: 526c467b showed [9h Qd] and won ($0.73) with a pair of Queens, and won ($0.73) with a full house, Fours full of Queens
Seat 6: 1a5c24ee folded before Flop (didn't bet)


Poker Hand #RC3811128067: Hold'em No Limit ($0.02/$0.05) - 2025/08/16 11:54:37
Table 'RushAndCash833327' 6-max Seat #1 is the button
Seat 1: 45eea39e ($7.86 in chips)
Seat 2: 4d159d0 ($5.15 in chips)
Seat 3: Hero ($5.27 in chips)
Seat 4: 7ed759c7 ($8.59 in chips)
Seat 5: 7925797d ($5 in chips)
Seat 6: 20400cad ($5 in chips)
4d159d0: posts small blind $0.02
Hero: posts big blind $0.05
*** HOLE CARDS ***
Dealt to 45eea39e 
Dealt to 4d159d0 
Dealt to Hero [8d Td]
Dealt to 7ed759c7 
Dealt to 7925797d 
Dealt to 20400cad 
7ed759c7: folds
7925797d: folds
20400cad: raises $0.07 to $0.12
45eea39e: folds
4d159d0: folds
Hero: calls $0.07
*** FLOP *** [5c 7d 6d]
Hero: bets $0.31
20400cad: raises $0.66 to $0.97
Hero: raises $0.85 to $1.82
20400cad: raises $3.06 to $4.88 and is all-in
Hero: calls $3.06
20400cad: shows [Kc Kd] (a pair of Kings)
Hero: shows [8d Td] (Ten high)
*** TURN *** [5c 7d 6d] [7c]
*** RIVER *** [5c 7d 6d 7c] [2d]
*** SHOWDOWN ***
Hero collected $9.8 from pot
*** SUMMARY ***
Total pot $10.02 | Rake $0.15 | Jackpot $0.07 | Bingo $0 | Fortune $0 | Tax $0
Board [5c 7d 6d 7c 2d]
Seat 1: 45eea39e (button) folded before Flop (didn't bet)
Seat 2: 4d159d0 (small blind) folded before Flop
Seat 3: Hero (big blind) showed [8d Td] and won ($9.8) with a flush Ten high
Seat 4: 7ed759c7 folded before Flop (didn't bet)
Seat 5: 7925797d folded before Flop (didn't bet)
Seat 6: 20400cad showed [Kc Kd] and lost with two pair, Kings and Sevens


Poker Hand #RC3811128044: Hold'em No Limit ($0.02/$0.05) - 2025/08/16 11:54:33
Table 'RushAndCash833304' 6-max Seat #1 is the button
Seat 1: Hero ($5.27 in chips)
Seat 2: 436e1fd ($4.38 in chips)
Seat 3: 4dd8d914 ($5.49 in chips)
Seat 4: eed190a6 ($6.4 in chips)
Seat 5: b4545ddd ($5.73 in chips)
Seat 6: 73b20583 ($6.3 in chips)
436e1fd: posts small blind $0.02
4dd8d914: posts big blind $0.05
*** HOLE CARDS ***
Dealt to Hero [Jd 3c]
Dealt to 436e1fd 
Dealt to 4dd8d914 
Dealt to eed190a6 
Dealt to b4545ddd 
Dealt to 73b20583 
eed190a6: raises $0.05 to $0.1
b4545ddd: folds
73b20583: folds
Hero: folds
436e1fd: folds
4dd8d914: folds
Uncalled bet ($0.05) returned to eed190a6
*** SHOWDOWN ***
eed190a6 collected $0.12 from pot
*** SUMMARY ***
Total pot $0.12 | Rake $0 | Jackpot $0 | Bingo $0 | Fortune $0 | Tax $0
Seat 1: Hero (button) folded before Flop (didn't bet)
Seat 2: 436e1fd (small blind) folded before Flop
Seat 3: 4dd8d914 (big blind) folded before Flop
Seat 4: eed190a6 collected ($0.12)
Seat 5: b4545ddd folded before Flop (didn't bet)
Seat 6: 73b20583 folded before Flop (didn't bet)


Poker Hand #RC3811128027: Hold'em No Limit ($0.02/$0.05) - 2025/08/16 11:54:29
Table 'RushAndCash833287' 6-max Seat #1 is the button
Seat 1: a719981c ($7.36 in chips)
Seat 2: 4339513e ($11.42 in chips)
Seat 3: caa77df6 ($4.9 in chips)
Seat 4: Hero ($5.27 in chips)
Seat 5: 91e0daba ($5 in chips)
Seat 6: 70a9354e ($12.92 in chips)
4339513e: posts small blind $0.02
caa77df6: posts big blind $0.05
*** HOLE CARDS ***
Dealt to a719981c 
Dealt to 4339513e 
Dealt to caa77df6 
Dealt to Hero [8s Jh]
Dealt to 91e0daba 
Dealt to 70a9354e 
Hero: folds
91e0daba: folds
70a9354e: raises $0.08 to $0.13
a719981c: folds
4339513e: folds
caa77df6: folds
Uncalled bet ($0.08) returned to 70a9354e
*** SHOWDOWN ***
70a9354e collected $0.12 from pot
*** SUMMARY ***
Total pot $0.12 | Rake $0 | Jackpot $0 | Bingo $0 | Fortune $0 | Tax $0
Seat 1: a719981c (button) folded before Flop (didn't bet)
Seat 2: 4339513e (small blind) folded before Flop
Seat 3: caa77df6 (big blind) folded before Flop
Seat 4: Hero folded before Flop (didn't bet)
Seat 5: 91e0daba folded before Flop (didn't bet)
Seat 6: 70a9354e collected ($0.12)


Poker Hand #RC3811128009: Hold'em No Limit ($0.02/$0.05) - 2025/08/16 11:54:25
Table 'RushAndCash833269' 6-max Seat #1 is the button
Seat 1: 17f8f0d4 ($5 in chips)
Seat 2: 73c308f9 ($10.73 in chips)
Seat 3: 6d52458c ($9.87 in chips)
Seat 4: 3600837f ($7.51 in chips)
Seat 5: Hero ($5.27 in chips)
Seat 6: dd67c485 ($3.37 in chips)
73c308f9: posts small blind $0.02
6d52458c: posts big blind $0.05
*** HOLE CARDS ***
Dealt to 17f8f0d4 
Dealt to 73c308f9 
Dealt to 6d52458c 
Dealt to 3600837f 
Dealt to Hero [Tc 8h]
Dealt to dd67c485 
3600837f: folds
Hero: folds
dd67c485: folds
17f8f0d4: folds
73c308f9: folds
Uncalled bet ($0.03) returned to 6d52458c
*** SHOWDOWN ***
6d52458c collected $0.04 from pot
*** SUMMARY ***
Total pot $0.04 | Rake $0 | Jackpot $0 | Bingo $0 | Fortune $0 | Tax $0
Seat 1: 17f8f0d4 (button) folded before Flop (didn't bet)
Seat 2: 73c308f9 (small blind) folded before Flop
Seat 3: 6d52458c (big blind) collected ($0.04)
Seat 4: 3600837f folded before Flop (didn't bet)
Seat 5: Hero folded before Flop (didn't bet)
Seat 6: dd67c485 folded before Flop (didn't bet)


Poker Hand #RC3811127995: Hold'em No Limit ($0.02/$0.05) - 2025/08/16 11:54:22
Table 'RushAndCash833255' 6-max Seat #1 is the button
Seat 1: 53ae2c4c ($3.52 in chips)
Seat 2: ffbe87fb ($6.66 in chips)
Seat 3: c7f821aa ($3.69 in chips)
Seat 4: e9bc54bf ($10.87 in chips)
Seat 5: caa77df6 ($4.9 in chips)
Seat 6: Hero ($5.27 in chips)
ffbe87fb: posts small blind $0.02
c7f821aa: posts big blind $0.05
*** HOLE CARDS ***
Dealt to 53ae2c4c 
Dealt to ffbe87fb 
Dealt to c7f821aa 
Dealt to e9bc54bf 
Dealt to caa77df6 
Dealt to Hero [7h 4d]
e9bc54bf: folds
caa77df6: folds
Hero: folds
53ae2c4c: folds
ffbe87fb: raises $0.1 to $0.15
c7f821aa: raises $0.31 to $0.46
ffbe87fb: calls $0.31
*** FLOP *** [8d 7d 4s]
ffbe87fb: checks
c7f821aa: bets $0.69
ffbe87fb: calls $0.69
*** TURN *** [8d 7d 4s] [9h]
ffbe87fb: checks
c7f821aa: bets $2.54 and is all-in
ffbe87fb: folds
Uncalled bet ($2.54) returned to c7f821aa
*** SHOWDOWN ***
c7f821aa collected $2.12 from pot
*** SUMMARY ***
Total pot $2.3 | Rake $0.11 | Jackpot $0.07 | Bingo $0 | Fortune $0 | Tax $0
Board [8d 7d 4s 9h]
Seat 1: 53ae2c4c (button) folded before Flop (didn't bet)
Seat 2: ffbe87fb (small blind) folded on the Turn
Seat 3: c7f821aa (big blind) won ($2.12)
Seat 4: e9bc54bf folded before Flop (didn't bet)
Seat 5: caa77df6 folded before Flop (didn't bet)
Seat 6: Hero folded before Flop (didn't bet)


Poker Hand #RC3811127933: Hold'em No Limit ($0.02/$0.05) - 2025/08/16 11:54:08
Table 'RushAndCash833193' 6-max Seat #1 is the button
Seat 1: Hero ($5.27 in chips)
Seat 2: 613daa75 ($5 in chips)
Seat 3: db8a363d ($4.58 in chips)
Seat 4: 9b3a6ffd ($8.23 in chips)
Seat 5: 589a5d42 ($10.33 in chips)
Seat 6: 6f824e82 ($11.23 in chips)
613daa75: posts small blind $0.02
db8a363d: posts big blind $0.05
*** HOLE CARDS ***
Dealt to Hero [4c As]
Dealt to 613daa75 
Dealt to db8a363d 
Dealt to 9b3a6ffd 
Dealt to 589a5d42 
Dealt to 6f824e82 
9b3a6ffd: raises $0.07 to $0.12
589a5d42: folds
6f824e82: folds
Hero: folds
613daa75: folds
db8a363d: folds
Uncalled bet ($0.07) returned to 9b3a6ffd
*** SHOWDOWN ***
9b3a6ffd collected $0.12 from pot
*** SUMMARY ***
Total pot $0.12 | Rake $0 | Jackpot $0 | Bingo $0 | Fortune $0 | Tax $0
Seat 1: Hero (button) folded before Flop (didn't bet)
Seat 2: 613daa75 (small blind) folded before Flop
Seat 3: db8a363d (big blind) folded before Flop
Seat 4: 9b3a6ffd collected ($0.12)
Seat 5: 589a5d42 folded before Flop (didn't bet)
Seat 6: 6f824e82 folded before Flop (didn't bet)


Poker Hand #RC3811127740: Hold'em No Limit ($0.02/$0.05) - 2025/08/16 11:53:24
Table 'RushAndCash833000' 6-max Seat #1 is the button
Seat 1: 9a1028c8 ($10.32 in chips)
Seat 2: Hero ($4.95 in chips)
Seat 3: f3c409bd ($5 in chips)
Seat 4: eadf38fc ($5.43 in chips)
Seat 5: 613daa75 ($5 in chips)
Seat 6: 3bc9dc9 ($5.46 in chips)
Hero: posts small blind $0.02
f3c409bd: posts big blind $0.05
*** HOLE CARDS ***
Dealt to 9a1028c8 
Dealt to Hero [8d 6d]
Dealt to f3c409bd 
Dealt to eadf38fc 
Dealt to 613daa75 
Dealt to 3bc9dc9 
eadf38fc: folds
613daa75: raises $0.05 to $0.1
3bc9dc9: folds
9a1028c8: folds
Hero: raises $0.2 to $0.3
f3c409bd: folds
613daa75: calls $0.2
*** FLOP *** [2d 6s Ad]
Hero: bets $0.77
613daa75: folds
Uncalled bet ($0.77) returned to Hero
*** SHOWDOWN ***
Hero collected $0.62 from pot
*** SUMMARY ***
Total pot $0.65 | Rake $0.03 | Jackpot $0 | Bingo $0 | Fortune $0 | Tax $0
Board [2d 6s Ad]
Seat 1: 9a1028c8 (button) folded before Flop (didn't bet)
Seat 2: Hero (small blind) won ($0.62)
Seat 3: f3c409bd (big blind) folded before Flop
Seat 4: eadf38fc folded before Flop (didn't bet)
Seat 5: 613daa75 folded on the Flop
Seat 6: 3bc9dc9 folded before Flop (didn't bet)


Poker Hand #RC3811127700: Hold'em No Limit ($0.02/$0.05) - 2025/08/16 11:53:16
Table 'RushAndCash832960' 6-max Seat #1 is the button
Seat 1: 73b20583 ($6.19 in chips)
Seat 2: 7ac5c1d6 ($5 in chips)
Seat 3: Hero ($5 in chips)
Seat 4: 5d53942d ($5 in chips)
Seat 5: fd0ae030 ($10.01 in chips)
Seat 6: f1e6db21 ($9.47 in chips)
7ac5c1d6: posts small blind $0.02
Hero: posts big blind $0.05
*** HOLE CARDS ***
Dealt to 73b20583 
Dealt to 7ac5c1d6 
Dealt to Hero [9h 6h]
Dealt to 5d53942d 
Dealt to fd0ae030 
Dealt to f1e6db21 
5d53942d: raises $0.05 to $0.1
fd0ae030: folds
f1e6db21: folds
73b20583: folds
7ac5c1d6: folds
Hero: folds
Uncalled bet ($0.05) returned to 5d53942d
*** SHOWDOWN ***
5d53942d collected $0.12 from pot
*** SUMMARY ***
Total pot $0.12 | Rake $0 | Jackpot $0 | Bingo $0 | Fortune $0 | Tax $0
Seat 1: 73b20583 (button) folded before Flop (didn't bet)
Seat 2: 7ac5c1d6 (small blind) folded before Flop
Seat 3: Hero (big blind) folded before Flop
Seat 4: 5d53942d collected ($0.12)
Seat 5: fd0ae030 folded before Flop (didn't bet)
Seat 6: f1e6db21 folded before Flop (didn't bet)


