Poker Hand #RC3794757472: Hold'em No Limit ($0.02/$0.05) - 2025/08/09 21:06:59
Table 'RushAndCash10842732' 6-max Seat #1 is the button
Seat 1: c037fcf6 ($5.46 in chips)
Seat 2: a9317c54 ($5.66 in chips)
Seat 3: 8bbcfd8 ($8.55 in chips)
Seat 4: 972aadb9 ($7.6 in chips)
Seat 5: 4936349d ($5.82 in chips)
Seat 6: Hero ($10.92 in chips)
a9317c54: posts small blind $0.02
8bbcfd8: posts big blind $0.05
*** HOLE CARDS ***
Dealt to c037fcf6 
Dealt to a9317c54 
Dealt to 8bbcfd8 
Dealt to 972aadb9 
Dealt to 4936349d 
Dealt to Hero [8c Ad]
972aadb9: folds
4936349d: folds
Hero: folds
c037fcf6: raises $0.08 to $0.13
a9317c54: folds
8bbcfd8: folds
Uncalled bet ($0.08) returned to c037fcf6
*** SHOWDOWN ***
c037fcf6 collected $0.12 from pot
*** SUMMARY ***
Total pot $0.12 | Rake $0 | Jackpot $0 | Bingo $0 | Fortune $0 | Tax $0
Seat 1: c037fcf6 (button) collected ($0.12)
Seat 2: a9317c54 (small blind) folded before Flop
Seat 3: 8bbcfd8 (big blind) folded before Flop
Seat 4: 972aadb9 folded before Flop (didn't bet)
Seat 5: 4936349d folded before Flop (didn't bet)
Seat 6: Hero folded before Flop (didn't bet)


Poker Hand #RC3794757449: Hold'em No Limit ($0.02/$0.05) - 2025/08/09 21:06:55
Table 'RushAndCash10842709' 6-max Seat #1 is the button
Seat 1: 5b9fab38 ($5.57 in chips)
Seat 2: 9ad0155e ($6.31 in chips)
Seat 3: 36655a52 ($5 in chips)
Seat 4: 56274f49 ($5.29 in chips)
Seat 5: 972aadb9 ($7.6 in chips)
Seat 6: Hero ($10.92 in chips)
9ad0155e: posts small blind $0.02
36655a52: posts big blind $0.05
*** HOLE CARDS ***
Dealt to 5b9fab38 
Dealt to 9ad0155e 
Dealt to 36655a52 
Dealt to 56274f49 
Dealt to 972aadb9 
Dealt to Hero [4c 4h]
56274f49: folds
972aadb9: folds
Hero: folds
5b9fab38: folds
9ad0155e: raises $0.1 to $0.15
36655a52: raises $0.23 to $0.38
9ad0155e: folds
Uncalled bet ($0.23) returned to 36655a52
*** SHOWDOWN ***
36655a52 collected $0.29 from pot
*** SUMMARY ***
Total pot $0.3 | Rake $0.01 | Jackpot $0 | Bingo $0 | Fortune $0 | Tax $0
Seat 1: 5b9fab38 (button) folded before Flop (didn't bet)
Seat 2: 9ad0155e (small blind) folded before Flop
Seat 3: 36655a52 (big blind) collected ($0.29)
Seat 4: 56274f49 folded before Flop (didn't bet)
Seat 5: 972aadb9 folded before Flop (didn't bet)
Seat 6: Hero folded before Flop (didn't bet)


Poker Hand #RC3794757413: Hold'em No Limit ($0.02/$0.05) - 2025/08/09 21:06:49
Table 'RushAndCash10842673' 6-max Seat #1 is the button
Seat 1: 328a0233 ($5.68 in chips)
Seat 2: Hero ($10.94 in chips)
Seat 3: a863eb22 ($5.33 in chips)
Seat 4: 52099f56 ($5.81 in chips)
Seat 5: 8f91d21c ($5.25 in chips)
Seat 6: ab0f9e83 ($10.28 in chips)
Hero: posts small blind $0.02
a863eb22: posts big blind $0.05
*** HOLE CARDS ***
Dealt to 328a0233 
Dealt to Hero [Td Jc]
Dealt to a863eb22 
Dealt to 52099f56 
Dealt to 8f91d21c 
Dealt to ab0f9e83 
52099f56: raises $0.1 to $0.15
8f91d21c: folds
ab0f9e83: folds
328a0233: calls $0.15
Hero: folds
a863eb22: raises $0.61 to $0.76
52099f56: calls $0.61
328a0233: folds
*** FLOP *** [9s Qh 7d]
a863eb22: bets $0.58
52099f56: calls $0.58
*** TURN *** [9s Qh 7d] [7s]
a863eb22: bets $3.99 and is all-in
52099f56: folds
Uncalled bet ($3.99) returned to a863eb22
*** SHOWDOWN ***
a863eb22 collected $2.65 from pot
*** SUMMARY ***
Total pot $2.85 | Rake $0.13 | Jackpot $0.07 | Bingo $0 | Fortune $0 | Tax $0
Board [9s Qh 7d 7s]
Seat 1: 328a0233 (button) folded before Flop
Seat 2: Hero (small blind) folded before Flop
Seat 3: a863eb22 (big blind) won ($2.65)
Seat 4: 52099f56 folded on the Turn
Seat 5: 8f91d21c folded before Flop (didn't bet)
Seat 6: ab0f9e83 folded before Flop (didn't bet)


Poker Hand #RC3794757390: Hold'em No Limit ($0.02/$0.05) - 2025/08/09 21:06:45
Table 'RushAndCash10842650' 6-max Seat #1 is the button
Seat 1: a8ef2628 ($6.5 in chips)
Seat 2: c8825294 ($5.55 in chips)
Seat 3: a9c3a5c6 ($5.19 in chips)
Seat 4: 4565936a ($6.66 in chips)
Seat 5: Hero ($10.94 in chips)
Seat 6: 54c415ab ($5.4 in chips)
c8825294: posts small blind $0.02
a9c3a5c6: posts big blind $0.05
*** HOLE CARDS ***
Dealt to a8ef2628 
Dealt to c8825294 
Dealt to a9c3a5c6 
Dealt to 4565936a 
Dealt to Hero [2h As]
Dealt to 54c415ab 
4565936a: folds
Hero: folds
54c415ab: folds
a8ef2628: raises $0.05 to $0.1
c8825294: raises $0.22 to $0.32
a9c3a5c6: folds
a8ef2628: calls $0.22
*** FLOP *** [6h Kh 7s]
c8825294: bets $0.23
a8ef2628: raises $0.37 to $0.6
c8825294: calls $0.37
*** TURN *** [6h Kh 7s] [7d]
c8825294: checks
a8ef2628: checks
*** RIVER *** [6h Kh 7s 7d] [4s]
c8825294: bets $0.63
a8ef2628: folds
Uncalled bet ($0.63) returned to c8825294
*** SHOWDOWN ***
c8825294 collected $1.73 from pot
*** SUMMARY ***
Total pot $1.89 | Rake $0.09 | Jackpot $0.07 | Bingo $0 | Fortune $0 | Tax $0
Board [6h Kh 7s 7d 4s]
Seat 1: a8ef2628 (button) folded on the River
Seat 2: c8825294 (small blind) won ($1.73)
Seat 3: a9c3a5c6 (big blind) folded before Flop
Seat 4: 4565936a folded before Flop (didn't bet)
Seat 5: Hero folded before Flop (didn't bet)
Seat 6: 54c415ab folded before Flop (didn't bet)


Poker Hand #RC3794757371: Hold'em No Limit ($0.02/$0.05) - 2025/08/09 21:06:41
Table 'RushAndCash10842631' 6-max Seat #1 is the button
Seat 1: 859f0257 ($5.18 in chips)
Seat 2: 133f34ec ($8.54 in chips)
Seat 3: c27142af ($8.92 in chips)
Seat 4: 77d99075 ($5 in chips)
Seat 5: Hero ($10.94 in chips)
Seat 6: af6c0be8 ($5.47 in chips)
133f34ec: posts small blind $0.02
c27142af: posts big blind $0.05
*** HOLE CARDS ***
Dealt to 859f0257 
Dealt to 133f34ec 
Dealt to c27142af 
Dealt to 77d99075 
Dealt to Hero [4s 8s]
Dealt to af6c0be8 
77d99075: folds
Hero: folds
af6c0be8: raises $0.06 to $0.11
859f0257: calls $0.11
133f34ec: folds
c27142af: folds
*** FLOP *** [2d 9s 5s]
af6c0be8: checks
859f0257: checks
*** TURN *** [2d 9s 5s] [6s]
af6c0be8: bets $0.22
859f0257: folds
Uncalled bet ($0.22) returned to af6c0be8
*** SHOWDOWN ***
af6c0be8 collected $0.28 from pot
*** SUMMARY ***
Total pot $0.29 | Rake $0.01 | Jackpot $0 | Bingo $0 | Fortune $0 | Tax $0
Board [2d 9s 5s 6s]
Seat 1: 859f0257 (button) folded on the Turn
Seat 2: 133f34ec (small blind) folded before Flop
Seat 3: c27142af (big blind) folded before Flop
Seat 4: 77d99075 folded before Flop (didn't bet)
Seat 5: Hero folded before Flop (didn't bet)
Seat 6: af6c0be8 won ($0.28)


Poker Hand #RC3794757299: Hold'em No Limit ($0.02/$0.05) - 2025/08/09 21:06:28
Table 'RushAndCash10842559' 6-max Seat #1 is the button
Seat 1: ada030ad ($9.08 in chips)
Seat 2: 3db5d065 ($5.35 in chips)
Seat 3: Hero ($10.92 in chips)
Seat 4: 4936349d ($5.89 in chips)
Seat 5: e608b61d ($5.4 in chips)
Seat 6: 32ee6ef6 ($5.81 in chips)
3db5d065: posts small blind $0.02
Hero: posts big blind $0.05
*** HOLE CARDS ***
Dealt to ada030ad 
Dealt to 3db5d065 
Dealt to Hero [Ah 9c]
Dealt to 4936349d 
Dealt to e608b61d 
Dealt to 32ee6ef6 
4936349d: folds
e608b61d: folds
32ee6ef6: folds
ada030ad: folds
3db5d065: folds
Uncalled bet ($0.03) returned to Hero
*** SHOWDOWN ***
Hero collected $0.04 from pot
*** SUMMARY ***
Total pot $0.04 | Rake $0 | Jackpot $0 | Bingo $0 | Fortune $0 | Tax $0
Seat 1: ada030ad (button) folded before Flop (didn't bet)
Seat 2: 3db5d065 (small blind) folded before Flop
Seat 3: Hero (big blind) collected ($0.04)
Seat 4: 4936349d folded before Flop (didn't bet)
Seat 5: e608b61d folded before Flop (didn't bet)
Seat 6: 32ee6ef6 folded before Flop (didn't bet)


Poker Hand #RC3794757222: Hold'em No Limit ($0.02/$0.05) - 2025/08/09 21:06:16
Table 'RushAndCash10842482' 6-max Seat #1 is the button
Seat 1: Hero ($10.92 in chips)
Seat 2: 636fc07b ($5.79 in chips)
Seat 3: 133f34ec ($8.59 in chips)
Seat 4: 7aa650ed ($5 in chips)
Seat 5: 47485814 ($5.35 in chips)
Seat 6: 8c716ab7 ($5.07 in chips)
636fc07b: posts small blind $0.02
133f34ec: posts big blind $0.05
*** HOLE CARDS ***
Dealt to Hero [3c Th]
Dealt to 636fc07b 
Dealt to 133f34ec 
Dealt to 7aa650ed 
Dealt to 47485814 
Dealt to 8c716ab7 
7aa650ed: folds
47485814: raises $0.05 to $0.1
8c716ab7: folds
Hero: folds
636fc07b: folds
133f34ec: folds
Uncalled bet ($0.05) returned to 47485814
*** SHOWDOWN ***
47485814 collected $0.12 from pot
*** SUMMARY ***
Total pot $0.12 | Rake $0 | Jackpot $0 | Bingo $0 | Fortune $0 | Tax $0
Seat 1: Hero (button) folded before Flop (didn't bet)
Seat 2: 636fc07b (small blind) folded before Flop
Seat 3: 133f34ec (big blind) folded before Flop
Seat 4: 7aa650ed folded before Flop (didn't bet)
Seat 5: 47485814 collected ($0.12)
Seat 6: 8c716ab7 folded before Flop (didn't bet)


Poker Hand #RC3794757185: Hold'em No Limit ($0.02/$0.05) - 2025/08/09 21:06:10
Table 'RushAndCash10842445' 6-max Seat #1 is the button
Seat 1: ef98ca65 ($8.47 in chips)
Seat 2: c577f391 ($5 in chips)
Seat 3: Hero ($10.97 in chips)
Seat 4: 46e14704 ($7.28 in chips)
Seat 5: f3244c6e ($5 in chips)
Seat 6: 5f37634 ($6.56 in chips)
c577f391: posts small blind $0.02
Hero: posts big blind $0.05
*** HOLE CARDS ***
Dealt to ef98ca65 
Dealt to c577f391 
Dealt to Hero [Jh 8c]
Dealt to 46e14704 
Dealt to f3244c6e 
Dealt to 5f37634 
46e14704: raises $0.05 to $0.1
f3244c6e: folds
5f37634: raises $0.21 to $0.31
ef98ca65: folds
c577f391: folds
Hero: folds
46e14704: folds
Uncalled bet ($0.21) returned to 5f37634
*** SHOWDOWN ***
5f37634 collected $0.26 from pot
*** SUMMARY ***
Total pot $0.27 | Rake $0.01 | Jackpot $0 | Bingo $0 | Fortune $0 | Tax $0
Seat 1: ef98ca65 (button) folded before Flop (didn't bet)
Seat 2: c577f391 (small blind) folded before Flop
Seat 3: Hero (big blind) folded before Flop
Seat 4: 46e14704 folded before Flop
Seat 5: f3244c6e folded before Flop (didn't bet)
Seat 6: 5f37634 collected ($0.26)


Poker Hand #RC3794757088: Hold'em No Limit ($0.02/$0.05) - 2025/08/09 21:05:57
Table 'RushAndCash10842348' 6-max Seat #1 is the button
Seat 1: 6e0a9c3f ($5.35 in chips)
Seat 2: 5af73c56 ($13.7 in chips)
Seat 3: 458d32a5 ($7.42 in chips)
Seat 4: Hero ($10.9 in chips)
Seat 5: fc1b9e38 ($5 in chips)
Seat 6: fb765a21 ($4.72 in chips)
5af73c56: posts small blind $0.02
458d32a5: posts big blind $0.05
*** HOLE CARDS ***
Dealt to 6e0a9c3f 
Dealt to 5af73c56 
Dealt to 458d32a5 
Dealt to Hero [6d 6s]
Dealt to fc1b9e38 
Dealt to fb765a21 
Hero: raises $0.05 to $0.1
fc1b9e38: folds
fb765a21: folds
6e0a9c3f: folds
5af73c56: folds
458d32a5: folds
Uncalled bet ($0.05) returned to Hero
*** SHOWDOWN ***
Hero collected $0.12 from pot
*** SUMMARY ***
Total pot $0.12 | Rake $0 | Jackpot $0 | Bingo $0 | Fortune $0 | Tax $0
Seat 1: 6e0a9c3f (button) folded before Flop (didn't bet)
Seat 2: 5af73c56 (small blind) folded before Flop
Seat 3: 458d32a5 (big blind) folded before Flop
Seat 4: Hero collected ($0.12)
Seat 5: fc1b9e38 folded before Flop (didn't bet)
Seat 6: fb765a21 folded before Flop (didn't bet)


Poker Hand #RC3794757054: Hold'em No Limit ($0.02/$0.05) - 2025/08/09 21:05:52
Table 'RushAndCash10842314' 6-max Seat #1 is the button
Seat 1: 3a7df0c7 ($5.26 in chips)
Seat 2: 3583aaef ($9.78 in chips)
Seat 3: 88503d9 ($5.05 in chips)
Seat 4: Hero ($10.9 in chips)
Seat 5: 82fb97ba ($5.35 in chips)
Seat 6: 8bbcfd8 ($8.55 in chips)
3583aaef: posts small blind $0.02
88503d9: posts big blind $0.05
*** HOLE CARDS ***
Dealt to 3a7df0c7 
Dealt to 3583aaef 
Dealt to 88503d9 
Dealt to Hero [Jh 6h]
Dealt to 82fb97ba 
Dealt to 8bbcfd8 
Hero: folds
82fb97ba: folds
8bbcfd8: folds
3a7df0c7: folds
3583aaef: raises $0.1 to $0.15
88503d9: folds
Uncalled bet ($0.1) returned to 3583aaef
*** SHOWDOWN ***
3583aaef collected $0.1 from pot
*** SUMMARY ***
Total pot $0.1 | Rake $0 | Jackpot $0 | Bingo $0 | Fortune $0 | Tax $0
Seat 1: 3a7df0c7 (button) folded before Flop (didn't bet)
Seat 2: 3583aaef (small blind) collected ($0.1)
Seat 3: 88503d9 (big blind) folded before Flop
Seat 4: Hero folded before Flop (didn't bet)
Seat 5: 82fb97ba folded before Flop (didn't bet)
Seat 6: 8bbcfd8 folded before Flop (didn't bet)


Poker Hand #RC3794756986: Hold'em No Limit ($0.02/$0.05) - 2025/08/09 21:05:43
Table 'RushAndCash10842246' 6-max Seat #1 is the button
Seat 1: Hero ($10.9 in chips)
Seat 2: f14bdb86 ($8.7 in chips)
Seat 3: f0a09800 ($5.02 in chips)
Seat 4: 893e7c32 ($3.06 in chips)
Seat 5: 2ede25f7 ($5.09 in chips)
Seat 6: d5141f67 ($5.23 in chips)
f14bdb86: posts small blind $0.02
f0a09800: posts big blind $0.05
*** HOLE CARDS ***
Dealt to Hero [3d Kc]
Dealt to f14bdb86 
Dealt to f0a09800 
Dealt to 893e7c32 
Dealt to 2ede25f7 
Dealt to d5141f67 
893e7c32: folds
2ede25f7: folds
d5141f67: folds
Hero: folds
f14bdb86: folds
Uncalled bet ($0.03) returned to f0a09800
*** SHOWDOWN ***
f0a09800 collected $0.04 from pot
*** SUMMARY ***
Total pot $0.04 | Rake $0 | Jackpot $0 | Bingo $0 | Fortune $0 | Tax $0
Seat 1: Hero (button) folded before Flop (didn't bet)
Seat 2: f14bdb86 (small blind) folded before Flop
Seat 3: f0a09800 (big blind) collected ($0.04)
Seat 4: 893e7c32 folded before Flop (didn't bet)
Seat 5: 2ede25f7 folded before Flop (didn't bet)
Seat 6: d5141f67 folded before Flop (didn't bet)


Poker Hand #RC3794756630: Hold'em No Limit ($0.02/$0.05) - 2025/08/09 21:04:53
Table 'RushAndCash10841890' 6-max Seat #1 is the button
Seat 1: 79ca254c ($7 in chips)
Seat 2: Hero ($10.85 in chips)
Seat 3: 722603f4 ($30.3 in chips)
Seat 4: 76d3c749 ($6.35 in chips)
Seat 5: 8c575ae4 ($5 in chips)
Seat 6: a845db71 ($5.44 in chips)
Hero: posts small blind $0.02
722603f4: posts big blind $0.05
*** HOLE CARDS ***
Dealt to 79ca254c 
Dealt to Hero [6d 8h]
Dealt to 722603f4 
Dealt to 76d3c749 
Dealt to 8c575ae4 
Dealt to a845db71 
76d3c749: folds
8c575ae4: folds
a845db71: folds
79ca254c: folds
Hero: calls $0.03
722603f4: checks
*** FLOP *** [5h Jh Qh]
Hero: checks
722603f4: checks
*** TURN *** [5h Jh Qh] [Kc]
Hero: checks
722603f4: checks
*** RIVER *** [5h Jh Qh Kc] [7c]
Hero: checks
722603f4: checks
Hero: shows [6d 8h] (King high)
722603f4: shows [4h 6s] (King high)
*** SHOWDOWN ***
Hero collected $0.1 from pot
*** SUMMARY ***
Total pot $0.1 | Rake $0 | Jackpot $0 | Bingo $0 | Fortune $0 | Tax $0
Board [5h Jh Qh Kc 7c]
Seat 1: 79ca254c (button) folded before Flop (didn't bet)
Seat 2: Hero (small blind) showed [6d 8h] and won ($0.1) with King high
Seat 3: 722603f4 (big blind) showed [4h 6s] and lost with King high
Seat 4: 76d3c749 folded before Flop (didn't bet)
Seat 5: 8c575ae4 folded before Flop (didn't bet)
Seat 6: a845db71 folded before Flop (didn't bet)


Poker Hand #RC3794756608: Hold'em No Limit ($0.02/$0.05) - 2025/08/09 21:04:50
Table 'RushAndCash10841868' 6-max Seat #1 is the button
Seat 1: 8c575ae4 ($5 in chips)
Seat 2: 8b6f27db ($5.46 in chips)
Seat 3: 26e85f7d ($7.57 in chips)
Seat 4: b15eea30 ($2.76 in chips)
Seat 5: Hero ($10.85 in chips)
Seat 6: a845db71 ($5.44 in chips)
8b6f27db: posts small blind $0.02
26e85f7d: posts big blind $0.05
*** HOLE CARDS ***
Dealt to 8c575ae4 
Dealt to 8b6f27db 
Dealt to 26e85f7d 
Dealt to b15eea30 
Dealt to Hero [9s 2s]
Dealt to a845db71 
b15eea30: folds
Hero: folds
a845db71: folds
8c575ae4: folds
8b6f27db: raises $0.07 to $0.12
26e85f7d: raises $0.29 to $0.41
8b6f27db: folds
Uncalled bet ($0.29) returned to 26e85f7d
*** SHOWDOWN ***
26e85f7d collected $0.23 from pot
*** SUMMARY ***
Total pot $0.24 | Rake $0.01 | Jackpot $0 | Bingo $0 | Fortune $0 | Tax $0
Seat 1: 8c575ae4 (button) folded before Flop (didn't bet)
Seat 2: 8b6f27db (small blind) folded before Flop
Seat 3: 26e85f7d (big blind) collected ($0.23)
Seat 4: b15eea30 folded before Flop (didn't bet)
Seat 5: Hero folded before Flop (didn't bet)
Seat 6: a845db71 folded before Flop (didn't bet)


Poker Hand #RC3794756364: Hold'em No Limit ($0.02/$0.05) - 2025/08/09 21:04:12
Table 'RushAndCash10841624' 6-max Seat #1 is the button
Seat 1: a845db71 ($5.64 in chips)
Seat 2: addec0b4 ($6.19 in chips)
Seat 3: 8b6f27db ($5.02 in chips)
Seat 4: b05d0879 ($5 in chips)
Seat 5: Hero ($10.9 in chips)
Seat 6: acee9790 ($5 in chips)
addec0b4: posts small blind $0.02
8b6f27db: posts big blind $0.05
*** HOLE CARDS ***
Dealt to a845db71 
Dealt to addec0b4 
Dealt to 8b6f27db 
Dealt to b05d0879 
Dealt to Hero [6d Ad]
Dealt to acee9790 
b05d0879: folds
Hero: calls $0.05
acee9790: raises $0.15 to $0.2
a845db71: calls $0.2
addec0b4: folds
8b6f27db: raises $0.57 to $0.77
Hero: folds
acee9790: folds
a845db71: folds
Uncalled bet ($0.57) returned to 8b6f27db
*** SHOWDOWN ***
8b6f27db collected $0.64 from pot
*** SUMMARY ***
Total pot $0.67 | Rake $0.03 | Jackpot $0 | Bingo $0 | Fortune $0 | Tax $0
Seat 1: a845db71 (button) folded before Flop
Seat 2: addec0b4 (small blind) folded before Flop
Seat 3: 8b6f27db (big blind) collected ($0.64)
Seat 4: b05d0879 folded before Flop (didn't bet)
Seat 5: Hero folded before Flop
Seat 6: acee9790 folded before Flop


Poker Hand #RC3794755979: Hold'em No Limit ($0.02/$0.05) - 2025/08/09 21:03:12
Table 'RushAndCash10841239' 6-max Seat #1 is the button
Seat 1: 30a8d0af ($5.14 in chips)
Seat 2: b05d0879 ($4.82 in chips)
Seat 3: Hero ($10.68 in chips)
Seat 4: 426c3bb6 ($11.08 in chips)
Seat 5: fc68174d ($16.33 in chips)
Seat 6: 5f149f9c ($2.61 in chips)
b05d0879: posts small blind $0.02
Hero: posts big blind $0.05
*** HOLE CARDS ***
Dealt to 30a8d0af 
Dealt to b05d0879 
Dealt to Hero [8h 9c]
Dealt to 426c3bb6 
Dealt to fc68174d 
Dealt to 5f149f9c 
426c3bb6: folds
fc68174d: folds
5f149f9c: folds
30a8d0af: folds
b05d0879: raises $0.1 to $0.15
Hero: calls $0.1
*** FLOP *** [Js 6c 2d]
b05d0879: checks
Hero: bets $0.09
b05d0879: calls $0.09
*** TURN *** [Js 6c 2d] [8s]
b05d0879: checks
Hero: bets $0.38
b05d0879: folds
Uncalled bet ($0.38) returned to Hero
*** SHOWDOWN ***
Hero collected $0.46 from pot
*** SUMMARY ***
Total pot $0.48 | Rake $0.02 | Jackpot $0 | Bingo $0 | Fortune $0 | Tax $0
Board [Js 6c 2d 8s]
Seat 1: 30a8d0af (button) folded before Flop (didn't bet)
Seat 2: b05d0879 (small blind) folded on the Turn
Seat 3: Hero (big blind) won ($0.46)
Seat 4: 426c3bb6 folded before Flop (didn't bet)
Seat 5: fc68174d folded before Flop (didn't bet)
Seat 6: 5f149f9c folded before Flop (didn't bet)


Poker Hand #RC3794755956: Hold'em No Limit ($0.02/$0.05) - 2025/08/09 21:03:08
Table 'RushAndCash10841216' 6-max Seat #1 is the button
Seat 1: 59e8c082 ($9.44 in chips)
Seat 2: f3244c6e ($5 in chips)
Seat 3: 6e0a9c3f ($5.12 in chips)
Seat 4: 7271da5c ($5.09 in chips)
Seat 5: 2af9a41c ($7.14 in chips)
Seat 6: Hero ($10.68 in chips)
f3244c6e: posts small blind $0.02
6e0a9c3f: posts big blind $0.05
*** HOLE CARDS ***
Dealt to 59e8c082 
Dealt to f3244c6e 
Dealt to 6e0a9c3f 
Dealt to 7271da5c 
Dealt to 2af9a41c 
Dealt to Hero [6h 4c]
7271da5c: folds
2af9a41c: folds
Hero: folds
59e8c082: raises $0.08 to $0.13
f3244c6e: raises $0.47 to $0.6
6e0a9c3f: folds
59e8c082: folds
Uncalled bet ($0.47) returned to f3244c6e
*** SHOWDOWN ***
f3244c6e collected $0.3 from pot
*** SUMMARY ***
Total pot $0.31 | Rake $0.01 | Jackpot $0 | Bingo $0 | Fortune $0 | Tax $0
Seat 1: 59e8c082 (button) folded before Flop
Seat 2: f3244c6e (small blind) collected ($0.3)
Seat 3: 6e0a9c3f (big blind) folded before Flop
Seat 4: 7271da5c folded before Flop (didn't bet)
Seat 5: 2af9a41c folded before Flop (didn't bet)
Seat 6: Hero folded before Flop (didn't bet)


Poker Hand #RC3794755804: Hold'em No Limit ($0.02/$0.05) - 2025/08/09 21:02:44
Table 'RushAndCash10841064' 6-max Seat #1 is the button
Seat 1: 5b29662a ($9.45 in chips)
Seat 2: Hero ($10.7 in chips)
Seat 3: 502d05dc ($7.63 in chips)
Seat 4: e1e6a6ec ($12 in chips)
Seat 5: da1607b ($4.01 in chips)
Seat 6: 3d944e4 ($5 in chips)
Hero: posts small blind $0.02
502d05dc: posts big blind $0.05
*** HOLE CARDS ***
Dealt to 5b29662a 
Dealt to Hero [6s Ad]
Dealt to 502d05dc 
Dealt to e1e6a6ec 
Dealt to da1607b 
Dealt to 3d944e4 
e1e6a6ec: raises $0.05 to $0.1
da1607b: raises $0.21 to $0.31
3d944e4: folds
5b29662a: calls $0.31
Hero: folds
502d05dc: folds
e1e6a6ec: folds
*** FLOP *** [Jc 8d 2d]
da1607b: bets $0.42
5b29662a: calls $0.42
*** TURN *** [Jc 8d 2d] [3d]
da1607b: checks
5b29662a: checks
*** RIVER *** [Jc 8d 2d 3d] [7c]
da1607b: bets $0.5
5b29662a: folds
Uncalled bet ($0.5) returned to da1607b
*** SHOWDOWN ***
da1607b collected $1.47 from pot
*** SUMMARY ***
Total pot $1.63 | Rake $0.09 | Jackpot $0.07 | Bingo $0 | Fortune $0 | Tax $0
Board [Jc 8d 2d 3d 7c]
Seat 1: 5b29662a (button) folded on the River
Seat 2: Hero (small blind) folded before Flop
Seat 3: 502d05dc (big blind) folded before Flop
Seat 4: e1e6a6ec folded before Flop
Seat 5: da1607b won ($1.47)
Seat 6: 3d944e4 folded before Flop (didn't bet)


Poker Hand #RC3794755778: Hold'em No Limit ($0.02/$0.05) - 2025/08/09 21:02:40
Table 'RushAndCash10841038' 6-max Seat #1 is the button
Seat 1: b05d0879 ($4.87 in chips)
Seat 2: f9619147 ($10.8 in chips)
Seat 3: 32ee6ef6 ($5 in chips)
Seat 4: ab0f9e83 ($10.37 in chips)
Seat 5: acca462 ($4.79 in chips)
Seat 6: Hero ($10.7 in chips)
f9619147: posts small blind $0.02
32ee6ef6: posts big blind $0.05
*** HOLE CARDS ***
Dealt to b05d0879 
Dealt to f9619147 
Dealt to 32ee6ef6 
Dealt to ab0f9e83 
Dealt to acca462 
Dealt to Hero [Tc 2s]
ab0f9e83: folds
acca462: folds
Hero: folds
b05d0879: folds
f9619147: folds
Uncalled bet ($0.03) returned to 32ee6ef6
*** SHOWDOWN ***
32ee6ef6 collected $0.04 from pot
*** SUMMARY ***
Total pot $0.04 | Rake $0 | Jackpot $0 | Bingo $0 | Fortune $0 | Tax $0
Seat 1: b05d0879 (button) folded before Flop (didn't bet)
Seat 2: f9619147 (small blind) folded before Flop
Seat 3: 32ee6ef6 (big blind) collected ($0.04)
Seat 4: ab0f9e83 folded before Flop (didn't bet)
Seat 5: acca462 folded before Flop (didn't bet)
Seat 6: Hero folded before Flop (didn't bet)


Poker Hand #RC3794755721: Hold'em No Limit ($0.02/$0.05) - 2025/08/09 21:02:32
Table 'RushAndCash10840981' 6-max Seat #1 is the button
Seat 1: d45ab85a ($5.08 in chips)
Seat 2: 94c344e6 ($6.95 in chips)
Seat 3: e4a6a98b ($8.34 in chips)
Seat 4: Hero ($10.7 in chips)
Seat 5: fd24d0fe ($16.62 in chips)
Seat 6: a9c3a5c6 ($5.07 in chips)
94c344e6: posts small blind $0.02
e4a6a98b: posts big blind $0.05
*** HOLE CARDS ***
Dealt to d45ab85a 
Dealt to 94c344e6 
Dealt to e4a6a98b 
Dealt to Hero [As 2s]
Dealt to fd24d0fe 
Dealt to a9c3a5c6 
Hero: folds
fd24d0fe: raises $0.05 to $0.1
a9c3a5c6: folds
d45ab85a: folds
94c344e6: folds
e4a6a98b: calls $0.05
*** FLOP *** [Jc Qd Qc]
e4a6a98b: checks
fd24d0fe: checks
*** TURN *** [Jc Qd Qc] [6s]
e4a6a98b: bets $0.11
fd24d0fe: calls $0.11
*** RIVER *** [Jc Qd Qc 6s] [7h]
e4a6a98b: checks
fd24d0fe: bets $0.33
e4a6a98b: folds
Uncalled bet ($0.33) returned to fd24d0fe
*** SHOWDOWN ***
fd24d0fe collected $0.42 from pot
*** SUMMARY ***
Total pot $0.44 | Rake $0.02 | Jackpot $0 | Bingo $0 | Fortune $0 | Tax $0
Board [Jc Qd Qc 6s 7h]
Seat 1: d45ab85a (button) folded before Flop (didn't bet)
Seat 2: 94c344e6 (small blind) folded before Flop
Seat 3: e4a6a98b (big blind) folded on the River
Seat 4: Hero folded before Flop (didn't bet)
Seat 5: fd24d0fe won ($0.42)
Seat 6: a9c3a5c6 folded before Flop (didn't bet)


Poker Hand #RC3794755668: Hold'em No Limit ($0.02/$0.05) - 2025/08/09 21:02:24
Table 'RushAndCash10840928' 6-max Seat #1 is the button
Seat 1: Hero ($10.7 in chips)
Seat 2: 2eeff014 ($12.88 in chips)
Seat 3: 1da6e048 ($5.26 in chips)
Seat 4: ff85320b ($16.39 in chips)
Seat 5: 862bbf4 ($5 in chips)
Seat 6: f14bdb86 ($7.7 in chips)
2eeff014: posts small blind $0.02
1da6e048: posts big blind $0.05
*** HOLE CARDS ***
Dealt to Hero [2d 4s]
Dealt to 2eeff014 
Dealt to 1da6e048 
Dealt to ff85320b 
Dealt to 862bbf4 
Dealt to f14bdb86 
ff85320b: folds
862bbf4: raises $0.05 to $0.1
f14bdb86: folds
Hero: folds
2eeff014: folds
1da6e048: folds
Uncalled bet ($0.05) returned to 862bbf4
*** SHOWDOWN ***
862bbf4 collected $0.12 from pot
*** SUMMARY ***
Total pot $0.12 | Rake $0 | Jackpot $0 | Bingo $0 | Fortune $0 | Tax $0
Seat 1: Hero (button) folded before Flop (didn't bet)
Seat 2: 2eeff014 (small blind) folded before Flop
Seat 3: 1da6e048 (big blind) folded before Flop
Seat 4: ff85320b folded before Flop (didn't bet)
Seat 5: 862bbf4 collected ($0.12)
Seat 6: f14bdb86 folded before Flop (didn't bet)


Poker Hand #RC3794755642: Hold'em No Limit ($0.02/$0.05) - 2025/08/09 21:02:20
Table 'RushAndCash10840902' 6-max Seat #1 is the button
Seat 1: 5f149f9c ($2.61 in chips)
Seat 2: 1da6e048 ($5.28 in chips)
Seat 3: adaf294f ($5.23 in chips)
Seat 4: a9317c54 ($6.01 in chips)
Seat 5: 4b982b0b ($6.69 in chips)
Seat 6: Hero ($10.7 in chips)
1da6e048: posts small blind $0.02
adaf294f: posts big blind $0.05
*** HOLE CARDS ***
Dealt to 5f149f9c 
Dealt to 1da6e048 
Dealt to adaf294f 
Dealt to a9317c54 
Dealt to 4b982b0b 
Dealt to Hero [3h 5s]
a9317c54: folds
4b982b0b: folds
Hero: folds
5f149f9c: raises $0.05 to $0.1
1da6e048: folds
adaf294f: folds
Uncalled bet ($0.05) returned to 5f149f9c
*** SHOWDOWN ***
5f149f9c collected $0.12 from pot
*** SUMMARY ***
Total pot $0.12 | Rake $0 | Jackpot $0 | Bingo $0 | Fortune $0 | Tax $0
Seat 1: 5f149f9c (button) collected ($0.12)
Seat 2: 1da6e048 (small blind) folded before Flop
Seat 3: adaf294f (big blind) folded before Flop
Seat 4: a9317c54 folded before Flop (didn't bet)
Seat 5: 4b982b0b folded before Flop (didn't bet)
Seat 6: Hero folded before Flop (didn't bet)


Poker Hand #RC3794755491: Hold'em No Limit ($0.02/$0.05) - 2025/08/09 21:01:56
Table 'RushAndCash10840751' 6-max Seat #1 is the button
Seat 1: Hero ($10.8 in chips)
Seat 2: 76d3c749 ($5.82 in chips)
Seat 3: 17f014c8 ($5.49 in chips)
Seat 4: 5f149f9c ($2.45 in chips)
Seat 5: a4bc81df ($5.17 in chips)
Seat 6: daa7003b ($9.68 in chips)
76d3c749: posts small blind $0.02
17f014c8: posts big blind $0.05
*** HOLE CARDS ***
Dealt to Hero [Jd Kd]
Dealt to 76d3c749 
Dealt to 17f014c8 
Dealt to 5f149f9c 
Dealt to a4bc81df 
Dealt to daa7003b 
5f149f9c: raises $0.05 to $0.1
a4bc81df: folds
daa7003b: folds
Hero: calls $0.1
76d3c749: folds
17f014c8: folds
*** FLOP *** [7s 9s Tc]
5f149f9c: bets $0.09
Hero: folds
Uncalled bet ($0.09) returned to 5f149f9c
*** SHOWDOWN ***
5f149f9c collected $0.26 from pot
*** SUMMARY ***
Total pot $0.27 | Rake $0.01 | Jackpot $0 | Bingo $0 | Fortune $0 | Tax $0
Board [7s 9s Tc]
Seat 1: Hero (button) folded on the Flop
Seat 2: 76d3c749 (small blind) folded before Flop
Seat 3: 17f014c8 (big blind) folded before Flop
Seat 4: 5f149f9c won ($0.26)
Seat 5: a4bc81df folded before Flop (didn't bet)
Seat 6: daa7003b folded before Flop (didn't bet)


Poker Hand #RC3794755412: Hold'em No Limit ($0.02/$0.05) - 2025/08/09 21:01:44
Table 'RushAndCash10840672' 6-max Seat #1 is the button
Seat 1: e564c3bc ($4.68 in chips)
Seat 2: Hero ($10.82 in chips)
Seat 3: db8dcbc3 ($6.01 in chips)
Seat 4: 581b7f56 ($6.52 in chips)
Seat 5: a3b36115 ($1.68 in chips)
Seat 6: 7dcb94f4 ($4.88 in chips)
Hero: posts small blind $0.02
db8dcbc3: posts big blind $0.05
*** HOLE CARDS ***
Dealt to e564c3bc 
Dealt to Hero [Jh 9s]
Dealt to db8dcbc3 
Dealt to 581b7f56 
Dealt to a3b36115 
Dealt to 7dcb94f4 
581b7f56: folds
a3b36115: folds
7dcb94f4: folds
e564c3bc: raises $0.08 to $0.13
Hero: folds
db8dcbc3: calls $0.08
*** FLOP *** [9c 4s 8c]
db8dcbc3: checks
e564c3bc: bets $0.14
db8dcbc3: calls $0.14
*** TURN *** [9c 4s 8c] [Kc]
db8dcbc3: checks
e564c3bc: checks
*** RIVER *** [9c 4s 8c Kc] [Ks]
db8dcbc3: checks
e564c3bc: checks
db8dcbc3: shows [Jc Td] (a pair of Kings)
e564c3bc: shows [7h 4h] (two pair, Kings and Fours)
*** SHOWDOWN ***
e564c3bc collected $0.54 from pot
*** SUMMARY ***
Total pot $0.56 | Rake $0.02 | Jackpot $0 | Bingo $0 | Fortune $0 | Tax $0
Board [9c 4s 8c Kc Ks]
Seat 1: e564c3bc (button) showed [7h 4h] and won ($0.54) with two pair, Kings and Fours
Seat 2: Hero (small blind) folded before Flop
Seat 3: db8dcbc3 (big blind) showed [Jc Td] and lost with a pair of Kings
Seat 4: 581b7f56 folded before Flop (didn't bet)
Seat 5: a3b36115 folded before Flop (didn't bet)
Seat 6: 7dcb94f4 folded before Flop (didn't bet)


Poker Hand #RC3794755346: Hold'em No Limit ($0.02/$0.05) - 2025/08/09 21:01:33
Table 'RushAndCash10840606' 6-max Seat #1 is the button
Seat 1: 621b675e ($6.63 in chips)
Seat 2: 7dcb94f4 ($4.9 in chips)
Seat 3: Hero ($10.8 in chips)
Seat 4: f9619147 ($10.8 in chips)
Seat 5: ae99fc2a ($8.56 in chips)
Seat 6: c67feaf5 ($4.03 in chips)
7dcb94f4: posts small blind $0.02
Hero: posts big blind $0.05
*** HOLE CARDS ***
Dealt to 621b675e 
Dealt to 7dcb94f4 
Dealt to Hero [8s Ah]
Dealt to f9619147 
Dealt to ae99fc2a 
Dealt to c67feaf5 
f9619147: folds
ae99fc2a: folds
c67feaf5: folds
621b675e: folds
7dcb94f4: folds
Uncalled bet ($0.03) returned to Hero
*** SHOWDOWN ***
Hero collected $0.04 from pot
*** SUMMARY ***
Total pot $0.04 | Rake $0 | Jackpot $0 | Bingo $0 | Fortune $0 | Tax $0
Seat 1: 621b675e (button) folded before Flop (didn't bet)
Seat 2: 7dcb94f4 (small blind) folded before Flop
Seat 3: Hero (big blind) collected ($0.04)
Seat 4: f9619147 folded before Flop (didn't bet)
Seat 5: ae99fc2a folded before Flop (didn't bet)
Seat 6: c67feaf5 folded before Flop (didn't bet)


Poker Hand #RC3794755088: Hold'em No Limit ($0.02/$0.05) - 2025/08/09 21:00:50
Table 'RushAndCash10840348' 6-max Seat #1 is the button
Seat 1: f8f4c659 ($10.77 in chips)
Seat 2: dfdf8b4b ($5.71 in chips)
Seat 3: 7dcb94f4 ($5 in chips)
Seat 4: Hero ($10.69 in chips)
Seat 5: d6ff1e7 ($1.26 in chips)
Seat 6: ad489162 ($7.54 in chips)
dfdf8b4b: posts small blind $0.02
7dcb94f4: posts big blind $0.05
*** HOLE CARDS ***
Dealt to f8f4c659 
Dealt to dfdf8b4b 
Dealt to 7dcb94f4 
Dealt to Hero [Qd Ah]
Dealt to d6ff1e7 
Dealt to ad489162 
Hero: raises $0.05 to $0.1
d6ff1e7: folds
ad489162: folds
f8f4c659: folds
dfdf8b4b: folds
7dcb94f4: calls $0.05
*** FLOP *** [9d Ad 4h]
7dcb94f4: checks
Hero: bets $0.12
7dcb94f4: folds
Uncalled bet ($0.12) returned to Hero
*** SHOWDOWN ***
Hero collected $0.21 from pot
*** SUMMARY ***
Total pot $0.22 | Rake $0.01 | Jackpot $0 | Bingo $0 | Fortune $0 | Tax $0
Board [9d Ad 4h]
Seat 1: f8f4c659 (button) folded before Flop (didn't bet)
Seat 2: dfdf8b4b (small blind) folded before Flop
Seat 3: 7dcb94f4 (big blind) folded on the Flop
Seat 4: Hero won ($0.21)
Seat 5: d6ff1e7 folded before Flop (didn't bet)
Seat 6: ad489162 folded before Flop (didn't bet)


Poker Hand #RC3794755058: Hold'em No Limit ($0.02/$0.05) - 2025/08/09 21:00:45
Table 'RushAndCash10840318' 6-max Seat #1 is the button
Seat 1: 581b7f56 ($5.56 in chips)
Seat 2: b65742ec ($8.14 in chips)
Seat 3: 3f63937d ($11.56 in chips)
Seat 4: e3af0157 ($5 in chips)
Seat 5: Hero ($10.69 in chips)
Seat 6: 92c1cc9 ($4.28 in chips)
b65742ec: posts small blind $0.02
3f63937d: posts big blind $0.05
*** HOLE CARDS ***
Dealt to 581b7f56 
Dealt to b65742ec 
Dealt to 3f63937d 
Dealt to e3af0157 
Dealt to Hero [As 6h]
Dealt to 92c1cc9 
e3af0157: raises $0.05 to $0.1
Hero: folds
92c1cc9: calls $0.1
581b7f56: folds
b65742ec: folds
3f63937d: folds
*** FLOP *** [2d 8s 9s]
e3af0157: bets $0.21
92c1cc9: folds
Uncalled bet ($0.21) returned to e3af0157
*** SHOWDOWN ***
e3af0157 collected $0.26 from pot
*** SUMMARY ***
Total pot $0.27 | Rake $0.01 | Jackpot $0 | Bingo $0 | Fortune $0 | Tax $0
Board [2d 8s 9s]
Seat 1: 581b7f56 (button) folded before Flop (didn't bet)
Seat 2: b65742ec (small blind) folded before Flop
Seat 3: 3f63937d (big blind) folded before Flop
Seat 4: e3af0157 won ($0.26)
Seat 5: Hero folded before Flop (didn't bet)
Seat 6: 92c1cc9 folded on the Flop


Poker Hand #RC3794754945: Hold'em No Limit ($0.02/$0.05) - 2025/08/09 21:00:28
Table 'RushAndCash10840205' 6-max Seat #1 is the button
Seat 1: a51ccf3b ($5.64 in chips)
Seat 2: Hero ($10.61 in chips)
Seat 3: 8ab5b1be ($5 in chips)
Seat 4: e1e6a6ec ($12.08 in chips)
Seat 5: fe394ca4 ($11.07 in chips)
Seat 6: 3db5d065 ($5.32 in chips)
Hero: posts small blind $0.02
8ab5b1be: posts big blind $0.05
*** HOLE CARDS ***
Dealt to a51ccf3b 
Dealt to Hero [7h Qc]
Dealt to 8ab5b1be 
Dealt to e1e6a6ec 
Dealt to fe394ca4 
Dealt to 3db5d065 
e1e6a6ec: folds
fe394ca4: folds
3db5d065: raises $0.05 to $0.1
a51ccf3b: folds
Hero: folds
8ab5b1be: folds
Uncalled bet ($0.05) returned to 3db5d065
*** SHOWDOWN ***
3db5d065 collected $0.12 from pot
*** SUMMARY ***
Total pot $0.12 | Rake $0 | Jackpot $0 | Bingo $0 | Fortune $0 | Tax $0
Seat 1: a51ccf3b (button) folded before Flop (didn't bet)
Seat 2: Hero (small blind) folded before Flop
Seat 3: 8ab5b1be (big blind) folded before Flop
Seat 4: e1e6a6ec folded before Flop (didn't bet)
Seat 5: fe394ca4 folded before Flop (didn't bet)
Seat 6: 3db5d065 collected ($0.12)


Poker Hand #RC3794754887: Hold'em No Limit ($0.02/$0.05) - 2025/08/09 21:00:19
Table 'RushAndCash10840147' 6-max Seat #1 is the button
Seat 1: 55786b04 ($8.92 in chips)
Seat 2: e3c47470 ($8.66 in chips)
Seat 3: Hero ($10.66 in chips)
Seat 4: c7314dc8 ($6.15 in chips)
Seat 5: 82d96bf0 ($10.71 in chips)
Seat 6: fdb28128 ($5 in chips)
e3c47470: posts small blind $0.02
Hero: posts big blind $0.05
*** HOLE CARDS ***
Dealt to 55786b04 
Dealt to e3c47470 
Dealt to Hero [2s Qh]
Dealt to c7314dc8 
Dealt to 82d96bf0 
Dealt to fdb28128 
c7314dc8: folds
82d96bf0: folds
fdb28128: folds
55786b04: folds
e3c47470: calls $0.03
Hero: checks
*** FLOP *** [Ks Kd Th]
e3c47470: checks
Hero: checks
*** TURN *** [Ks Kd Th] [Qd]
e3c47470: checks
Hero: checks
*** RIVER *** [Ks Kd Th Qd] [8h]
e3c47470: checks
Hero: checks
e3c47470: shows [7c 9s] (a pair of Kings)
Hero: shows [2s Qh] (two pair, Kings and Queens)
*** SHOWDOWN ***
Hero collected $0.1 from pot
*** SUMMARY ***
Total pot $0.1 | Rake $0 | Jackpot $0 | Bingo $0 | Fortune $0 | Tax $0
Board [Ks Kd Th Qd 8h]
Seat 1: 55786b04 (button) folded before Flop (didn't bet)
Seat 2: e3c47470 (small blind) showed [7c 9s] and lost with a pair of Kings
Seat 3: Hero (big blind) showed [2s Qh] and won ($0.1) with two pair, Kings and Queens
Seat 4: c7314dc8 folded before Flop (didn't bet)
Seat 5: 82d96bf0 folded before Flop (didn't bet)
Seat 6: fdb28128 folded before Flop (didn't bet)


Poker Hand #RC3794754854: Hold'em No Limit ($0.02/$0.05) - 2025/08/09 21:00:15
Table 'RushAndCash10840114' 6-max Seat #1 is the button
Seat 1: 862bbf4 ($5.15 in chips)
Seat 2: 948e0192 ($5.04 in chips)
Seat 3: 16faa775 ($7.18 in chips)
Seat 4: 593ead4c ($5 in chips)
Seat 5: Hero ($10.66 in chips)
Seat 6: dc07b7f7 ($9.26 in chips)
948e0192: posts small blind $0.02
16faa775: posts big blind $0.05
*** HOLE CARDS ***
Dealt to 862bbf4 
Dealt to 948e0192 
Dealt to 16faa775 
Dealt to 593ead4c 
Dealt to Hero [4c 3c]
Dealt to dc07b7f7 
593ead4c: folds
Hero: folds
dc07b7f7: folds
862bbf4: folds
948e0192: raises $0.05 to $0.1
16faa775: folds
Uncalled bet ($0.05) returned to 948e0192
*** SHOWDOWN ***
948e0192 collected $0.1 from pot
*** SUMMARY ***
Total pot $0.1 | Rake $0 | Jackpot $0 | Bingo $0 | Fortune $0 | Tax $0
Seat 1: 862bbf4 (button) folded before Flop (didn't bet)
Seat 2: 948e0192 (small blind) collected ($0.1)
Seat 3: 16faa775 (big blind) folded before Flop
Seat 4: 593ead4c folded before Flop (didn't bet)
Seat 5: Hero folded before Flop (didn't bet)
Seat 6: dc07b7f7 folded before Flop (didn't bet)


Poker Hand #RC3794754820: Hold'em No Limit ($0.02/$0.05) - 2025/08/09 21:00:10
Table 'RushAndCash10840080' 6-max Seat #1 is the button
Seat 1: 6d40d9cd ($5.28 in chips)
Seat 2: 600131d5 ($5.23 in chips)
Seat 3: d6ff1e7 ($1.8 in chips)
Seat 4: 60d1140d ($7.78 in chips)
Seat 5: fab43016 ($5 in chips)
Seat 6: Hero ($10.66 in chips)
600131d5: posts small blind $0.02
d6ff1e7: posts big blind $0.05
*** HOLE CARDS ***
Dealt to 6d40d9cd 
Dealt to 600131d5 
Dealt to d6ff1e7 
Dealt to 60d1140d 
Dealt to fab43016 
Dealt to Hero [8c 3s]
60d1140d: folds
fab43016: folds
Hero: folds
6d40d9cd: folds
600131d5: calls $0.03
d6ff1e7: checks
*** FLOP *** [2d 2c 4c]
600131d5: bets $0.05
d6ff1e7: folds
Uncalled bet ($0.05) returned to 600131d5
*** SHOWDOWN ***
600131d5 collected $0.1 from pot
*** SUMMARY ***
Total pot $0.1 | Rake $0 | Jackpot $0 | Bingo $0 | Fortune $0 | Tax $0
Board [2d 2c 4c]
Seat 1: 6d40d9cd (button) folded before Flop (didn't bet)
Seat 2: 600131d5 (small blind) won ($0.1)
Seat 3: d6ff1e7 (big blind) folded on the Flop
Seat 4: 60d1140d folded before Flop (didn't bet)
Seat 5: fab43016 folded before Flop (didn't bet)
Seat 6: Hero folded before Flop (didn't bet)


Poker Hand #RC3794754783: Hold'em No Limit ($0.02/$0.05) - 2025/08/09 21:00:04
Table 'RushAndCash10840043' 6-max Seat #1 is the button
Seat 1: 2642a224 ($10.72 in chips)
Seat 2: f46fb824 ($4.18 in chips)
Seat 3: 79ca254c ($6.59 in chips)
Seat 4: a9c3a5c6 ($5.41 in chips)
Seat 5: c755210d ($5.87 in chips)
Seat 6: Hero ($10.66 in chips)
f46fb824: posts small blind $0.02
79ca254c: posts big blind $0.05
*** HOLE CARDS ***
Dealt to 2642a224 
Dealt to f46fb824 
Dealt to 79ca254c 
Dealt to a9c3a5c6 
Dealt to c755210d 
Dealt to Hero [Kh 9c]
a9c3a5c6: folds
c755210d: folds
Hero: folds
2642a224: folds
f46fb824: calls $0.03
79ca254c: raises $0.08 to $0.13
f46fb824: calls $0.08
*** FLOP *** [Ks 2h Ac]
f46fb824: checks
79ca254c: bets $0.06
f46fb824: calls $0.06
*** TURN *** [Ks 2h Ac] [8d]
f46fb824: checks
79ca254c: bets $0.14
f46fb824: folds
Uncalled bet ($0.14) returned to 79ca254c
*** SHOWDOWN ***
79ca254c collected $0.37 from pot
*** SUMMARY ***
Total pot $0.38 | Rake $0.01 | Jackpot $0 | Bingo $0 | Fortune $0 | Tax $0
Board [Ks 2h Ac 8d]
Seat 1: 2642a224 (button) folded before Flop (didn't bet)
Seat 2: f46fb824 (small blind) folded on the Turn
Seat 3: 79ca254c (big blind) won ($0.37)
Seat 4: a9c3a5c6 folded before Flop (didn't bet)
Seat 5: c755210d folded before Flop (didn't bet)
Seat 6: Hero folded before Flop (didn't bet)


Poker Hand #RC3794714721: Hold'em No Limit ($0.02/$0.05) - 2025/08/09 20:59:55
Table 'RushAndCash10839981' 6-max Seat #1 is the button
Seat 1: Hero ($10.66 in chips)
Seat 2: f60f362e ($4.54 in chips)
Seat 3: 6aa1d0de ($6.94 in chips)
Seat 4: 92c1cc9 ($4.3 in chips)
Seat 5: 669053fa ($5.15 in chips)
Seat 6: 9c76ea84 ($7.35 in chips)
f60f362e: posts small blind $0.02
6aa1d0de: posts big blind $0.05
*** HOLE CARDS ***
Dealt to Hero [7h Ts]
Dealt to f60f362e 
Dealt to 6aa1d0de 
Dealt to 92c1cc9 
Dealt to 669053fa 
Dealt to 9c76ea84 
92c1cc9: folds
669053fa: raises $0.05 to $0.1
9c76ea84: folds
Hero: folds
f60f362e: folds
6aa1d0de: folds
Uncalled bet ($0.05) returned to 669053fa
*** SHOWDOWN ***
669053fa collected $0.12 from pot
*** SUMMARY ***
Total pot $0.12 | Rake $0 | Jackpot $0 | Bingo $0 | Fortune $0 | Tax $0
Seat 1: Hero (button) folded before Flop (didn't bet)
Seat 2: f60f362e (small blind) folded before Flop
Seat 3: 6aa1d0de (big blind) folded before Flop
Seat 4: 92c1cc9 folded before Flop (didn't bet)
Seat 5: 669053fa collected ($0.12)
Seat 6: 9c76ea84 folded before Flop (didn't bet)


Poker Hand #RC3794714697: Hold'em No Limit ($0.02/$0.05) - 2025/08/09 20:59:52
Table 'RushAndCash10839957' 6-max Seat #1 is the button
Seat 1: 85e116cf ($2.64 in chips)
Seat 2: 5760b980 ($5.45 in chips)
Seat 3: ab0f9e83 ($11.04 in chips)
Seat 4: 3c9f1b9d ($8.26 in chips)
Seat 5: e9f9f5d7 ($5.23 in chips)
Seat 6: Hero ($10.66 in chips)
5760b980: posts small blind $0.02
ab0f9e83: posts big blind $0.05
*** HOLE CARDS ***
Dealt to 85e116cf 
Dealt to 5760b980 
Dealt to ab0f9e83 
Dealt to 3c9f1b9d 
Dealt to e9f9f5d7 
Dealt to Hero [Kd 3c]
3c9f1b9d: folds
e9f9f5d7: folds
Hero: folds
85e116cf: raises $0.1 to $0.15
5760b980: folds
ab0f9e83: calls $0.1
*** FLOP *** [2d 9s Ah]
ab0f9e83: checks
85e116cf: bets $0.1
ab0f9e83: calls $0.1
*** TURN *** [2d 9s Ah] [7d]
ab0f9e83: checks
85e116cf: bets $0.25
ab0f9e83: folds
Uncalled bet ($0.25) returned to 85e116cf
*** SHOWDOWN ***
85e116cf collected $0.5 from pot
*** SUMMARY ***
Total pot $0.52 | Rake $0.02 | Jackpot $0 | Bingo $0 | Fortune $0 | Tax $0
Board [2d 9s Ah 7d]
Seat 1: 85e116cf (button) won ($0.5)
Seat 2: 5760b980 (small blind) folded before Flop
Seat 3: ab0f9e83 (big blind) folded on the Turn
Seat 4: 3c9f1b9d folded before Flop (didn't bet)
Seat 5: e9f9f5d7 folded before Flop (didn't bet)
Seat 6: Hero folded before Flop (didn't bet)


Poker Hand #RC3794714644: Hold'em No Limit ($0.02/$0.05) - 2025/08/09 20:59:44
Table 'RushAndCash10839904' 6-max Seat #1 is the button
Seat 1: Hero ($10.66 in chips)
Seat 2: 395cc012 ($5 in chips)
Seat 3: c67feaf5 ($2.23 in chips)
Seat 4: ebbf4b8e ($4.3 in chips)
Seat 5: 216d3aab ($5.96 in chips)
Seat 6: e608b61d ($5.42 in chips)
395cc012: posts small blind $0.02
c67feaf5: posts big blind $0.05
*** HOLE CARDS ***
Dealt to Hero [8h As]
Dealt to 395cc012 
Dealt to c67feaf5 
Dealt to ebbf4b8e 
Dealt to 216d3aab 
Dealt to e608b61d 
ebbf4b8e: raises $0.1 to $0.15
216d3aab: folds
e608b61d: folds
Hero: folds
395cc012: folds
c67feaf5: folds
Uncalled bet ($0.1) returned to ebbf4b8e
*** SHOWDOWN ***
ebbf4b8e collected $0.12 from pot
*** SUMMARY ***
Total pot $0.12 | Rake $0 | Jackpot $0 | Bingo $0 | Fortune $0 | Tax $0
Seat 1: Hero (button) folded before Flop (didn't bet)
Seat 2: 395cc012 (small blind) folded before Flop
Seat 3: c67feaf5 (big blind) folded before Flop
Seat 4: ebbf4b8e collected ($0.12)
Seat 5: 216d3aab folded before Flop (didn't bet)
Seat 6: e608b61d folded before Flop (didn't bet)


Poker Hand #RC3794714425: Hold'em No Limit ($0.02/$0.05) - 2025/08/09 20:59:09
Table 'RushAndCash10839685' 6-max Seat #1 is the button
Seat 1: 4e7b88c1 ($6.84 in chips)
Seat 2: 216d3aab ($6.11 in chips)
Seat 3: Hero ($10.52 in chips)
Seat 4: 68e76e87 ($5 in chips)
Seat 5: 41626ac4 ($5 in chips)
Seat 6: dec49550 ($4.59 in chips)
216d3aab: posts small blind $0.02
Hero: posts big blind $0.05
*** HOLE CARDS ***
Dealt to 4e7b88c1 
Dealt to 216d3aab 
Dealt to Hero [5h 2h]
Dealt to 68e76e87 
Dealt to 41626ac4 
Dealt to dec49550 
68e76e87: folds
41626ac4: folds
dec49550: folds
4e7b88c1: folds
216d3aab: raises $0.1 to $0.15
Hero: calls $0.1
*** FLOP *** [9d 7c 3h]
216d3aab: checks
Hero: bets $0.24
216d3aab: folds
Uncalled bet ($0.24) returned to Hero
*** SHOWDOWN ***
Hero collected $0.29 from pot
*** SUMMARY ***
Total pot $0.3 | Rake $0.01 | Jackpot $0 | Bingo $0 | Fortune $0 | Tax $0
Board [9d 7c 3h]
Seat 1: 4e7b88c1 (button) folded before Flop (didn't bet)
Seat 2: 216d3aab (small blind) folded on the Flop
Seat 3: Hero (big blind) won ($0.29)
Seat 4: 68e76e87 folded before Flop (didn't bet)
Seat 5: 41626ac4 folded before Flop (didn't bet)
Seat 6: dec49550 folded before Flop (didn't bet)


Poker Hand #RC3794714193: Hold'em No Limit ($0.02/$0.05) - 2025/08/09 20:58:35
Table 'RushAndCash10839453' 6-max Seat #1 is the button
Seat 1: 4311c03 ($5.12 in chips)
Seat 2: 7348380d ($22.48 in chips)
Seat 3: 96e8c78e ($5.08 in chips)
Seat 4: 4d9bdcc ($12.41 in chips)
Seat 5: Hero ($10.31 in chips)
Seat 6: 3a7df0c7 ($3.51 in chips)
7348380d: posts small blind $0.02
96e8c78e: posts big blind $0.05
*** HOLE CARDS ***
Dealt to 4311c03 
Dealt to 7348380d 
Dealt to 96e8c78e 
Dealt to 4d9bdcc 
Dealt to Hero [Jd Qs]
Dealt to 3a7df0c7 
4d9bdcc: folds
Hero: raises $0.05 to $0.1
3a7df0c7: folds
4311c03: calls $0.1
7348380d: folds
96e8c78e: calls $0.05
*** FLOP *** [Qd Ts Kh]
96e8c78e: checks
Hero: bets $0.18
4311c03: folds
96e8c78e: folds
Uncalled bet ($0.18) returned to Hero
*** SHOWDOWN ***
Hero collected $0.31 from pot
*** SUMMARY ***
Total pot $0.32 | Rake $0.01 | Jackpot $0 | Bingo $0 | Fortune $0 | Tax $0
Board [Qd Ts Kh]
Seat 1: 4311c03 (button) folded on the Flop
Seat 2: 7348380d (small blind) folded before Flop
Seat 3: 96e8c78e (big blind) folded on the Flop
Seat 4: 4d9bdcc folded before Flop (didn't bet)
Seat 5: Hero won ($0.31)
Seat 6: 3a7df0c7 folded before Flop (didn't bet)


Poker Hand #RC3794713802: Hold'em No Limit ($0.02/$0.05) - 2025/08/09 20:57:31
Table 'RushAndCash10839062' 6-max Seat #1 is the button
Seat 1: 6ac5bc1b ($8.47 in chips)
Seat 2: Hero ($10.69 in chips)
Seat 3: a8ef2628 ($5 in chips)
Seat 4: d5fcbea8 ($5 in chips)
Seat 5: d80c74 ($3.21 in chips)
Seat 6: 3a7df0c7 ($3.12 in chips)
Hero: posts small blind $0.02
a8ef2628: posts big blind $0.05
*** HOLE CARDS ***
Dealt to 6ac5bc1b 
Dealt to Hero [6c 9c]
Dealt to a8ef2628 
Dealt to d5fcbea8 
Dealt to d80c74 
Dealt to 3a7df0c7 
d5fcbea8: folds
d80c74: folds
3a7df0c7: calls $0.05
6ac5bc1b: folds
Hero: raises $0.15 to $0.2
a8ef2628: folds
3a7df0c7: calls $0.15
*** FLOP *** [8d Ad 2h]
Hero: checks
3a7df0c7: checks
*** TURN *** [8d Ad 2h] [4h]
Hero: bets $0.18
3a7df0c7: raises $0.61 to $0.79
Hero: folds
Uncalled bet ($0.61) returned to 3a7df0c7
*** SHOWDOWN ***
3a7df0c7 collected $0.77 from pot
*** SUMMARY ***
Total pot $0.81 | Rake $0.04 | Jackpot $0 | Bingo $0 | Fortune $0 | Tax $0
Board [8d Ad 2h 4h]
Seat 1: 6ac5bc1b (button) folded before Flop (didn't bet)
Seat 2: Hero (small blind) folded on the Turn
Seat 3: a8ef2628 (big blind) folded before Flop
Seat 4: d5fcbea8 folded before Flop (didn't bet)
Seat 5: d80c74 folded before Flop (didn't bet)
Seat 6: 3a7df0c7 won ($0.77)


Poker Hand #RC3794713747: Hold'em No Limit ($0.02/$0.05) - 2025/08/09 20:57:23
Table 'RushAndCash10839007' 6-max Seat #1 is the button
Seat 1: 1da6e048 ($5.33 in chips)
Seat 2: 2f1c4fc0 ($4.29 in chips)
Seat 3: 55786b04 ($9.08 in chips)
Seat 4: Hero ($10.69 in chips)
Seat 5: dd2265ed ($5.4 in chips)
Seat 6: a863eb22 ($5.09 in chips)
2f1c4fc0: posts small blind $0.02
55786b04: posts big blind $0.05
*** HOLE CARDS ***
Dealt to 1da6e048 
Dealt to 2f1c4fc0 
Dealt to 55786b04 
Dealt to Hero [As Tc]
Dealt to dd2265ed 
Dealt to a863eb22 
Hero: folds
dd2265ed: raises $0.05 to $0.1
a863eb22: raises $0.27 to $0.37
1da6e048: folds
2f1c4fc0: folds
55786b04: folds
dd2265ed: folds
Uncalled bet ($0.27) returned to a863eb22
*** SHOWDOWN ***
a863eb22 collected $0.26 from pot
*** SUMMARY ***
Total pot $0.27 | Rake $0.01 | Jackpot $0 | Bingo $0 | Fortune $0 | Tax $0
Seat 1: 1da6e048 (button) folded before Flop (didn't bet)
Seat 2: 2f1c4fc0 (small blind) folded before Flop
Seat 3: 55786b04 (big blind) folded before Flop
Seat 4: Hero folded before Flop (didn't bet)
Seat 5: dd2265ed folded before Flop
Seat 6: a863eb22 collected ($0.26)


Poker Hand #RC3794713653: Hold'em No Limit ($0.02/$0.05) - 2025/08/09 20:57:08
Table 'RushAndCash10838913' 6-max Seat #1 is the button
Seat 1: Hero ($10.62 in chips)
Seat 2: fe394ca4 ($5.69 in chips)
Seat 3: 22636bd9 ($5.02 in chips)
Seat 4: 5d300516 ($6.23 in chips)
Seat 5: 7a2a9de7 ($3.12 in chips)
Seat 6: e7aeb0ef ($8.31 in chips)
fe394ca4: posts small blind $0.02
22636bd9: posts big blind $0.05
*** HOLE CARDS ***
Dealt to Hero [Kh Tc]
Dealt to fe394ca4 
Dealt to 22636bd9 
Dealt to 5d300516 
Dealt to 7a2a9de7 
Dealt to e7aeb0ef 
5d300516: folds
7a2a9de7: folds
e7aeb0ef: folds
Hero: raises $0.11 to $0.16
fe394ca4: folds
22636bd9: folds
Uncalled bet ($0.11) returned to Hero
*** SHOWDOWN ***
Hero collected $0.12 from pot
*** SUMMARY ***
Total pot $0.12 | Rake $0 | Jackpot $0 | Bingo $0 | Fortune $0 | Tax $0
Seat 1: Hero (button) collected ($0.12)
Seat 2: fe394ca4 (small blind) folded before Flop
Seat 3: 22636bd9 (big blind) folded before Flop
Seat 4: 5d300516 folded before Flop (didn't bet)
Seat 5: 7a2a9de7 folded before Flop (didn't bet)
Seat 6: e7aeb0ef folded before Flop (didn't bet)


Poker Hand #RC3794713367: Hold'em No Limit ($0.02/$0.05) - 2025/08/09 20:56:22
Table 'RushAndCash10838627' 6-max Seat #1 is the button
Seat 1: b6f2a657 ($5.05 in chips)
Seat 2: 4f713b7c ($7.03 in chips)
Seat 3: f4498877 ($4.99 in chips)
Seat 4: 636fc07b ($8.39 in chips)
Seat 5: 4bfc47ce ($7.48 in chips)
Seat 6: Hero ($10.33 in chips)
4f713b7c: posts small blind $0.02
f4498877: posts big blind $0.05
*** HOLE CARDS ***
Dealt to b6f2a657 
Dealt to 4f713b7c 
Dealt to f4498877 
Dealt to 636fc07b 
Dealt to 4bfc47ce 
Dealt to Hero [Ts As]
636fc07b: folds
4bfc47ce: raises $0.08 to $0.13
Hero: calls $0.13
b6f2a657: folds
4f713b7c: folds
f4498877: folds
*** FLOP *** [Tc 3s 3c]
4bfc47ce: bets $0.11
Hero: calls $0.11
*** TURN *** [Tc 3s 3c] [Kd]
4bfc47ce: checks
Hero: checks
*** RIVER *** [Tc 3s 3c Kd] [2c]
4bfc47ce: checks
Hero: checks
4bfc47ce: shows [Qs Ac] (a pair of Threes)
Hero: shows [Ts As] (two pair, Tens and Threes)
*** SHOWDOWN ***
Hero collected $0.53 from pot
*** SUMMARY ***
Total pot $0.55 | Rake $0.02 | Jackpot $0 | Bingo $0 | Fortune $0 | Tax $0
Board [Tc 3s 3c Kd 2c]
Seat 1: b6f2a657 (button) folded before Flop (didn't bet)
Seat 2: 4f713b7c (small blind) folded before Flop
Seat 3: f4498877 (big blind) folded before Flop
Seat 4: 636fc07b folded before Flop (didn't bet)
Seat 5: 4bfc47ce showed [Qs Ac] and lost with a pair of Threes
Seat 6: Hero showed [Ts As] and won ($0.53) with two pair, Tens and Threes


Poker Hand #RC3794713289: Hold'em No Limit ($0.02/$0.05) - 2025/08/09 20:56:09
Table 'RushAndCash10838549' 6-max Seat #1 is the button
Seat 1: 820e762 ($5.02 in chips)
Seat 2: 22636bd9 ($5.11 in chips)
Seat 3: Hero ($10.31 in chips)
Seat 4: 21a5e321 ($5 in chips)
Seat 5: 7be8f7d0 ($3.37 in chips)
Seat 6: ada030ad ($7.72 in chips)
22636bd9: posts small blind $0.02
Hero: posts big blind $0.05
*** HOLE CARDS ***
Dealt to 820e762 
Dealt to 22636bd9 
Dealt to Hero [9d 6h]
Dealt to 21a5e321 
Dealt to 7be8f7d0 
Dealt to ada030ad 
21a5e321: folds
7be8f7d0: folds
ada030ad: folds
820e762: folds
22636bd9: folds
Uncalled bet ($0.03) returned to Hero
*** SHOWDOWN ***
Hero collected $0.04 from pot
*** SUMMARY ***
Total pot $0.04 | Rake $0 | Jackpot $0 | Bingo $0 | Fortune $0 | Tax $0
Seat 1: 820e762 (button) folded before Flop (didn't bet)
Seat 2: 22636bd9 (small blind) folded before Flop
Seat 3: Hero (big blind) collected ($0.04)
Seat 4: 21a5e321 folded before Flop (didn't bet)
Seat 5: 7be8f7d0 folded before Flop (didn't bet)
Seat 6: ada030ad folded before Flop (didn't bet)


Poker Hand #RC3794713256: Hold'em No Limit ($0.02/$0.05) - 2025/08/09 20:56:03
Table 'RushAndCash10838516' 6-max Seat #1 is the button
Seat 1: 88503d9 ($5.64 in chips)
Seat 2: Hero ($10.33 in chips)
Seat 3: 64b4c970 ($4.19 in chips)
Seat 4: f26aeb53 ($5.28 in chips)
Seat 5: 86e90fab ($6.89 in chips)
Seat 6: 794a5631 ($44.37 in chips)
Hero: posts small blind $0.02
64b4c970: posts big blind $0.05
*** HOLE CARDS ***
Dealt to 88503d9 
Dealt to Hero [2c 7s]
Dealt to 64b4c970 
Dealt to f26aeb53 
Dealt to 86e90fab 
Dealt to 794a5631 
f26aeb53: folds
86e90fab: folds
794a5631: folds
88503d9: folds
Hero: folds
Uncalled bet ($0.03) returned to 64b4c970
*** SHOWDOWN ***
64b4c970 collected $0.04 from pot
*** SUMMARY ***
Total pot $0.04 | Rake $0 | Jackpot $0 | Bingo $0 | Fortune $0 | Tax $0
Seat 1: 88503d9 (button) folded before Flop (didn't bet)
Seat 2: Hero (small blind) folded before Flop
Seat 3: 64b4c970 (big blind) collected ($0.04)
Seat 4: f26aeb53 folded before Flop (didn't bet)
Seat 5: 86e90fab folded before Flop (didn't bet)
Seat 6: 794a5631 folded before Flop (didn't bet)


Poker Hand #RC3794713232: Hold'em No Limit ($0.02/$0.05) - 2025/08/09 20:55:59
Table 'RushAndCash10838492' 6-max Seat #1 is the button
Seat 1: 133f34ec ($7.24 in chips)
Seat 2: 59e8c082 ($12.88 in chips)
Seat 3: 6297aa54 ($7.17 in chips)
Seat 4: 43ae5181 ($5 in chips)
Seat 5: Hero ($10.33 in chips)
Seat 6: 7f70eadd ($11.36 in chips)
59e8c082: posts small blind $0.02
6297aa54: posts big blind $0.05
*** HOLE CARDS ***
Dealt to 133f34ec 
Dealt to 59e8c082 
Dealt to 6297aa54 
Dealt to 43ae5181 
Dealt to Hero [8s 2c]
Dealt to 7f70eadd 
43ae5181: raises $0.05 to $0.1
Hero: folds
7f70eadd: raises $0.07 to $0.17
133f34ec: folds
59e8c082: folds
6297aa54: raises $0.43 to $0.6
43ae5181: calls $0.5
7f70eadd: folds
*** FLOP *** [5d 5c 3h]
6297aa54: bets $0.6
43ae5181: calls $0.6
*** TURN *** [5d 5c 3h] [7h]
6297aa54: bets $0.86
43ae5181: folds
Uncalled bet ($0.86) returned to 6297aa54
*** SHOWDOWN ***
6297aa54 collected $2.4 from pot
*** SUMMARY ***
Total pot $2.59 | Rake $0.12 | Jackpot $0.07 | Bingo $0 | Fortune $0 | Tax $0
Board [5d 5c 3h 7h]
Seat 1: 133f34ec (button) folded before Flop (didn't bet)
Seat 2: 59e8c082 (small blind) folded before Flop
Seat 3: 6297aa54 (big blind) won ($2.4)
Seat 4: 43ae5181 folded on the Turn
Seat 5: Hero folded before Flop (didn't bet)
Seat 6: 7f70eadd folded before Flop


Poker Hand #RC3794713181: Hold'em No Limit ($0.02/$0.05) - 2025/08/09 20:55:50
Table 'RushAndCash10838441' 6-max Seat #1 is the button
Seat 1: Hero ($10.33 in chips)
Seat 2: 198ddfd4 ($9.86 in chips)
Seat 3: ff990240 ($5.07 in chips)
Seat 4: 21a5e321 ($5 in chips)
Seat 5: 6aa1d0de ($7.02 in chips)
Seat 6: 395cc012 ($5 in chips)
198ddfd4: posts small blind $0.02
ff990240: posts big blind $0.05
*** HOLE CARDS ***
Dealt to Hero [6s 5c]
Dealt to 198ddfd4 
Dealt to ff990240 
Dealt to 21a5e321 
Dealt to 6aa1d0de 
Dealt to 395cc012 
21a5e321: folds
6aa1d0de: folds
395cc012: folds
Hero: folds
198ddfd4: raises $0.1 to $0.15
ff990240: calls $0.1
*** FLOP *** [Kc Th 2d]
198ddfd4: bets $0.15
ff990240: folds
Uncalled bet ($0.15) returned to 198ddfd4
*** SHOWDOWN ***
198ddfd4 collected $0.29 from pot
*** SUMMARY ***
Total pot $0.3 | Rake $0.01 | Jackpot $0 | Bingo $0 | Fortune $0 | Tax $0
Board [Kc Th 2d]
Seat 1: Hero (button) folded before Flop (didn't bet)
Seat 2: 198ddfd4 (small blind) won ($0.29)
Seat 3: ff990240 (big blind) folded on the Flop
Seat 4: 21a5e321 folded before Flop (didn't bet)
Seat 5: 6aa1d0de folded before Flop (didn't bet)
Seat 6: 395cc012 folded before Flop (didn't bet)


Poker Hand #RC3794713082: Hold'em No Limit ($0.02/$0.05) - 2025/08/09 20:55:33
Table 'RushAndCash10838342' 6-max Seat #1 is the button
Seat 1: c2d4a614 ($5 in chips)
Seat 2: 2353d87c ($11.28 in chips)
Seat 3: bfa35251 ($5 in chips)
Seat 4: 151c57c8 ($5.16 in chips)
Seat 5: 6297aa54 ($7.19 in chips)
Seat 6: Hero ($10.33 in chips)
2353d87c: posts small blind $0.02
bfa35251: posts big blind $0.05
*** HOLE CARDS ***
Dealt to c2d4a614 
Dealt to 2353d87c 
Dealt to bfa35251 
Dealt to 151c57c8 
Dealt to 6297aa54 
Dealt to Hero [Ah Js]
151c57c8: raises $0.05 to $0.1
6297aa54: folds
Hero: folds
c2d4a614: folds
2353d87c: folds
bfa35251: raises $0.17 to $0.27
151c57c8: calls $0.17
*** FLOP *** [Jc 4d 2d]
bfa35251: bets $0.42
151c57c8: raises $0.7 to $1.12
bfa35251: calls $0.7
*** TURN *** [Jc 4d 2d] [3c]
bfa35251: checks
151c57c8: bets $2.1
bfa35251: folds
Uncalled bet ($2.1) returned to 151c57c8
*** SHOWDOWN ***
151c57c8 collected $2.6 from pot
*** SUMMARY ***
Total pot $2.8 | Rake $0.13 | Jackpot $0.07 | Bingo $0 | Fortune $0 | Tax $0
Board [Jc 4d 2d 3c]
Seat 1: c2d4a614 (button) folded before Flop (didn't bet)
Seat 2: 2353d87c (small blind) folded before Flop
Seat 3: bfa35251 (big blind) folded on the Turn
Seat 4: 151c57c8 won ($2.6)
Seat 5: 6297aa54 folded before Flop (didn't bet)
Seat 6: Hero folded before Flop (didn't bet)


Poker Hand #RC3794713006: Hold'em No Limit ($0.02/$0.05) - 2025/08/09 20:55:21
Table 'RushAndCash10838266' 6-max Seat #1 is the button
Seat 1: cae2dc9e ($5.41 in chips)
Seat 2: Hero ($10.28 in chips)
Seat 3: 25fc7652 ($8.88 in chips)
Seat 4: 7f82334f ($6.2 in chips)
Seat 5: ab008761 ($9.05 in chips)
Seat 6: ec1c1e0b ($10.32 in chips)
Hero: posts small blind $0.02
25fc7652: posts big blind $0.05
*** HOLE CARDS ***
Dealt to cae2dc9e 
Dealt to Hero [6d 5d]
Dealt to 25fc7652 
Dealt to 7f82334f 
Dealt to ab008761 
Dealt to ec1c1e0b 
7f82334f: raises $0.05 to $0.1
ab008761: folds
ec1c1e0b: folds
cae2dc9e: folds
Hero: folds
25fc7652: calls $0.05
*** FLOP *** [Qs Qd 8c]
25fc7652: checks
7f82334f: bets $0.08
25fc7652: calls $0.08
*** TURN *** [Qs Qd 8c] [9h]
25fc7652: checks
7f82334f: bets $0.29
25fc7652: calls $0.29
*** RIVER *** [Qs Qd 8c 9h] [2h]
25fc7652: bets $0.96
7f82334f: calls $0.96
25fc7652: shows [7c 5c] (a pair of Queens)
7f82334f: shows [Ah 8h] (two pair, Queens and Eights)
*** SHOWDOWN ***
7f82334f collected $2.67 from pot
*** SUMMARY ***
Total pot $2.88 | Rake $0.14 | Jackpot $0.07 | Bingo $0 | Fortune $0 | Tax $0
Board [Qs Qd 8c 9h 2h]
Seat 1: cae2dc9e (button) folded before Flop (didn't bet)
Seat 2: Hero (small blind) folded before Flop
Seat 3: 25fc7652 (big blind) showed [7c 5c] and lost with a pair of Queens
Seat 4: 7f82334f showed [Ah 8h] and won ($2.67) with two pair, Queens and Eights
Seat 5: ab008761 folded before Flop (didn't bet)
Seat 6: ec1c1e0b folded before Flop (didn't bet)


Poker Hand #RC3794712983: Hold'em No Limit ($0.02/$0.05) - 2025/08/09 20:55:18
Table 'RushAndCash10838243' 6-max Seat #1 is the button
Seat 1: 99d15dce ($13.12 in chips)
Seat 2: 7264bbe3 ($11.66 in chips)
Seat 3: 745be88c ($5.15 in chips)
Seat 4: Hero ($10.28 in chips)
Seat 5: 7f82334f ($6.2 in chips)
Seat 6: 7946e846 ($5.18 in chips)
7264bbe3: posts small blind $0.02
745be88c: posts big blind $0.05
*** HOLE CARDS ***
Dealt to 99d15dce 
Dealt to 7264bbe3 
Dealt to 745be88c 
Dealt to Hero [Qd 2c]
Dealt to 7f82334f 
Dealt to 7946e846 
Hero: folds
7f82334f: folds
7946e846: folds
99d15dce: folds
7264bbe3: raises $0.05 to $0.1
745be88c: folds
Uncalled bet ($0.05) returned to 7264bbe3
*** SHOWDOWN ***
7264bbe3 collected $0.1 from pot
*** SUMMARY ***
Total pot $0.1 | Rake $0 | Jackpot $0 | Bingo $0 | Fortune $0 | Tax $0
Seat 1: 99d15dce (button) folded before Flop (didn't bet)
Seat 2: 7264bbe3 (small blind) collected ($0.1)
Seat 3: 745be88c (big blind) folded before Flop
Seat 4: Hero folded before Flop (didn't bet)
Seat 5: 7f82334f folded before Flop (didn't bet)
Seat 6: 7946e846 folded before Flop (didn't bet)


Poker Hand #RC3794712942: Hold'em No Limit ($0.02/$0.05) - 2025/08/09 20:55:11
Table 'RushAndCash10838202' 6-max Seat #1 is the button
Seat 1: e285caaf ($6.57 in chips)
Seat 2: 41626ac4 ($5.05 in chips)
Seat 3: Hero ($10.33 in chips)
Seat 4: 1d2a2d42 ($5 in chips)
Seat 5: 4e5bf084 ($5.07 in chips)
Seat 6: 2ad08dad ($5.07 in chips)
41626ac4: posts small blind $0.02
Hero: posts big blind $0.05
*** HOLE CARDS ***
Dealt to e285caaf 
Dealt to 41626ac4 
Dealt to Hero [Jc 6s]
Dealt to 1d2a2d42 
Dealt to 4e5bf084 
Dealt to 2ad08dad 
1d2a2d42: folds
4e5bf084: folds
2ad08dad: folds
e285caaf: folds
41626ac4: folds
Uncalled bet ($0.03) returned to Hero
*** SHOWDOWN ***
Hero collected $0.04 from pot
*** SUMMARY ***
Total pot $0.04 | Rake $0 | Jackpot $0 | Bingo $0 | Fortune $0 | Tax $0
Seat 1: e285caaf (button) folded before Flop (didn't bet)
Seat 2: 41626ac4 (small blind) folded before Flop
Seat 3: Hero (big blind) collected ($0.04)
Seat 4: 1d2a2d42 folded before Flop (didn't bet)
Seat 5: 4e5bf084 folded before Flop (didn't bet)
Seat 6: 2ad08dad folded before Flop (didn't bet)


Poker Hand #RC3794712580: Hold'em No Limit ($0.02/$0.05) - 2025/08/09 20:54:09
Table 'RushAndCash10837840' 6-max Seat #1 is the button
Seat 1: 7ee5bdc3 ($5.45 in chips)
Seat 2: 1055095b ($5.17 in chips)
Seat 3: d45ab85a ($5.67 in chips)
Seat 4: fdbd98ca ($4.88 in chips)
Seat 5: 9c98035d ($7.78 in chips)
Seat 6: Hero ($9.98 in chips)
1055095b: posts small blind $0.02
d45ab85a: posts big blind $0.05
*** HOLE CARDS ***
Dealt to 7ee5bdc3 
Dealt to 1055095b 
Dealt to d45ab85a 
Dealt to fdbd98ca 
Dealt to 9c98035d 
Dealt to Hero [9s 9c]
fdbd98ca: folds
9c98035d: folds
Hero: raises $0.05 to $0.1
7ee5bdc3: raises $0.21 to $0.31
1055095b: folds
d45ab85a: folds
Hero: calls $0.21
*** FLOP *** [Qh Jd 4s]
Hero: checks
7ee5bdc3: checks
*** TURN *** [Qh Jd 4s] [8c]
Hero: checks
7ee5bdc3: checks
*** RIVER *** [Qh Jd 4s 8c] [Qc]
Hero: checks
7ee5bdc3: checks
Hero: shows [9s 9c] (two pair, Queens and Nines)
7ee5bdc3: shows [Ac 6c] (a pair of Queens)
*** SHOWDOWN ***
Hero collected $0.66 from pot
*** SUMMARY ***
Total pot $0.69 | Rake $0.03 | Jackpot $0 | Bingo $0 | Fortune $0 | Tax $0
Board [Qh Jd 4s 8c Qc]
Seat 1: 7ee5bdc3 (button) showed [Ac 6c] and lost with a pair of Queens
Seat 2: 1055095b (small blind) folded before Flop
Seat 3: d45ab85a (big blind) folded before Flop
Seat 4: fdbd98ca folded before Flop (didn't bet)
Seat 5: 9c98035d folded before Flop (didn't bet)
Seat 6: Hero showed [9s 9c] and won ($0.66) with two pair, Queens and Nines


Poker Hand #RC3794712203: Hold'em No Limit ($0.02/$0.05) - 2025/08/09 20:53:00
Table 'RushAndCash10837463' 6-max Seat #1 is the button
Seat 1: 5c7ea22b ($7.1 in chips)
Seat 2: e3cb6d92 ($5.03 in chips)
Seat 3: 7ee5bdc3 ($5.71 in chips)
Seat 4: f3a1d090 ($10.13 in chips)
Seat 5: Hero ($10.08 in chips)
Seat 6: fdbd98ca ($4.53 in chips)
e3cb6d92: posts small blind $0.02
7ee5bdc3: posts big blind $0.05
*** HOLE CARDS ***
Dealt to 5c7ea22b 
Dealt to e3cb6d92 
Dealt to 7ee5bdc3 
Dealt to f3a1d090 
Dealt to Hero [Ah Tc]
Dealt to fdbd98ca 
f3a1d090: folds
Hero: raises $0.05 to $0.1
fdbd98ca: calls $0.1
5c7ea22b: folds
e3cb6d92: folds
7ee5bdc3: calls $0.05
*** FLOP *** [7c Qc 3h]
7ee5bdc3: checks
Hero: checks
fdbd98ca: bets $0.16
7ee5bdc3: calls $0.16
Hero: folds
*** TURN *** [7c Qc 3h] [Kd]
7ee5bdc3: checks
fdbd98ca: bets $0.48
7ee5bdc3: folds
Uncalled bet ($0.48) returned to fdbd98ca
*** SHOWDOWN ***
fdbd98ca collected $0.61 from pot
*** SUMMARY ***
Total pot $0.64 | Rake $0.03 | Jackpot $0 | Bingo $0 | Fortune $0 | Tax $0
Board [7c Qc 3h Kd]
Seat 1: 5c7ea22b (button) folded before Flop (didn't bet)
Seat 2: e3cb6d92 (small blind) folded before Flop
Seat 3: 7ee5bdc3 (big blind) folded on the Turn
Seat 4: f3a1d090 folded before Flop (didn't bet)
Seat 5: Hero folded on the Flop
Seat 6: fdbd98ca won ($0.61)


Poker Hand #RC3794712087: Hold'em No Limit ($0.02/$0.05) - 2025/08/09 20:52:39
Table 'RushAndCash10837347' 6-max Seat #1 is the button
Seat 1: 76211edb ($10.75 in chips)
Seat 2: 7c6d9206 ($5.02 in chips)
Seat 3: Hero ($10.13 in chips)
Seat 4: bc8d7b66 ($5.75 in chips)
Seat 5: e1cf8f5d ($5 in chips)
Seat 6: 356b0b20 ($10.38 in chips)
7c6d9206: posts small blind $0.02
Hero: posts big blind $0.05
*** HOLE CARDS ***
Dealt to 76211edb 
Dealt to 7c6d9206 
Dealt to Hero [8c 8h]
Dealt to bc8d7b66 
Dealt to e1cf8f5d 
Dealt to 356b0b20 
bc8d7b66: raises $0.1 to $0.15
e1cf8f5d: folds
356b0b20: raises $0.25 to $0.4
76211edb: folds
7c6d9206: folds
Hero: folds
bc8d7b66: folds
Uncalled bet ($0.25) returned to 356b0b20
*** SHOWDOWN ***
356b0b20 collected $0.36 from pot
*** SUMMARY ***
Total pot $0.37 | Rake $0.01 | Jackpot $0 | Bingo $0 | Fortune $0 | Tax $0
Seat 1: 76211edb (button) folded before Flop (didn't bet)
Seat 2: 7c6d9206 (small blind) folded before Flop
Seat 3: Hero (big blind) folded before Flop
Seat 4: bc8d7b66 folded before Flop
Seat 5: e1cf8f5d folded before Flop (didn't bet)
Seat 6: 356b0b20 collected ($0.36)


Poker Hand #RC3794712057: Hold'em No Limit ($0.02/$0.05) - 2025/08/09 20:52:34
Table 'RushAndCash10837317' 6-max Seat #1 is the button
Seat 1: Hero ($10.13 in chips)
Seat 2: f3cceda1 ($8.98 in chips)
Seat 3: 8e38cd0c ($5.17 in chips)
Seat 4: ef14076f ($5 in chips)
Seat 5: 7a6ee12b ($29.18 in chips)
Seat 6: ba4330c ($5.5 in chips)
f3cceda1: posts small blind $0.02
8e38cd0c: posts big blind $0.05
*** HOLE CARDS ***
Dealt to Hero [6c 3h]
Dealt to f3cceda1 
Dealt to 8e38cd0c 
Dealt to ef14076f 
Dealt to 7a6ee12b 
Dealt to ba4330c 
ef14076f: folds
7a6ee12b: folds
ba4330c: folds
Hero: folds
f3cceda1: raises $0.05 to $0.1
8e38cd0c: folds
Uncalled bet ($0.05) returned to f3cceda1
*** SHOWDOWN ***
f3cceda1 collected $0.1 from pot
*** SUMMARY ***
Total pot $0.1 | Rake $0 | Jackpot $0 | Bingo $0 | Fortune $0 | Tax $0
Seat 1: Hero (button) folded before Flop (didn't bet)
Seat 2: f3cceda1 (small blind) collected ($0.1)
Seat 3: 8e38cd0c (big blind) folded before Flop
Seat 4: ef14076f folded before Flop (didn't bet)
Seat 5: 7a6ee12b folded before Flop (didn't bet)
Seat 6: ba4330c folded before Flop (didn't bet)


Poker Hand #RC3794711903: Hold'em No Limit ($0.02/$0.05) - 2025/08/09 20:52:06
Table 'RushAndCash10837163' 6-max Seat #1 is the button
Seat 1: 440b4c12 ($5.87 in chips)
Seat 2: 64b4c970 ($4.4 in chips)
Seat 3: ad489162 ($5.04 in chips)
Seat 4: Hero ($10.06 in chips)
Seat 5: 1197636c ($6.3 in chips)
Seat 6: 54a63178 ($2.12 in chips)
64b4c970: posts small blind $0.02
ad489162: posts big blind $0.05
*** HOLE CARDS ***
Dealt to 440b4c12 
Dealt to 64b4c970 
Dealt to ad489162 
Dealt to Hero [Ah Jc]
Dealt to 1197636c 
Dealt to 54a63178 
Hero: raises $0.05 to $0.1
1197636c: folds
54a63178: folds
440b4c12: folds
64b4c970: folds
ad489162: folds
Uncalled bet ($0.05) returned to Hero
*** SHOWDOWN ***
Hero collected $0.12 from pot
*** SUMMARY ***
Total pot $0.12 | Rake $0 | Jackpot $0 | Bingo $0 | Fortune $0 | Tax $0
Seat 1: 440b4c12 (button) folded before Flop (didn't bet)
Seat 2: 64b4c970 (small blind) folded before Flop
Seat 3: ad489162 (big blind) folded before Flop
Seat 4: Hero collected ($0.12)
Seat 5: 1197636c folded before Flop (didn't bet)
Seat 6: 54a63178 folded before Flop (didn't bet)


Poker Hand #RC3794711883: Hold'em No Limit ($0.02/$0.05) - 2025/08/09 20:52:03
Table 'RushAndCash10837143' 6-max Seat #1 is the button
Seat 1: 36655a52 ($6.12 in chips)
Seat 2: Hero ($10.08 in chips)
Seat 3: 8a366556 ($6.95 in chips)
Seat 4: 369c563b ($5.19 in chips)
Seat 5: be50ed85 ($6.64 in chips)
Seat 6: 7d8f8074 ($6.16 in chips)
Hero: posts small blind $0.02
8a366556: posts big blind $0.05
*** HOLE CARDS ***
Dealt to 36655a52 
Dealt to Hero [3c Qs]
Dealt to 8a366556 
Dealt to 369c563b 
Dealt to be50ed85 
Dealt to 7d8f8074 
369c563b: folds
be50ed85: raises $0.08 to $0.13
7d8f8074: folds
36655a52: folds
Hero: folds
8a366556: folds
Uncalled bet ($0.08) returned to be50ed85
*** SHOWDOWN ***
be50ed85 collected $0.12 from pot
*** SUMMARY ***
Total pot $0.12 | Rake $0 | Jackpot $0 | Bingo $0 | Fortune $0 | Tax $0
Seat 1: 36655a52 (button) folded before Flop (didn't bet)
Seat 2: Hero (small blind) folded before Flop
Seat 3: 8a366556 (big blind) folded before Flop
Seat 4: 369c563b folded before Flop (didn't bet)
Seat 5: be50ed85 collected ($0.12)
Seat 6: 7d8f8074 folded before Flop (didn't bet)


Poker Hand #RC3794711859: Hold'em No Limit ($0.02/$0.05) - 2025/08/09 20:51:58
Table 'RushAndCash10837119' 6-max Seat #1 is the button
Seat 1: e1e6a6ec ($12.02 in chips)
Seat 2: 686ba38d ($1.95 in chips)
Seat 3: 2fc96fe ($6.84 in chips)
Seat 4: af6c0be8 ($5 in chips)
Seat 5: Hero ($10.08 in chips)
Seat 6: cae2dc9e ($5.16 in chips)
686ba38d: posts small blind $0.02
2fc96fe: posts big blind $0.05
*** HOLE CARDS ***
Dealt to e1e6a6ec 
Dealt to 686ba38d 
Dealt to 2fc96fe 
Dealt to af6c0be8 
Dealt to Hero [3c Jd]
Dealt to cae2dc9e 
af6c0be8: folds
Hero: folds
cae2dc9e: folds
e1e6a6ec: folds
686ba38d: raises $0.05 to $0.1
2fc96fe: calls $0.05
*** FLOP *** [4h 8d Ts]
686ba38d: checks
2fc96fe: bets $0.1
686ba38d: calls $0.1
*** TURN *** [4h 8d Ts] [4d]
686ba38d: checks
2fc96fe: checks
*** RIVER *** [4h 8d Ts 4d] [2c]
686ba38d: checks
2fc96fe: bets $0.3
686ba38d: folds
Uncalled bet ($0.3) returned to 2fc96fe
*** SHOWDOWN ***
2fc96fe collected $0.38 from pot
*** SUMMARY ***
Total pot $0.4 | Rake $0.02 | Jackpot $0 | Bingo $0 | Fortune $0 | Tax $0
Board [4h 8d Ts 4d 2c]
Seat 1: e1e6a6ec (button) folded before Flop (didn't bet)
Seat 2: 686ba38d (small blind) folded on the River
Seat 3: 2fc96fe (big blind) won ($0.38)
Seat 4: af6c0be8 folded before Flop (didn't bet)
Seat 5: Hero folded before Flop (didn't bet)
Seat 6: cae2dc9e folded before Flop (didn't bet)


Poker Hand #RC3794711836: Hold'em No Limit ($0.02/$0.05) - 2025/08/09 20:51:55
Table 'RushAndCash10837096' 6-max Seat #1 is the button
Seat 1: 6bfc5e4a ($9.35 in chips)
Seat 2: 8edf7521 ($6.65 in chips)
Seat 3: 810806b8 ($5.26 in chips)
Seat 4: 99d15dce ($7.58 in chips)
Seat 5: Hero ($10.08 in chips)
Seat 6: 576eaca ($5.05 in chips)
8edf7521: posts small blind $0.02
810806b8: posts big blind $0.05
*** HOLE CARDS ***
Dealt to 6bfc5e4a 
Dealt to 8edf7521 
Dealt to 810806b8 
Dealt to 99d15dce 
Dealt to Hero [2c Qc]
Dealt to 576eaca 
99d15dce: folds
Hero: folds
576eaca: raises $0.07 to $0.12
6bfc5e4a: folds
8edf7521: folds
810806b8: folds
Uncalled bet ($0.07) returned to 576eaca
*** SHOWDOWN ***
576eaca collected $0.12 from pot
*** SUMMARY ***
Total pot $0.12 | Rake $0 | Jackpot $0 | Bingo $0 | Fortune $0 | Tax $0
Seat 1: 6bfc5e4a (button) folded before Flop (didn't bet)
Seat 2: 8edf7521 (small blind) folded before Flop
Seat 3: 810806b8 (big blind) folded before Flop
Seat 4: 99d15dce folded before Flop (didn't bet)
Seat 5: Hero folded before Flop (didn't bet)
Seat 6: 576eaca collected ($0.12)


Poker Hand #RC3794711818: Hold'em No Limit ($0.02/$0.05) - 2025/08/09 20:51:52
Table 'RushAndCash10837078' 6-max Seat #1 is the button
Seat 1: 60d1140d ($5.05 in chips)
Seat 2: 6d22fd1e ($5.02 in chips)
Seat 3: 3262a3fc ($5.34 in chips)
Seat 4: 34a678f5 ($5.12 in chips)
Seat 5: Hero ($10.08 in chips)
Seat 6: caf5392e ($9.9 in chips)
6d22fd1e: posts small blind $0.02
3262a3fc: posts big blind $0.05
*** HOLE CARDS ***
Dealt to 60d1140d 
Dealt to 6d22fd1e 
Dealt to 3262a3fc 
Dealt to 34a678f5 
Dealt to Hero [9d 4c]
Dealt to caf5392e 
34a678f5: raises $0.07 to $0.12
Hero: folds
caf5392e: folds
60d1140d: folds
6d22fd1e: folds
3262a3fc: raises $0.5 to $0.62
34a678f5: calls $0.5
*** FLOP *** [4s 9c Ts]
3262a3fc: bets $0.5
34a678f5: calls $0.5
*** TURN *** [4s 9c Ts] [6c]
3262a3fc: checks
34a678f5: checks
*** RIVER *** [4s 9c Ts 6c] [8d]
3262a3fc: checks
34a678f5: checks
3262a3fc: shows [Qh As] (Ace high)
34a678f5: shows [5s 6s] (a pair of Sixes)
*** SHOWDOWN ***
34a678f5 collected $2.08 from pot
*** SUMMARY ***
Total pot $2.26 | Rake $0.11 | Jackpot $0.07 | Bingo $0 | Fortune $0 | Tax $0
Board [4s 9c Ts 6c 8d]
Seat 1: 60d1140d (button) folded before Flop (didn't bet)
Seat 2: 6d22fd1e (small blind) folded before Flop
Seat 3: 3262a3fc (big blind) showed [Qh As] and lost with Ace high
Seat 4: 34a678f5 showed [5s 6s] and won ($2.08) with a pair of Sixes
Seat 5: Hero folded before Flop (didn't bet)
Seat 6: caf5392e folded before Flop (didn't bet)


Poker Hand #RC3794711701: Hold'em No Limit ($0.02/$0.05) - 2025/08/09 20:51:31
Table 'RushAndCash10836961' 6-max Seat #1 is the button
Seat 1: 6aa1d0de ($5.45 in chips)
Seat 2: Hero ($10.03 in chips)
Seat 3: 3d391d6f ($8.08 in chips)
Seat 4: 918c5263 ($5.98 in chips)
Seat 5: ba46b98d ($5.49 in chips)
Seat 6: 40bc30b8 ($5.58 in chips)
Hero: posts small blind $0.02
3d391d6f: posts big blind $0.05
*** HOLE CARDS ***
Dealt to 6aa1d0de 
Dealt to Hero [5c 5d]
Dealt to 3d391d6f 
Dealt to 918c5263 
Dealt to ba46b98d 
Dealt to 40bc30b8 
918c5263: folds
ba46b98d: folds
40bc30b8: folds
6aa1d0de: folds
Hero: raises $0.1 to $0.15
3d391d6f: folds
Uncalled bet ($0.1) returned to Hero
*** SHOWDOWN ***
Hero collected $0.1 from pot
*** SUMMARY ***
Total pot $0.1 | Rake $0 | Jackpot $0 | Bingo $0 | Fortune $0 | Tax $0
Seat 1: 6aa1d0de (button) folded before Flop (didn't bet)
Seat 2: Hero (small blind) collected ($0.1)
Seat 3: 3d391d6f (big blind) folded before Flop
Seat 4: 918c5263 folded before Flop (didn't bet)
Seat 5: ba46b98d folded before Flop (didn't bet)
Seat 6: 40bc30b8 folded before Flop (didn't bet)


Poker Hand #RC3794711656: Hold'em No Limit ($0.02/$0.05) - 2025/08/09 20:51:25
Table 'RushAndCash10836916' 6-max Seat #1 is the button
Seat 1: 1055095b ($5 in chips)
Seat 2: 119e3298 ($6.32 in chips)
Seat 3: Hero ($10.08 in chips)
Seat 4: fe8c7c0 ($10.85 in chips)
Seat 5: 8b6f27db ($9.11 in chips)
Seat 6: 19ff753b ($5.3 in chips)
119e3298: posts small blind $0.02
Hero: posts big blind $0.05
*** HOLE CARDS ***
Dealt to 1055095b 
Dealt to 119e3298 
Dealt to Hero [6c Qs]
Dealt to fe8c7c0 
Dealt to 8b6f27db 
Dealt to 19ff753b 
fe8c7c0: folds
8b6f27db: folds
19ff753b: folds
1055095b: folds
119e3298: raises $0.1 to $0.15
Hero: folds
Uncalled bet ($0.1) returned to 119e3298
*** SHOWDOWN ***
119e3298 collected $0.1 from pot
*** SUMMARY ***
Total pot $0.1 | Rake $0 | Jackpot $0 | Bingo $0 | Fortune $0 | Tax $0
Seat 1: 1055095b (button) folded before Flop (didn't bet)
Seat 2: 119e3298 (small blind) collected ($0.1)
Seat 3: Hero (big blind) folded before Flop
Seat 4: fe8c7c0 folded before Flop (didn't bet)
Seat 5: 8b6f27db folded before Flop (didn't bet)
Seat 6: 19ff753b folded before Flop (didn't bet)


Poker Hand #RC3794711632: Hold'em No Limit ($0.02/$0.05) - 2025/08/09 20:51:21
Table 'RushAndCash10836892' 6-max Seat #1 is the button
Seat 1: 686ba38d ($2 in chips)
Seat 2: fa179cbb ($5.18 in chips)
Seat 3: 4c7f6a0e ($5.21 in chips)
Seat 4: 1055095b ($5 in chips)
Seat 5: Hero ($10.08 in chips)
Seat 6: 16e6973e ($5.02 in chips)
fa179cbb: posts small blind $0.02
4c7f6a0e: posts big blind $0.05
*** HOLE CARDS ***
Dealt to 686ba38d 
Dealt to fa179cbb 
Dealt to 4c7f6a0e 
Dealt to 1055095b 
Dealt to Hero [6d 7h]
Dealt to 16e6973e 
1055095b: folds
Hero: folds
16e6973e: folds
686ba38d: folds
fa179cbb: folds
Uncalled bet ($0.03) returned to 4c7f6a0e
*** SHOWDOWN ***
4c7f6a0e collected $0.04 from pot
*** SUMMARY ***
Total pot $0.04 | Rake $0 | Jackpot $0 | Bingo $0 | Fortune $0 | Tax $0
Seat 1: 686ba38d (button) folded before Flop (didn't bet)
Seat 2: fa179cbb (small blind) folded before Flop
Seat 3: 4c7f6a0e (big blind) collected ($0.04)
Seat 4: 1055095b folded before Flop (didn't bet)
Seat 5: Hero folded before Flop (didn't bet)
Seat 6: 16e6973e folded before Flop (didn't bet)


Poker Hand #RC3794711602: Hold'em No Limit ($0.02/$0.05) - 2025/08/09 20:51:17
Table 'RushAndCash10836862' 6-max Seat #1 is the button
Seat 1: Hero ($10.08 in chips)
Seat 2: c296fa82 ($5 in chips)
Seat 3: ae8e199a ($5.09 in chips)
Seat 4: 6b91637b ($5.19 in chips)
Seat 5: 16e6973e ($5.02 in chips)
Seat 6: 24ccc5f7 ($9.01 in chips)
c296fa82: posts small blind $0.02
ae8e199a: posts big blind $0.05
*** HOLE CARDS ***
Dealt to Hero [6s Jc]
Dealt to c296fa82 
Dealt to ae8e199a 
Dealt to 6b91637b 
Dealt to 16e6973e 
Dealt to 24ccc5f7 
6b91637b: folds
16e6973e: folds
24ccc5f7: folds
Hero: folds
c296fa82: raises $0.08 to $0.13
ae8e199a: calls $0.08
*** FLOP *** [Qs As 4c]
c296fa82: bets $0.09
ae8e199a: folds
Uncalled bet ($0.09) returned to c296fa82
*** SHOWDOWN ***
c296fa82 collected $0.25 from pot
*** SUMMARY ***
Total pot $0.26 | Rake $0.01 | Jackpot $0 | Bingo $0 | Fortune $0 | Tax $0
Board [Qs As 4c]
Seat 1: Hero (button) folded before Flop (didn't bet)
Seat 2: c296fa82 (small blind) won ($0.25)
Seat 3: ae8e199a (big blind) folded on the Flop
Seat 4: 6b91637b folded before Flop (didn't bet)
Seat 5: 16e6973e folded before Flop (didn't bet)
Seat 6: 24ccc5f7 folded before Flop (didn't bet)


Poker Hand #RC3794711579: Hold'em No Limit ($0.02/$0.05) - 2025/08/09 20:51:13
Table 'RushAndCash10836839' 6-max Seat #1 is the button
Seat 1: 859f0257 ($5.83 in chips)
Seat 2: b79528db ($5.3 in chips)
Seat 3: aac2ed56 ($5 in chips)
Seat 4: e56bda5e ($4.62 in chips)
Seat 5: Hero ($10.08 in chips)
Seat 6: 2f8cb281 ($6.49 in chips)
b79528db: posts small blind $0.02
aac2ed56: posts big blind $0.05
*** HOLE CARDS ***
Dealt to 859f0257 
Dealt to b79528db 
Dealt to aac2ed56 
Dealt to e56bda5e 
Dealt to Hero [4d 8d]
Dealt to 2f8cb281 
e56bda5e: folds
Hero: folds
2f8cb281: folds
859f0257: folds
b79528db: raises $0.1 to $0.15
aac2ed56: folds
Uncalled bet ($0.1) returned to b79528db
*** SHOWDOWN ***
b79528db collected $0.1 from pot
*** SUMMARY ***
Total pot $0.1 | Rake $0 | Jackpot $0 | Bingo $0 | Fortune $0 | Tax $0
Seat 1: 859f0257 (button) folded before Flop (didn't bet)
Seat 2: b79528db (small blind) collected ($0.1)
Seat 3: aac2ed56 (big blind) folded before Flop
Seat 4: e56bda5e folded before Flop (didn't bet)
Seat 5: Hero folded before Flop (didn't bet)
Seat 6: 2f8cb281 folded before Flop (didn't bet)


Poker Hand #RC3794711557: Hold'em No Limit ($0.02/$0.05) - 2025/08/09 20:51:10
Table 'RushAndCash10836817' 6-max Seat #1 is the button
Seat 1: 5b781315 ($5 in chips)
Seat 2: 2eeff014 ($5.56 in chips)
Seat 3: 9ad0155e ($5 in chips)
Seat 4: Hero ($10.08 in chips)
Seat 5: 85648a31 ($4.77 in chips)
Seat 6: 61137e3a ($2.55 in chips)
2eeff014: posts small blind $0.02
9ad0155e: posts big blind $0.05
*** HOLE CARDS ***
Dealt to 5b781315 
Dealt to 2eeff014 
Dealt to 9ad0155e 
Dealt to Hero [5c Th]
Dealt to 85648a31 
Dealt to 61137e3a 
Hero: folds
85648a31: folds
61137e3a: folds
5b781315: folds
2eeff014: folds
Uncalled bet ($0.03) returned to 9ad0155e
*** SHOWDOWN ***
9ad0155e collected $0.04 from pot
*** SUMMARY ***
Total pot $0.04 | Rake $0 | Jackpot $0 | Bingo $0 | Fortune $0 | Tax $0
Seat 1: 5b781315 (button) folded before Flop (didn't bet)
Seat 2: 2eeff014 (small blind) folded before Flop
Seat 3: 9ad0155e (big blind) collected ($0.04)
Seat 4: Hero folded before Flop (didn't bet)
Seat 5: 85648a31 folded before Flop (didn't bet)
Seat 6: 61137e3a folded before Flop (didn't bet)


Poker Hand #RC3794711512: Hold'em No Limit ($0.02/$0.05) - 2025/08/09 20:51:03
Table 'RushAndCash10836772' 6-max Seat #1 is the button
Seat 1: 76919bdf ($5 in chips)
Seat 2: e4cddcac ($5 in chips)
Seat 3: Hero ($10.13 in chips)
Seat 4: 2fc96fe ($6.77 in chips)
Seat 5: b9a60126 ($7.05 in chips)
Seat 6: 16e6973e ($5.07 in chips)
e4cddcac: posts small blind $0.02
Hero: posts big blind $0.05
*** HOLE CARDS ***
Dealt to 76919bdf 
Dealt to e4cddcac 
Dealt to Hero [Js 2s]
Dealt to 2fc96fe 
Dealt to b9a60126 
Dealt to 16e6973e 
2fc96fe: folds
b9a60126: folds
16e6973e: folds
76919bdf: raises $0.06 to $0.11
e4cddcac: folds
Hero: folds
Uncalled bet ($0.06) returned to 76919bdf
*** SHOWDOWN ***
76919bdf collected $0.12 from pot
*** SUMMARY ***
Total pot $0.12 | Rake $0 | Jackpot $0 | Bingo $0 | Fortune $0 | Tax $0
Seat 1: 76919bdf (button) collected ($0.12)
Seat 2: e4cddcac (small blind) folded before Flop
Seat 3: Hero (big blind) folded before Flop
Seat 4: 2fc96fe folded before Flop (didn't bet)
Seat 5: b9a60126 folded before Flop (didn't bet)
Seat 6: 16e6973e folded before Flop (didn't bet)


Poker Hand #RC3794711372: Hold'em No Limit ($0.02/$0.05) - 2025/08/09 20:50:41
Table 'RushAndCash10836632' 6-max Seat #1 is the button
Seat 1: 734169f9 ($22.54 in chips)
Seat 2: b9a60126 ($6.91 in chips)
Seat 3: 38503bb9 ($5 in chips)
Seat 4: 2af9a41c ($5.47 in chips)
Seat 5: 5740c1c5 ($5 in chips)
Seat 6: Hero ($10.23 in chips)
b9a60126: posts small blind $0.02
38503bb9: posts big blind $0.05
*** HOLE CARDS ***
Dealt to 734169f9 
Dealt to b9a60126 
Dealt to 38503bb9 
Dealt to 2af9a41c 
Dealt to 5740c1c5 
Dealt to Hero [Js Tc]
2af9a41c: folds
5740c1c5: folds
Hero: raises $0.05 to $0.1
734169f9: folds
b9a60126: raises $0.25 to $0.35
38503bb9: folds
Hero: folds
Uncalled bet ($0.25) returned to b9a60126
*** SHOWDOWN ***
b9a60126 collected $0.24 from pot
*** SUMMARY ***
Total pot $0.25 | Rake $0.01 | Jackpot $0 | Bingo $0 | Fortune $0 | Tax $0
Seat 1: 734169f9 (button) folded before Flop (didn't bet)
Seat 2: b9a60126 (small blind) collected ($0.24)
Seat 3: 38503bb9 (big blind) folded before Flop
Seat 4: 2af9a41c folded before Flop (didn't bet)
Seat 5: 5740c1c5 folded before Flop (didn't bet)
Seat 6: Hero folded before Flop


Poker Hand #RC3794711352: Hold'em No Limit ($0.02/$0.05) - 2025/08/09 20:50:37
Table 'RushAndCash10836612' 6-max Seat #1 is the button
Seat 1: ef98ca65 ($6.86 in chips)
Seat 2: 2b7992bd ($6.45 in chips)
Seat 3: 2a373580 ($5 in chips)
Seat 4: 32ee6ef6 ($5 in chips)
Seat 5: e9a880e8 ($6.71 in chips)
Seat 6: Hero ($10.23 in chips)
2b7992bd: posts small blind $0.02
2a373580: posts big blind $0.05
*** HOLE CARDS ***
Dealt to ef98ca65 
Dealt to 2b7992bd 
Dealt to 2a373580 
Dealt to 32ee6ef6 
Dealt to e9a880e8 
Dealt to Hero [Jc 6d]
32ee6ef6: raises $0.06 to $0.11
e9a880e8: folds
Hero: folds
ef98ca65: folds
2b7992bd: folds
2a373580: folds
Uncalled bet ($0.06) returned to 32ee6ef6
*** SHOWDOWN ***
32ee6ef6 collected $0.12 from pot
*** SUMMARY ***
Total pot $0.12 | Rake $0 | Jackpot $0 | Bingo $0 | Fortune $0 | Tax $0
Seat 1: ef98ca65 (button) folded before Flop (didn't bet)
Seat 2: 2b7992bd (small blind) folded before Flop
Seat 3: 2a373580 (big blind) folded before Flop
Seat 4: 32ee6ef6 collected ($0.12)
Seat 5: e9a880e8 folded before Flop (didn't bet)
Seat 6: Hero folded before Flop (didn't bet)


Poker Hand #RC3794711296: Hold'em No Limit ($0.02/$0.05) - 2025/08/09 20:50:29
Table 'RushAndCash10836556' 6-max Seat #1 is the button
Seat 1: Hero ($10.23 in chips)
Seat 2: a53cb77e ($5.16 in chips)
Seat 3: 6b07d62c ($5.63 in chips)
Seat 4: 761d56d5 ($5 in chips)
Seat 5: 7d6169ad ($11.03 in chips)
Seat 6: 70b2f8fb ($5.92 in chips)
a53cb77e: posts small blind $0.02
6b07d62c: posts big blind $0.05
*** HOLE CARDS ***
Dealt to Hero [3d Kh]
Dealt to a53cb77e 
Dealt to 6b07d62c 
Dealt to 761d56d5 
Dealt to 7d6169ad 
Dealt to 70b2f8fb 
761d56d5: folds
7d6169ad: raises $0.05 to $0.1
70b2f8fb: folds
Hero: folds
a53cb77e: folds
6b07d62c: calls $0.05
*** FLOP *** [Ad 5s Qc]
6b07d62c: checks
7d6169ad: bets $0.08
6b07d62c: calls $0.08
*** TURN *** [Ad 5s Qc] [6s]
6b07d62c: checks
7d6169ad: bets $0.29
6b07d62c: folds
Uncalled bet ($0.29) returned to 7d6169ad
*** SHOWDOWN ***
7d6169ad collected $0.37 from pot
*** SUMMARY ***
Total pot $0.38 | Rake $0.01 | Jackpot $0 | Bingo $0 | Fortune $0 | Tax $0
Board [Ad 5s Qc 6s]
Seat 1: Hero (button) folded before Flop (didn't bet)
Seat 2: a53cb77e (small blind) folded before Flop
Seat 3: 6b07d62c (big blind) folded on the Turn
Seat 4: 761d56d5 folded before Flop (didn't bet)
Seat 5: 7d6169ad won ($0.37)
Seat 6: 70b2f8fb folded before Flop (didn't bet)


Poker Hand #RC3794711226: Hold'em No Limit ($0.02/$0.05) - 2025/08/09 20:50:18
Table 'RushAndCash10836486' 6-max Seat #1 is the button
Seat 1: c1fa8f23 ($5.19 in chips)
Seat 2: Hero ($10.25 in chips)
Seat 3: 1da6e048 ($5.05 in chips)
Seat 4: 8e11e4bd ($6.32 in chips)
Seat 5: fdbd98ca ($3.91 in chips)
Seat 6: fb1236e4 ($3.04 in chips)
Hero: posts small blind $0.02
1da6e048: posts big blind $0.05
*** HOLE CARDS ***
Dealt to c1fa8f23 
Dealt to Hero [3s 9h]
Dealt to 1da6e048 
Dealt to 8e11e4bd 
Dealt to fdbd98ca 
Dealt to fb1236e4 
8e11e4bd: folds
fdbd98ca: folds
fb1236e4: folds
c1fa8f23: folds
Hero: folds
Uncalled bet ($0.03) returned to 1da6e048
*** SHOWDOWN ***
1da6e048 collected $0.04 from pot
*** SUMMARY ***
Total pot $0.04 | Rake $0 | Jackpot $0 | Bingo $0 | Fortune $0 | Tax $0
Seat 1: c1fa8f23 (button) folded before Flop (didn't bet)
Seat 2: Hero (small blind) folded before Flop
Seat 3: 1da6e048 (big blind) collected ($0.04)
Seat 4: 8e11e4bd folded before Flop (didn't bet)
Seat 5: fdbd98ca folded before Flop (didn't bet)
Seat 6: fb1236e4 folded before Flop (didn't bet)


Poker Hand #RC3794710792: Hold'em No Limit ($0.02/$0.05) - 2025/08/09 20:49:04
Table 'RushAndCash10836052' 6-max Seat #1 is the button
Seat 1: Hero ($8.57 in chips)
Seat 2: db8dcbc3 ($5.11 in chips)
Seat 3: 96134fe8 ($5.86 in chips)
Seat 4: 6e2cac6c ($7.94 in chips)
Seat 5: fb1236e4 ($4.87 in chips)
Seat 6: 95c9f75b ($5.37 in chips)
db8dcbc3: posts small blind $0.02
96134fe8: posts big blind $0.05
*** HOLE CARDS ***
Dealt to Hero [Qc Qd]
Dealt to db8dcbc3 
Dealt to 96134fe8 
Dealt to 6e2cac6c 
Dealt to fb1236e4 
Dealt to 95c9f75b 
6e2cac6c: folds
fb1236e4: raises $0.05 to $0.1
95c9f75b: folds
Hero: raises $0.34 to $0.44
db8dcbc3: folds
96134fe8: folds
fb1236e4: calls $0.34
*** FLOP *** [3h 6s 6c]
fb1236e4: checks
Hero: bets $0.27
fb1236e4: calls $0.27
*** TURN *** [3h 6s 6c] [4s]
fb1236e4: checks
Hero: checks
*** RIVER *** [3h 6s 6c 4s] [8h]
fb1236e4: bets $1.12
Hero: calls $1.12
fb1236e4: shows [Kh Qh] (a pair of Sixes)
Hero: shows [Qc Qd] (two pair, Queens and Sixes)
*** SHOWDOWN ***
Hero collected $3.51 from pot
*** SUMMARY ***
Total pot $3.73 | Rake $0.15 | Jackpot $0.07 | Bingo $0 | Fortune $0 | Tax $0
Board [3h 6s 6c 4s 8h]
Seat 1: Hero (button) showed [Qc Qd] and won ($3.51) with two pair, Queens and Sixes
Seat 2: db8dcbc3 (small blind) folded before Flop
Seat 3: 96134fe8 (big blind) folded before Flop
Seat 4: 6e2cac6c folded before Flop (didn't bet)
Seat 5: fb1236e4 showed [Kh Qh] and lost with a pair of Sixes
Seat 6: 95c9f75b folded before Flop (didn't bet)


Poker Hand #RC3794710769: Hold'em No Limit ($0.02/$0.05) - 2025/08/09 20:49:01
Table 'RushAndCash10836029' 6-max Seat #1 is the button
Seat 1: cf8bfa48 ($5.39 in chips)
Seat 2: 78eff756 ($5.4 in chips)
Seat 3: 96e8c78e ($6.4 in chips)
Seat 4: 972aadb9 ($5.03 in chips)
Seat 5: 7a6ee12b ($29.32 in chips)
Seat 6: Hero ($8.57 in chips)
78eff756: posts small blind $0.02
96e8c78e: posts big blind $0.05
*** HOLE CARDS ***
Dealt to cf8bfa48 
Dealt to 78eff756 
Dealt to 96e8c78e 
Dealt to 972aadb9 
Dealt to 7a6ee12b 
Dealt to Hero [8h 2d]
972aadb9: folds
7a6ee12b: raises $0.05 to $0.1
Hero: folds
cf8bfa48: folds
78eff756: folds
96e8c78e: calls $0.05
*** FLOP *** [Th 5h 6s]
96e8c78e: checks
7a6ee12b: checks
*** TURN *** [Th 5h 6s] [8c]
96e8c78e: checks
7a6ee12b: checks
*** RIVER *** [Th 5h 6s 8c] [Qh]
96e8c78e: checks
7a6ee12b: checks
96e8c78e: shows [6c Ac] (a pair of Sixes)
7a6ee12b: shows [8d Ad] (a pair of Eights)
*** SHOWDOWN ***
7a6ee12b collected $0.21 from pot
*** SUMMARY ***
Total pot $0.22 | Rake $0.01 | Jackpot $0 | Bingo $0 | Fortune $0 | Tax $0
Board [Th 5h 6s 8c Qh]
Seat 1: cf8bfa48 (button) folded before Flop (didn't bet)
Seat 2: 78eff756 (small blind) folded before Flop
Seat 3: 96e8c78e (big blind) showed [6c Ac] and lost with a pair of Sixes
Seat 4: 972aadb9 folded before Flop (didn't bet)
Seat 5: 7a6ee12b showed [8d Ad] and won ($0.21) with a pair of Eights
Seat 6: Hero folded before Flop (didn't bet)


Poker Hand #RC3794710716: Hold'em No Limit ($0.02/$0.05) - 2025/08/09 20:48:52
Table 'RushAndCash10835976' 6-max Seat #1 is the button
Seat 1: cac2a4db ($3.5 in chips)
Seat 2: 8ebb19e4 ($8.56 in chips)
Seat 3: Hero ($8.55 in chips)
Seat 4: bd2b7d94 ($2.9 in chips)
Seat 5: af4c73ad ($4.76 in chips)
Seat 6: 8dd76c45 ($5.09 in chips)
8ebb19e4: posts small blind $0.02
Hero: posts big blind $0.05
*** HOLE CARDS ***
Dealt to cac2a4db 
Dealt to 8ebb19e4 
Dealt to Hero [4c 6s]
Dealt to bd2b7d94 
Dealt to af4c73ad 
Dealt to 8dd76c45 
bd2b7d94: folds
af4c73ad: folds
8dd76c45: folds
cac2a4db: folds
8ebb19e4: folds
Uncalled bet ($0.03) returned to Hero
*** SHOWDOWN ***
Hero collected $0.04 from pot
*** SUMMARY ***
Total pot $0.04 | Rake $0 | Jackpot $0 | Bingo $0 | Fortune $0 | Tax $0
Seat 1: cac2a4db (button) folded before Flop (didn't bet)
Seat 2: 8ebb19e4 (small blind) folded before Flop
Seat 3: Hero (big blind) collected ($0.04)
Seat 4: bd2b7d94 folded before Flop (didn't bet)
Seat 5: af4c73ad folded before Flop (didn't bet)
Seat 6: 8dd76c45 folded before Flop (didn't bet)


Poker Hand #RC3794710673: Hold'em No Limit ($0.02/$0.05) - 2025/08/09 20:48:45
Table 'RushAndCash10835933' 6-max Seat #1 is the button
Seat 1: dc50cbe ($4.9 in chips)
Seat 2: Hero ($8.57 in chips)
Seat 3: c076689 ($2 in chips)
Seat 4: 69a9c9ba ($3.74 in chips)
Seat 5: 30664133 ($7.26 in chips)
Seat 6: f36610f8 ($4.35 in chips)
Hero: posts small blind $0.02
c076689: posts big blind $0.05
*** HOLE CARDS ***
Dealt to dc50cbe 
Dealt to Hero [2h 8s]
Dealt to c076689 
Dealt to 69a9c9ba 
Dealt to 30664133 
Dealt to f36610f8 
69a9c9ba: folds
30664133: folds
f36610f8: folds
dc50cbe: raises $0.06 to $0.11
Hero: folds
c076689: folds
Uncalled bet ($0.06) returned to dc50cbe
*** SHOWDOWN ***
dc50cbe collected $0.12 from pot
*** SUMMARY ***
Total pot $0.12 | Rake $0 | Jackpot $0 | Bingo $0 | Fortune $0 | Tax $0
Seat 1: dc50cbe (button) collected ($0.12)
Seat 2: Hero (small blind) folded before Flop
Seat 3: c076689 (big blind) folded before Flop
Seat 4: 69a9c9ba folded before Flop (didn't bet)
Seat 5: 30664133 folded before Flop (didn't bet)
Seat 6: f36610f8 folded before Flop (didn't bet)


Poker Hand #RC3794710651: Hold'em No Limit ($0.02/$0.05) - 2025/08/09 20:48:41
Table 'RushAndCash10835911' 6-max Seat #1 is the button
Seat 1: d5763bb4 ($5.09 in chips)
Seat 2: 621b675e ($5.02 in chips)
Seat 3: e3cb6d92 ($5 in chips)
Seat 4: Hero ($8.57 in chips)
Seat 5: 544e7436 ($25.01 in chips)
Seat 6: 7ca3039a ($5.89 in chips)
621b675e: posts small blind $0.02
e3cb6d92: posts big blind $0.05
*** HOLE CARDS ***
Dealt to d5763bb4 
Dealt to 621b675e 
Dealt to e3cb6d92 
Dealt to Hero [Qs 4c]
Dealt to 544e7436 
Dealt to 7ca3039a 
Hero: folds
544e7436: folds
7ca3039a: folds
d5763bb4: folds
621b675e: folds
Uncalled bet ($0.03) returned to e3cb6d92
*** SHOWDOWN ***
e3cb6d92 collected $0.04 from pot
*** SUMMARY ***
Total pot $0.04 | Rake $0 | Jackpot $0 | Bingo $0 | Fortune $0 | Tax $0
Seat 1: d5763bb4 (button) folded before Flop (didn't bet)
Seat 2: 621b675e (small blind) folded before Flop
Seat 3: e3cb6d92 (big blind) collected ($0.04)
Seat 4: Hero folded before Flop (didn't bet)
Seat 5: 544e7436 folded before Flop (didn't bet)
Seat 6: 7ca3039a folded before Flop (didn't bet)


Poker Hand #RC3794710629: Hold'em No Limit ($0.02/$0.05) - 2025/08/09 20:48:38
Table 'RushAndCash10835889' 6-max Seat #1 is the button
Seat 1: bc8d7b66 ($5.81 in chips)
Seat 2: 54a63178 ($2.11 in chips)
Seat 3: a689b6f3 ($5.18 in chips)
Seat 4: 97c44460 ($7.42 in chips)
Seat 5: Hero ($8.57 in chips)
Seat 6: e3cb6d92 ($5 in chips)
54a63178: posts small blind $0.02
a689b6f3: posts big blind $0.05
*** HOLE CARDS ***
Dealt to bc8d7b66 
Dealt to 54a63178 
Dealt to a689b6f3 
Dealt to 97c44460 
Dealt to Hero [Kc 9d]
Dealt to e3cb6d92 
97c44460: folds
Hero: folds
e3cb6d92: folds
bc8d7b66: raises $0.1 to $0.15
54a63178: folds
a689b6f3: folds
Uncalled bet ($0.1) returned to bc8d7b66
*** SHOWDOWN ***
bc8d7b66 collected $0.12 from pot
*** SUMMARY ***
Total pot $0.12 | Rake $0 | Jackpot $0 | Bingo $0 | Fortune $0 | Tax $0
Seat 1: bc8d7b66 (button) collected ($0.12)
Seat 2: 54a63178 (small blind) folded before Flop
Seat 3: a689b6f3 (big blind) folded before Flop
Seat 4: 97c44460 folded before Flop (didn't bet)
Seat 5: Hero folded before Flop (didn't bet)
Seat 6: e3cb6d92 folded before Flop (didn't bet)


Poker Hand #RC3794710606: Hold'em No Limit ($0.02/$0.05) - 2025/08/09 20:48:34
Table 'RushAndCash10835866' 6-max Seat #1 is the button
Seat 1: 369c563b ($5.16 in chips)
Seat 2: 55a39b27 ($5 in chips)
Seat 3: bc8d7b66 ($5.86 in chips)
Seat 4: 54a63178 ($2.11 in chips)
Seat 5: Hero ($8.57 in chips)
Seat 6: 8a366556 ($7.28 in chips)
55a39b27: posts small blind $0.02
bc8d7b66: posts big blind $0.05
*** HOLE CARDS ***
Dealt to 369c563b 
Dealt to 55a39b27 
Dealt to bc8d7b66 
Dealt to 54a63178 
Dealt to Hero [7s Tc]
Dealt to 8a366556 
54a63178: folds
Hero: folds
8a366556: folds
369c563b: folds
55a39b27: folds
Uncalled bet ($0.03) returned to bc8d7b66
*** SHOWDOWN ***
bc8d7b66 collected $0.04 from pot
*** SUMMARY ***
Total pot $0.04 | Rake $0 | Jackpot $0 | Bingo $0 | Fortune $0 | Tax $0
Seat 1: 369c563b (button) folded before Flop (didn't bet)
Seat 2: 55a39b27 (small blind) folded before Flop
Seat 3: bc8d7b66 (big blind) collected ($0.04)
Seat 4: 54a63178 folded before Flop (didn't bet)
Seat 5: Hero folded before Flop (didn't bet)
Seat 6: 8a366556 folded before Flop (didn't bet)


Poker Hand #RC3794710456: Hold'em No Limit ($0.02/$0.05) - 2025/08/09 20:48:11
Table 'RushAndCash10835716' 6-max Seat #1 is the button
Seat 1: Hero ($8.69 in chips)
Seat 2: bc8d7b66 ($5.63 in chips)
Seat 3: 862bbf4 ($5.4 in chips)
Seat 4: 3f1bcff3 ($6.13 in chips)
Seat 5: 6b6aeb1d ($4.62 in chips)
Seat 6: c957dd13 ($6.36 in chips)
bc8d7b66: posts small blind $0.02
862bbf4: posts big blind $0.05
*** HOLE CARDS ***
Dealt to Hero [4s 5s]
Dealt to bc8d7b66 
Dealt to 862bbf4 
Dealt to 3f1bcff3 
Dealt to 6b6aeb1d 
Dealt to c957dd13 
3f1bcff3: folds
6b6aeb1d: folds
c957dd13: folds
Hero: raises $0.07 to $0.12
bc8d7b66: calls $0.1
862bbf4: folds
*** FLOP *** [2s 9h Qc]
bc8d7b66: bets $0.15
Hero: folds
Uncalled bet ($0.15) returned to bc8d7b66
*** SHOWDOWN ***
bc8d7b66 collected $0.28 from pot
*** SUMMARY ***
Total pot $0.29 | Rake $0.01 | Jackpot $0 | Bingo $0 | Fortune $0 | Tax $0
Board [2s 9h Qc]
Seat 1: Hero (button) folded on the Flop
Seat 2: bc8d7b66 (small blind) won ($0.28)
Seat 3: 862bbf4 (big blind) folded before Flop
Seat 4: 3f1bcff3 folded before Flop (didn't bet)
Seat 5: 6b6aeb1d folded before Flop (didn't bet)
Seat 6: c957dd13 folded before Flop (didn't bet)


Poker Hand #RC3794709965: Hold'em No Limit ($0.02/$0.05) - 2025/08/09 20:46:53
Table 'RushAndCash10835225' 6-max Seat #1 is the button
Seat 1: f9d845b7 ($10.34 in chips)
Seat 2: Hero ($8.64 in chips)
Seat 3: 5ed6f5ab ($5 in chips)
Seat 4: 84a6e006 ($5 in chips)
Seat 5: 3d944e4 ($5.19 in chips)
Seat 6: 722603f4 ($25.26 in chips)
Hero: posts small blind $0.02
5ed6f5ab: posts big blind $0.05
*** HOLE CARDS ***
Dealt to f9d845b7 
Dealt to Hero [7d Ac]
Dealt to 5ed6f5ab 
Dealt to 84a6e006 
Dealt to 3d944e4 
Dealt to 722603f4 
84a6e006: folds
3d944e4: folds
722603f4: folds
f9d845b7: folds
Hero: calls $0.03
5ed6f5ab: checks
*** FLOP *** [5s Qh 5d]
Hero: checks
5ed6f5ab: checks
*** TURN *** [5s Qh 5d] [Jh]
Hero: checks
5ed6f5ab: checks
*** RIVER *** [5s Qh 5d Jh] [Qd]
Hero: checks
5ed6f5ab: checks
Hero: shows [7d Ac] (two pair, Queens and Fives)
5ed6f5ab: shows [Ks 7c] (two pair, Queens and Fives)
*** SHOWDOWN ***
Hero collected $0.1 from pot
*** SUMMARY ***
Total pot $0.1 | Rake $0 | Jackpot $0 | Bingo $0 | Fortune $0 | Tax $0
Board [5s Qh 5d Jh Qd]
Seat 1: f9d845b7 (button) folded before Flop (didn't bet)
Seat 2: Hero (small blind) showed [7d Ac] and won ($0.1) with two pair, Queens and Fives
Seat 3: 5ed6f5ab (big blind) showed [Ks 7c] and lost with two pair, Queens and Fives
Seat 4: 84a6e006 folded before Flop (didn't bet)
Seat 5: 3d944e4 folded before Flop (didn't bet)
Seat 6: 722603f4 folded before Flop (didn't bet)


Poker Hand #RC3794709882: Hold'em No Limit ($0.02/$0.05) - 2025/08/09 20:46:38
Table 'RushAndCash10835142' 6-max Seat #1 is the button
Seat 1: 37a73065 ($4.76 in chips)
Seat 2: f3b4b12f ($10.51 in chips)
Seat 3: Hero ($8.69 in chips)
Seat 4: e77308da ($5.84 in chips)
Seat 5: 77df3ce2 ($5 in chips)
Seat 6: eabae1d1 ($5.07 in chips)
f3b4b12f: posts small blind $0.02
Hero: posts big blind $0.05
*** HOLE CARDS ***
Dealt to 37a73065 
Dealt to f3b4b12f 
Dealt to Hero [7s Tc]
Dealt to e77308da 
Dealt to 77df3ce2 
Dealt to eabae1d1 
e77308da: folds
77df3ce2: folds
eabae1d1: raises $0.07 to $0.12
37a73065: raises $0.24 to $0.36
f3b4b12f: folds
Hero: folds
eabae1d1: calls $0.24
*** FLOP *** [9c 9h Qc]
eabae1d1: checks
37a73065: bets $0.27
eabae1d1: calls $0.27
*** TURN *** [9c 9h Qc] [2c]
eabae1d1: checks
37a73065: checks
*** RIVER *** [9c 9h Qc 2c] [6s]
eabae1d1: checks
37a73065: checks
eabae1d1: shows [Jd Jh] (two pair, Jacks and Nines)
37a73065: shows [As Th] (a pair of Nines)
*** SHOWDOWN ***
eabae1d1 collected $1.28 from pot
*** SUMMARY ***
Total pot $1.33 | Rake $0.05 | Jackpot $0 | Bingo $0 | Fortune $0 | Tax $0
Board [9c 9h Qc 2c 6s]
Seat 1: 37a73065 (button) showed [As Th] and lost with a pair of Nines
Seat 2: f3b4b12f (small blind) folded before Flop
Seat 3: Hero (big blind) folded before Flop
Seat 4: e77308da folded before Flop (didn't bet)
Seat 5: 77df3ce2 folded before Flop (didn't bet)
Seat 6: eabae1d1 showed [Jd Jh] and won ($1.28) with two pair, Jacks and Nines


Poker Hand #RC3794709859: Hold'em No Limit ($0.02/$0.05) - 2025/08/09 20:46:35
Table 'RushAndCash10835119' 6-max Seat #1 is the button
Seat 1: 8d5ba14f ($9.97 in chips)
Seat 2: 43ae5181 ($5.41 in chips)
Seat 3: 7ebbd11e ($5.12 in chips)
Seat 4: 37a73065 ($4.76 in chips)
Seat 5: Hero ($8.69 in chips)
Seat 6: 8b6f27db ($9.97 in chips)
43ae5181: posts small blind $0.02
7ebbd11e: posts big blind $0.05
*** HOLE CARDS ***
Dealt to 8d5ba14f 
Dealt to 43ae5181 
Dealt to 7ebbd11e 
Dealt to 37a73065 
Dealt to Hero [Th 3c]
Dealt to 8b6f27db 
37a73065: folds
Hero: folds
8b6f27db: folds
8d5ba14f: folds
43ae5181: folds
Uncalled bet ($0.03) returned to 7ebbd11e
*** SHOWDOWN ***
7ebbd11e collected $0.04 from pot
*** SUMMARY ***
Total pot $0.04 | Rake $0 | Jackpot $0 | Bingo $0 | Fortune $0 | Tax $0
Seat 1: 8d5ba14f (button) folded before Flop (didn't bet)
Seat 2: 43ae5181 (small blind) folded before Flop
Seat 3: 7ebbd11e (big blind) collected ($0.04)
Seat 4: 37a73065 folded before Flop (didn't bet)
Seat 5: Hero folded before Flop (didn't bet)
Seat 6: 8b6f27db folded before Flop (didn't bet)


Poker Hand #RC3794709836: Hold'em No Limit ($0.02/$0.05) - 2025/08/09 20:46:32
Table 'RushAndCash10835096' 6-max Seat #1 is the button
Seat 1: 1468f0ed ($20.88 in chips)
Seat 2: 9bdaa6e3 ($6.63 in chips)
Seat 3: 82d96bf0 ($5.24 in chips)
Seat 4: 119e3298 ($5.02 in chips)
Seat 5: Hero ($8.69 in chips)
Seat 6: dc6cc2d0 ($20.01 in chips)
9bdaa6e3: posts small blind $0.02
82d96bf0: posts big blind $0.05
*** HOLE CARDS ***
Dealt to 1468f0ed 
Dealt to 9bdaa6e3 
Dealt to 82d96bf0 
Dealt to 119e3298 
Dealt to Hero [6d Qc]
Dealt to dc6cc2d0 
119e3298: raises $0.05 to $0.1
Hero: folds
dc6cc2d0: folds
1468f0ed: folds
9bdaa6e3: folds
82d96bf0: folds
Uncalled bet ($0.05) returned to 119e3298
*** SHOWDOWN ***
119e3298 collected $0.12 from pot
*** SUMMARY ***
Total pot $0.12 | Rake $0 | Jackpot $0 | Bingo $0 | Fortune $0 | Tax $0
Seat 1: 1468f0ed (button) folded before Flop (didn't bet)
Seat 2: 9bdaa6e3 (small blind) folded before Flop
Seat 3: 82d96bf0 (big blind) folded before Flop
Seat 4: 119e3298 collected ($0.12)
Seat 5: Hero folded before Flop (didn't bet)
Seat 6: dc6cc2d0 folded before Flop (didn't bet)


Poker Hand #RC3794709814: Hold'em No Limit ($0.02/$0.05) - 2025/08/09 20:46:28
Table 'RushAndCash10835074' 6-max Seat #1 is the button
Seat 1: e040a01e ($5.16 in chips)
Seat 2: 188d9a08 ($11.16 in chips)
Seat 3: 5341707d ($8.67 in chips)
Seat 4: 91850397 ($4.89 in chips)
Seat 5: a66593b ($6.82 in chips)
Seat 6: Hero ($8.69 in chips)
188d9a08: posts small blind $0.02
5341707d: posts big blind $0.05
*** HOLE CARDS ***
Dealt to e040a01e 
Dealt to 188d9a08 
Dealt to 5341707d 
Dealt to 91850397 
Dealt to a66593b 
Dealt to Hero [4d 2s]
91850397: folds
a66593b: folds
Hero: folds
e040a01e: raises $0.05 to $0.1
188d9a08: folds
5341707d: folds
Uncalled bet ($0.05) returned to e040a01e
*** SHOWDOWN ***
e040a01e collected $0.12 from pot
*** SUMMARY ***
Total pot $0.12 | Rake $0 | Jackpot $0 | Bingo $0 | Fortune $0 | Tax $0
Seat 1: e040a01e (button) collected ($0.12)
Seat 2: 188d9a08 (small blind) folded before Flop
Seat 3: 5341707d (big blind) folded before Flop
Seat 4: 91850397 folded before Flop (didn't bet)
Seat 5: a66593b folded before Flop (didn't bet)
Seat 6: Hero folded before Flop (didn't bet)


Poker Hand #RC3794709791: Hold'em No Limit ($0.02/$0.05) - 2025/08/09 20:46:25
Table 'RushAndCash10835051' 6-max Seat #1 is the button
Seat 1: 8edf7521 ($5 in chips)
Seat 2: 30664133 ($7.25 in chips)
Seat 3: 88503d9 ($5.07 in chips)
Seat 4: 4565936a ($7.83 in chips)
Seat 5: Hero ($8.69 in chips)
Seat 6: e1eff718 ($6.46 in chips)
30664133: posts small blind $0.02
88503d9: posts big blind $0.05
*** HOLE CARDS ***
Dealt to 8edf7521 
Dealt to 30664133 
Dealt to 88503d9 
Dealt to 4565936a 
Dealt to Hero [6d 7s]
Dealt to e1eff718 
4565936a: folds
Hero: folds
e1eff718: folds
8edf7521: raises $0.1 to $0.15
30664133: folds
88503d9: folds
Uncalled bet ($0.1) returned to 8edf7521
*** SHOWDOWN ***
8edf7521 collected $0.12 from pot
*** SUMMARY ***
Total pot $0.12 | Rake $0 | Jackpot $0 | Bingo $0 | Fortune $0 | Tax $0
Seat 1: 8edf7521 (button) collected ($0.12)
Seat 2: 30664133 (small blind) folded before Flop
Seat 3: 88503d9 (big blind) folded before Flop
Seat 4: 4565936a folded before Flop (didn't bet)
Seat 5: Hero folded before Flop (didn't bet)
Seat 6: e1eff718 folded before Flop (didn't bet)


Poker Hand #RC3794709731: Hold'em No Limit ($0.02/$0.05) - 2025/08/09 20:46:14
Table 'RushAndCash10834991' 6-max Seat #1 is the button
Seat 1: Hero ($8.69 in chips)
Seat 2: 32ee6ef6 ($5.02 in chips)
Seat 3: e7aeb0ef ($6.28 in chips)
Seat 4: 7fbcff4e ($20.43 in chips)
Seat 5: 8571eb8e ($11.12 in chips)
Seat 6: 54a63178 ($2 in chips)
32ee6ef6: posts small blind $0.02
e7aeb0ef: posts big blind $0.05
*** HOLE CARDS ***
Dealt to Hero [4h Jd]
Dealt to 32ee6ef6 
Dealt to e7aeb0ef 
Dealt to 7fbcff4e 
Dealt to 8571eb8e 
Dealt to 54a63178 
7fbcff4e: raises $0.05 to $0.1
8571eb8e: folds
54a63178: folds
Hero: folds
32ee6ef6: raises $0.34 to $0.44
e7aeb0ef: folds
7fbcff4e: calls $0.34
*** FLOP *** [8d 4s Th]
32ee6ef6: bets $0.48
7fbcff4e: calls $0.48
*** TURN *** [8d 4s Th] [7h]
32ee6ef6: checks
7fbcff4e: bets $0.75
32ee6ef6: calls $0.75
*** RIVER *** [8d 4s Th 7h] [5s]
32ee6ef6: checks
7fbcff4e: checks
32ee6ef6: shows [Js Ts] (a pair of Tens)
7fbcff4e: shows [Qd Qh] (a pair of Queens)
*** SHOWDOWN ***
7fbcff4e collected $3.17 from pot
*** SUMMARY ***
Total pot $3.39 | Rake $0.15 | Jackpot $0.07 | Bingo $0 | Fortune $0 | Tax $0
Board [8d 4s Th 7h 5s]
Seat 1: Hero (button) folded before Flop (didn't bet)
Seat 2: 32ee6ef6 (small blind) showed [Js Ts] and lost with a pair of Tens
Seat 3: e7aeb0ef (big blind) folded before Flop
Seat 4: 7fbcff4e showed [Qd Qh] and won ($3.17) with a pair of Queens
Seat 5: 8571eb8e folded before Flop (didn't bet)
Seat 6: 54a63178 folded before Flop (didn't bet)


Poker Hand #RC3794709627: Hold'em No Limit ($0.02/$0.05) - 2025/08/09 20:45:56
Table 'RushAndCash10834887' 6-max Seat #1 is the button
Seat 1: 61f4c617 ($5.33 in chips)
Seat 2: 5598b6d ($11.91 in chips)
Seat 3: Hero ($8.74 in chips)
Seat 4: e040a01e ($5.25 in chips)
Seat 5: ae99fc2a ($10.42 in chips)
Seat 6: e74908c2 ($6.58 in chips)
5598b6d: posts small blind $0.02
Hero: posts big blind $0.05
*** HOLE CARDS ***
Dealt to 61f4c617 
Dealt to 5598b6d 
Dealt to Hero [Ks Jc]
Dealt to e040a01e 
Dealt to ae99fc2a 
Dealt to e74908c2 
e040a01e: folds
ae99fc2a: folds
e74908c2: folds
61f4c617: raises $0.06 to $0.11
5598b6d: raises $0.21 to $0.32
Hero: folds
61f4c617: calls $0.21
*** FLOP *** [8h Kh 7c]
5598b6d: checks
61f4c617: checks
*** TURN *** [8h Kh 7c] [5s]
5598b6d: checks
61f4c617: checks
*** RIVER *** [8h Kh 7c 5s] [Td]
5598b6d: checks
61f4c617: checks
5598b6d: shows [As Qh] (Ace high)
61f4c617: shows [4d 4s] (a pair of Fours)
*** SHOWDOWN ***
61f4c617 collected $0.66 from pot
*** SUMMARY ***
Total pot $0.69 | Rake $0.03 | Jackpot $0 | Bingo $0 | Fortune $0 | Tax $0
Board [8h Kh 7c 5s Td]
Seat 1: 61f4c617 (button) showed [4d 4s] and won ($0.66) with a pair of Fours
Seat 2: 5598b6d (small blind) showed [As Qh] and lost with Ace high
Seat 3: Hero (big blind) folded before Flop
Seat 4: e040a01e folded before Flop (didn't bet)
Seat 5: ae99fc2a folded before Flop (didn't bet)
Seat 6: e74908c2 folded before Flop (didn't bet)


Poker Hand #RC3794709609: Hold'em No Limit ($0.02/$0.05) - 2025/08/09 20:45:53
Table 'RushAndCash10834869' 6-max Seat #1 is the button
Seat 1: b4adad5 ($2.18 in chips)
Seat 2: Hero ($8.76 in chips)
Seat 3: e74908c2 ($6.63 in chips)
Seat 4: 86014ae5 ($15.67 in chips)
Seat 5: 4bfc47ce ($7.86 in chips)
Seat 6: 19ff753b ($5.2 in chips)
Hero: posts small blind $0.02
e74908c2: posts big blind $0.05
*** HOLE CARDS ***
Dealt to b4adad5 
Dealt to Hero [3c 5s]
Dealt to e74908c2 
Dealt to 86014ae5 
Dealt to 4bfc47ce 
Dealt to 19ff753b 
86014ae5: folds
4bfc47ce: folds
19ff753b: raises $0.05 to $0.1
b4adad5: folds
Hero: folds
e74908c2: folds
Uncalled bet ($0.05) returned to 19ff753b
*** SHOWDOWN ***
19ff753b collected $0.12 from pot
*** SUMMARY ***
Total pot $0.12 | Rake $0 | Jackpot $0 | Bingo $0 | Fortune $0 | Tax $0
Seat 1: b4adad5 (button) folded before Flop (didn't bet)
Seat 2: Hero (small blind) folded before Flop
Seat 3: e74908c2 (big blind) folded before Flop
Seat 4: 86014ae5 folded before Flop (didn't bet)
Seat 5: 4bfc47ce folded before Flop (didn't bet)
Seat 6: 19ff753b collected ($0.12)


Poker Hand #RC3794709587: Hold'em No Limit ($0.02/$0.05) - 2025/08/09 20:45:49
Table 'RushAndCash10834847' 6-max Seat #1 is the button
Seat 1: 57fbb3e ($5.66 in chips)
Seat 2: e040a01e ($5.27 in chips)
Seat 3: c61dce26 ($3.77 in chips)
Seat 4: 5598b6d ($11.91 in chips)
Seat 5: Hero ($8.76 in chips)
Seat 6: 88c522d ($10.5 in chips)
e040a01e: posts small blind $0.02
c61dce26: posts big blind $0.05
*** HOLE CARDS ***
Dealt to 57fbb3e 
Dealt to e040a01e 
Dealt to c61dce26 
Dealt to 5598b6d 
Dealt to Hero [5d 2s]
Dealt to 88c522d 
5598b6d: folds
Hero: folds
88c522d: raises $0.12 to $0.17
57fbb3e: folds
e040a01e: folds
c61dce26: folds
Uncalled bet ($0.12) returned to 88c522d
*** SHOWDOWN ***
88c522d collected $0.12 from pot
*** SUMMARY ***
Total pot $0.12 | Rake $0 | Jackpot $0 | Bingo $0 | Fortune $0 | Tax $0
Seat 1: 57fbb3e (button) folded before Flop (didn't bet)
Seat 2: e040a01e (small blind) folded before Flop
Seat 3: c61dce26 (big blind) folded before Flop
Seat 4: 5598b6d folded before Flop (didn't bet)
Seat 5: Hero folded before Flop (didn't bet)
Seat 6: 88c522d collected ($0.12)


Poker Hand #RC3794709563: Hold'em No Limit ($0.02/$0.05) - 2025/08/09 20:45:45
Table 'RushAndCash10834823' 6-max Seat #1 is the button
Seat 1: f4cc1489 ($7.27 in chips)
Seat 2: bf09af08 ($19.44 in chips)
Seat 3: 576eaca ($5.23 in chips)
Seat 4: Hero ($8.76 in chips)
Seat 5: 57fbb3e ($5.66 in chips)
Seat 6: 476171a5 ($5.95 in chips)
bf09af08: posts small blind $0.02
576eaca: posts big blind $0.05
*** HOLE CARDS ***
Dealt to f4cc1489 
Dealt to bf09af08 
Dealt to 576eaca 
Dealt to Hero [7c 6c]
Dealt to 57fbb3e 
Dealt to 476171a5 
Hero: folds
57fbb3e: folds
476171a5: folds
f4cc1489: raises $0.08 to $0.13
bf09af08: folds
576eaca: folds
Uncalled bet ($0.08) returned to f4cc1489
*** SHOWDOWN ***
f4cc1489 collected $0.12 from pot
*** SUMMARY ***
Total pot $0.12 | Rake $0 | Jackpot $0 | Bingo $0 | Fortune $0 | Tax $0
Seat 1: f4cc1489 (button) collected ($0.12)
Seat 2: bf09af08 (small blind) folded before Flop
Seat 3: 576eaca (big blind) folded before Flop
Seat 4: Hero folded before Flop (didn't bet)
Seat 5: 57fbb3e folded before Flop (didn't bet)
Seat 6: 476171a5 folded before Flop (didn't bet)


Poker Hand #RC3794709542: Hold'em No Limit ($0.02/$0.05) - 2025/08/09 20:45:42
Table 'RushAndCash10834802' 6-max Seat #1 is the button
Seat 1: 6c072f04 ($2.28 in chips)
Seat 2: ac06365f ($5.55 in chips)
Seat 3: 58795b85 ($7.76 in chips)
Seat 4: 829ffb7f ($4.73 in chips)
Seat 5: f4cc1489 ($7.27 in chips)
Seat 6: Hero ($8.76 in chips)
ac06365f: posts small blind $0.02
58795b85: posts big blind $0.05
*** HOLE CARDS ***
Dealt to 6c072f04 
Dealt to ac06365f 
Dealt to 58795b85 
Dealt to 829ffb7f 
Dealt to f4cc1489 
Dealt to Hero [Th 4h]
829ffb7f: raises $0.05 to $0.1
f4cc1489: folds
Hero: folds
6c072f04: calls $0.1
ac06365f: raises $0.46 to $0.56
58795b85: folds
829ffb7f: folds
6c072f04: raises $1.72 to $2.28 and is all-in
ac06365f: calls $1.72
6c072f04: shows [Ks Td]
ac06365f: shows [9h 9d]
*** FIRST FLOP *** [Kc 9s 2d]
*** FIRST TURN *** [Kc 9s 2d] [8c]
*** FIRST RIVER *** [Kc 9s 2d 8c] [6d]
*** SECOND FLOP *** [As 4c 8h]
*** SECOND TURN *** [As 4c 8h] [Kd]
*** SECOND RIVER *** [As 4c 8h Kd] [5h]
*** FIRST SHOWDOWN ***
ac06365f collected $2.25 from pot
*** SECOND SHOWDOWN ***
6c072f04 collected $2.2 from pot
*** SUMMARY ***
Total pot $4.71 | Rake $0.19 | Jackpot $0.07 | Bingo $0 | Fortune $0 | Tax $0
Hand was run two times
FIRST Board [Kc 9s 2d 8c 6d]
SECOND Board [As 4c 8h Kd 5h]
Seat 1: 6c072f04 (button) showed [Ks Td] and lost with a pair of Kings, and won ($2.2) with a pair of Kings
Seat 2: ac06365f (small blind) showed [9h 9d] and won ($2.25) with three of a kind, Nines, and lost with a pair of Nines
Seat 3: 58795b85 (big blind) folded before Flop
Seat 4: 829ffb7f folded before Flop
Seat 5: f4cc1489 folded before Flop (didn't bet)
Seat 6: Hero folded before Flop (didn't bet)


Poker Hand #RC3794709428: Hold'em No Limit ($0.02/$0.05) - 2025/08/09 20:45:23
Table 'RushAndCash10834688' 6-max Seat #1 is the button
Seat 1: cac2a4db ($2.51 in chips)
Seat 2: Hero ($8.71 in chips)
Seat 3: 636fc07b ($6.92 in chips)
Seat 4: 8461206e ($5.02 in chips)
Seat 5: c755210d ($5.13 in chips)
Seat 6: ecf2f7d2 ($2 in chips)
Hero: posts small blind $0.02
636fc07b: posts big blind $0.05
*** HOLE CARDS ***
Dealt to cac2a4db 
Dealt to Hero [Qc 9d]
Dealt to 636fc07b 
Dealt to 8461206e 
Dealt to c755210d 
Dealt to ecf2f7d2 
8461206e: folds
c755210d: folds
ecf2f7d2: folds
cac2a4db: folds
Hero: raises $0.05 to $0.1
636fc07b: folds
Uncalled bet ($0.05) returned to Hero
*** SHOWDOWN ***
Hero collected $0.1 from pot
*** SUMMARY ***
Total pot $0.1 | Rake $0 | Jackpot $0 | Bingo $0 | Fortune $0 | Tax $0
Seat 1: cac2a4db (button) folded before Flop (didn't bet)
Seat 2: Hero (small blind) collected ($0.1)
Seat 3: 636fc07b (big blind) folded before Flop
Seat 4: 8461206e folded before Flop (didn't bet)
Seat 5: c755210d folded before Flop (didn't bet)
Seat 6: ecf2f7d2 folded before Flop (didn't bet)


Poker Hand #RC3794709315: Hold'em No Limit ($0.02/$0.05) - 2025/08/09 20:45:05
Table 'RushAndCash10834575' 6-max Seat #1 is the button
Seat 1: ddaea8e7 ($6.27 in chips)
Seat 2: 99d7f159 ($5 in chips)
Seat 3: Hero ($8.76 in chips)
Seat 4: 86e90fab ($8.22 in chips)
Seat 5: 36655a52 ($6.12 in chips)
Seat 6: 8814b7ca ($5.43 in chips)
99d7f159: posts small blind $0.02
Hero: posts big blind $0.05
*** HOLE CARDS ***
Dealt to ddaea8e7 
Dealt to 99d7f159 
Dealt to Hero [Tc 5d]
Dealt to 86e90fab 
Dealt to 36655a52 
Dealt to 8814b7ca 
86e90fab: folds
36655a52: folds
8814b7ca: folds
ddaea8e7: raises $0.05 to $0.1
99d7f159: raises $0.31 to $0.41
Hero: folds
ddaea8e7: folds
Uncalled bet ($0.31) returned to 99d7f159
*** SHOWDOWN ***
99d7f159 collected $0.24 from pot
*** SUMMARY ***
Total pot $0.25 | Rake $0.01 | Jackpot $0 | Bingo $0 | Fortune $0 | Tax $0
Seat 1: ddaea8e7 (button) folded before Flop
Seat 2: 99d7f159 (small blind) collected ($0.24)
Seat 3: Hero (big blind) folded before Flop
Seat 4: 86e90fab folded before Flop (didn't bet)
Seat 5: 36655a52 folded before Flop (didn't bet)
Seat 6: 8814b7ca folded before Flop (didn't bet)


Poker Hand #RC3794709291: Hold'em No Limit ($0.02/$0.05) - 2025/08/09 20:45:01
Table 'RushAndCash10834551' 6-max Seat #1 is the button
Seat 1: 41aab34e ($12.53 in chips)
Seat 2: e6823301 ($5.26 in chips)
Seat 3: 61fd97e3 ($5.06 in chips)
Seat 4: 54a63178 ($2 in chips)
Seat 5: e74908c2 ($6.49 in chips)
Seat 6: Hero ($8.76 in chips)
e6823301: posts small blind $0.02
61fd97e3: posts big blind $0.05
*** HOLE CARDS ***
Dealt to 41aab34e 
Dealt to e6823301 
Dealt to 61fd97e3 
Dealt to 54a63178 
Dealt to e74908c2 
Dealt to Hero [Th 5h]
54a63178: folds
e74908c2: folds
Hero: folds
41aab34e: raises $0.06 to $0.11
e6823301: folds
61fd97e3: raises $0.39 to $0.5
41aab34e: folds
Uncalled bet ($0.39) returned to 61fd97e3
*** SHOWDOWN ***
61fd97e3 collected $0.23 from pot
*** SUMMARY ***
Total pot $0.24 | Rake $0.01 | Jackpot $0 | Bingo $0 | Fortune $0 | Tax $0
Seat 1: 41aab34e (button) folded before Flop
Seat 2: e6823301 (small blind) folded before Flop
Seat 3: 61fd97e3 (big blind) collected ($0.23)
Seat 4: 54a63178 folded before Flop (didn't bet)
Seat 5: e74908c2 folded before Flop (didn't bet)
Seat 6: Hero folded before Flop (didn't bet)


Poker Hand #RC3794709268: Hold'em No Limit ($0.02/$0.05) - 2025/08/09 20:44:57
Table 'RushAndCash10834528' 6-max Seat #1 is the button
Seat 1: 82d96bf0 ($5.36 in chips)
Seat 2: 74de7472 ($5.61 in chips)
Seat 3: a689b6f3 ($5.12 in chips)
Seat 4: c150727a ($2 in chips)
Seat 5: a11b3695 ($3.57 in chips)
Seat 6: Hero ($8.76 in chips)
74de7472: posts small blind $0.02
a689b6f3: posts big blind $0.05
*** HOLE CARDS ***
Dealt to 82d96bf0 
Dealt to 74de7472 
Dealt to a689b6f3 
Dealt to c150727a 
Dealt to a11b3695 
Dealt to Hero [9c Qd]
c150727a: folds
a11b3695: raises $0.08 to $0.13
Hero: folds
82d96bf0: folds
74de7472: folds
a689b6f3: folds
Uncalled bet ($0.08) returned to a11b3695
*** SHOWDOWN ***
a11b3695 collected $0.12 from pot
*** SUMMARY ***
Total pot $0.12 | Rake $0 | Jackpot $0 | Bingo $0 | Fortune $0 | Tax $0
Seat 1: 82d96bf0 (button) folded before Flop (didn't bet)
Seat 2: 74de7472 (small blind) folded before Flop
Seat 3: a689b6f3 (big blind) folded before Flop
Seat 4: c150727a folded before Flop (didn't bet)
Seat 5: a11b3695 collected ($0.12)
Seat 6: Hero folded before Flop (didn't bet)


Poker Hand #RC3794708983: Hold'em No Limit ($0.02/$0.05) - 2025/08/09 20:44:15
Table 'RushAndCash10834243' 6-max Seat #1 is the button
Seat 1: Hero ($8.86 in chips)
Seat 2: 78147f30 ($9.52 in chips)
Seat 3: 74de7472 ($5 in chips)
Seat 4: 84a6e006 ($5 in chips)
Seat 5: f8f4c659 ($5.09 in chips)
Seat 6: 9a37ad73 ($5 in chips)
78147f30: posts small blind $0.02
74de7472: posts big blind $0.05
*** HOLE CARDS ***
Dealt to Hero [Td 6d]
Dealt to 78147f30 
Dealt to 74de7472 
Dealt to 84a6e006 
Dealt to f8f4c659 
Dealt to 9a37ad73 
84a6e006: folds
f8f4c659: folds
9a37ad73: folds
Hero: raises $0.05 to $0.1
78147f30: raises $0.45 to $0.55
74de7472: raises $0.7 to $1.25
Hero: folds
78147f30: folds
Uncalled bet ($0.7) returned to 74de7472
*** SHOWDOWN ***
74de7472 collected $1.16 from pot
*** SUMMARY ***
Total pot $1.2 | Rake $0.04 | Jackpot $0 | Bingo $0 | Fortune $0 | Tax $0
Seat 1: Hero (button) folded before Flop
Seat 2: 78147f30 (small blind) folded before Flop
Seat 3: 74de7472 (big blind) collected ($1.16)
Seat 4: 84a6e006 folded before Flop (didn't bet)
Seat 5: f8f4c659 folded before Flop (didn't bet)
Seat 6: 9a37ad73 folded before Flop (didn't bet)


Poker Hand #RC3794708280: Hold'em No Limit ($0.02/$0.05) - 2025/08/09 20:42:19
Table 'RushAndCash10833540' 6-max Seat #1 is the button
Seat 1: 60d1140d ($5.69 in chips)
Seat 2: 7d6169ad ($5.24 in chips)
Seat 3: Hero ($8.29 in chips)
Seat 4: 78147f30 ($10.13 in chips)
Seat 5: 1c648a7f ($5.09 in chips)
Seat 6: e367b091 ($8.64 in chips)
7d6169ad: posts small blind $0.02
Hero: posts big blind $0.05
*** HOLE CARDS ***
Dealt to 60d1140d 
Dealt to 7d6169ad 
Dealt to Hero [Ac Qd]
Dealt to 78147f30 
Dealt to 1c648a7f 
Dealt to e367b091 
78147f30: raises $0.05 to $0.1
1c648a7f: folds
e367b091: folds
60d1140d: folds
7d6169ad: folds
Hero: raises $0.26 to $0.36
78147f30: calls $0.26
*** FLOP *** [Qh 2h Ts]
Hero: checks
78147f30: bets $0.25
Hero: calls $0.25
*** TURN *** [Qh 2h Ts] [Jd]
Hero: checks
78147f30: checks
*** RIVER *** [Qh 2h Ts Jd] [5d]
Hero: bets $0.97
78147f30: folds
Uncalled bet ($0.97) returned to Hero
*** SHOWDOWN ***
Hero collected $1.18 from pot
*** SUMMARY ***
Total pot $1.24 | Rake $0.06 | Jackpot $0 | Bingo $0 | Fortune $0 | Tax $0
Board [Qh 2h Ts Jd 5d]
Seat 1: 60d1140d (button) folded before Flop (didn't bet)
Seat 2: 7d6169ad (small blind) folded before Flop
Seat 3: Hero (big blind) won ($1.18)
Seat 4: 78147f30 folded on the River
Seat 5: 1c648a7f folded before Flop (didn't bet)
Seat 6: e367b091 folded before Flop (didn't bet)


Poker Hand #RC3794708250: Hold'em No Limit ($0.02/$0.05) - 2025/08/09 20:42:14
Table 'RushAndCash10833510' 6-max Seat #1 is the button
Seat 1: 7be8f7d0 ($6.07 in chips)
Seat 2: Hero ($8.31 in chips)
Seat 3: 18cfc69e ($5.85 in chips)
Seat 4: d45ab85a ($5 in chips)
Seat 5: 16f3f681 ($6.87 in chips)
Seat 6: 6297aa54 ($5.93 in chips)
Hero: posts small blind $0.02
18cfc69e: posts big blind $0.05
*** HOLE CARDS ***
Dealt to 7be8f7d0 
Dealt to Hero [6h 7d]
Dealt to 18cfc69e 
Dealt to d45ab85a 
Dealt to 16f3f681 
Dealt to 6297aa54 
d45ab85a: folds
16f3f681: folds
6297aa54: folds
7be8f7d0: folds
Hero: folds
Uncalled bet ($0.03) returned to 18cfc69e
*** SHOWDOWN ***
18cfc69e collected $0.04 from pot
*** SUMMARY ***
Total pot $0.04 | Rake $0 | Jackpot $0 | Bingo $0 | Fortune $0 | Tax $0
Seat 1: 7be8f7d0 (button) folded before Flop (didn't bet)
Seat 2: Hero (small blind) folded before Flop
Seat 3: 18cfc69e (big blind) collected ($0.04)
Seat 4: d45ab85a folded before Flop (didn't bet)
Seat 5: 16f3f681 folded before Flop (didn't bet)
Seat 6: 6297aa54 folded before Flop (didn't bet)


Poker Hand #RC3794708201: Hold'em No Limit ($0.02/$0.05) - 2025/08/09 20:42:07
Table 'RushAndCash10833461' 6-max Seat #1 is the button
Seat 1: Hero ($8.31 in chips)
Seat 2: cac2a4db ($2.26 in chips)
Seat 3: 9b1b2e9d ($5.81 in chips)
Seat 4: f1ee3f3d ($8.94 in chips)
Seat 5: d45ab85a ($5 in chips)
Seat 6: 6ac5bc1b ($8.42 in chips)
cac2a4db: posts small blind $0.02
9b1b2e9d: posts big blind $0.05
*** HOLE CARDS ***
Dealt to Hero [9h 3h]
Dealt to cac2a4db 
Dealt to 9b1b2e9d 
Dealt to f1ee3f3d 
Dealt to d45ab85a 
Dealt to 6ac5bc1b 
f1ee3f3d: folds
d45ab85a: folds
6ac5bc1b: folds
Hero: folds
cac2a4db: raises $0.13 to $0.18
9b1b2e9d: folds
Uncalled bet ($0.13) returned to cac2a4db
*** SHOWDOWN ***
cac2a4db collected $0.1 from pot
*** SUMMARY ***
Total pot $0.1 | Rake $0 | Jackpot $0 | Bingo $0 | Fortune $0 | Tax $0
Seat 1: Hero (button) folded before Flop (didn't bet)
Seat 2: cac2a4db (small blind) collected ($0.1)
Seat 3: 9b1b2e9d (big blind) folded before Flop
Seat 4: f1ee3f3d folded before Flop (didn't bet)
Seat 5: d45ab85a folded before Flop (didn't bet)
Seat 6: 6ac5bc1b folded before Flop (didn't bet)


Poker Hand #RC3794708176: Hold'em No Limit ($0.02/$0.05) - 2025/08/09 20:42:03
Table 'RushAndCash10833436' 6-max Seat #1 is the button
Seat 1: 7a6ee12b ($27.94 in chips)
Seat 2: 76211edb ($6.04 in chips)
Seat 3: f089b1b1 ($5.3 in chips)
Seat 4: 9b1b2e9d ($5.81 in chips)
Seat 5: 330c7c84 ($5.15 in chips)
Seat 6: Hero ($8.31 in chips)
76211edb: posts small blind $0.02
f089b1b1: posts big blind $0.05
*** HOLE CARDS ***
Dealt to 7a6ee12b 
Dealt to 76211edb 
Dealt to f089b1b1 
Dealt to 9b1b2e9d 
Dealt to 330c7c84 
Dealt to Hero [2h Kc]
9b1b2e9d: folds
330c7c84: folds
Hero: folds
7a6ee12b: folds
76211edb: folds
Uncalled bet ($0.03) returned to f089b1b1
*** SHOWDOWN ***
f089b1b1 collected $0.04 from pot
*** SUMMARY ***
Total pot $0.04 | Rake $0 | Jackpot $0 | Bingo $0 | Fortune $0 | Tax $0
Seat 1: 7a6ee12b (button) folded before Flop (didn't bet)
Seat 2: 76211edb (small blind) folded before Flop
Seat 3: f089b1b1 (big blind) collected ($0.04)
Seat 4: 9b1b2e9d folded before Flop (didn't bet)
Seat 5: 330c7c84 folded before Flop (didn't bet)
Seat 6: Hero folded before Flop (didn't bet)


Poker Hand #RC3794708152: Hold'em No Limit ($0.02/$0.05) - 2025/08/09 20:42:00
Table 'RushAndCash10833412' 6-max Seat #1 is the button
Seat 1: 86014ae5 ($15.46 in chips)
Seat 2: 3220ff6a ($10.56 in chips)
Seat 3: d4b45183 ($5 in chips)
Seat 4: Hero ($8.31 in chips)
Seat 5: 2813af0a ($2.87 in chips)
Seat 6: 7a68c171 ($8.83 in chips)
3220ff6a: posts small blind $0.02
d4b45183: posts big blind $0.05
*** HOLE CARDS ***
Dealt to 86014ae5 
Dealt to 3220ff6a 
Dealt to d4b45183 
Dealt to Hero [7d 6s]
Dealt to 2813af0a 
Dealt to 7a68c171 
Hero: folds
2813af0a: folds
7a68c171: folds
86014ae5: folds
3220ff6a: folds
Uncalled bet ($0.03) returned to d4b45183
*** SHOWDOWN ***
d4b45183 collected $0.04 from pot
*** SUMMARY ***
Total pot $0.04 | Rake $0 | Jackpot $0 | Bingo $0 | Fortune $0 | Tax $0
Seat 1: 86014ae5 (button) folded before Flop (didn't bet)
Seat 2: 3220ff6a (small blind) folded before Flop
Seat 3: d4b45183 (big blind) collected ($0.04)
Seat 4: Hero folded before Flop (didn't bet)
Seat 5: 2813af0a folded before Flop (didn't bet)
Seat 6: 7a68c171 folded before Flop (didn't bet)


Poker Hand #RC3794708128: Hold'em No Limit ($0.02/$0.05) - 2025/08/09 20:41:56
Table 'RushAndCash10833388' 6-max Seat #1 is the button
Seat 1: 73b3b06b ($5 in chips)
Seat 2: 6aa1d0de ($5.32 in chips)
Seat 3: fe8c7c0 ($5.07 in chips)
Seat 4: 792d9d61 ($2 in chips)
Seat 5: Hero ($8.31 in chips)
Seat 6: 6dcc14c7 ($5.53 in chips)
6aa1d0de: posts small blind $0.02
fe8c7c0: posts big blind $0.05
*** HOLE CARDS ***
Dealt to 73b3b06b 
Dealt to 6aa1d0de 
Dealt to fe8c7c0 
Dealt to 792d9d61 
Dealt to Hero [9c Kh]
Dealt to 6dcc14c7 
792d9d61: folds
Hero: folds
6dcc14c7: folds
73b3b06b: folds
6aa1d0de: folds
Uncalled bet ($0.03) returned to fe8c7c0
*** SHOWDOWN ***
fe8c7c0 collected $0.04 from pot
*** SUMMARY ***
Total pot $0.04 | Rake $0 | Jackpot $0 | Bingo $0 | Fortune $0 | Tax $0
Seat 1: 73b3b06b (button) folded before Flop (didn't bet)
Seat 2: 6aa1d0de (small blind) folded before Flop
Seat 3: fe8c7c0 (big blind) collected ($0.04)
Seat 4: 792d9d61 folded before Flop (didn't bet)
Seat 5: Hero folded before Flop (didn't bet)
Seat 6: 6dcc14c7 folded before Flop (didn't bet)


Poker Hand #RC3794708103: Hold'em No Limit ($0.02/$0.05) - 2025/08/09 20:41:52
Table 'RushAndCash10833363' 6-max Seat #1 is the button
Seat 1: 915746c1 ($9.81 in chips)
Seat 2: 244640eb ($5.58 in chips)
Seat 3: 369c563b ($5.84 in chips)
Seat 4: 139381a3 ($5.14 in chips)
Seat 5: Hero ($8.31 in chips)
Seat 6: 83a6192e ($8.69 in chips)
244640eb: posts small blind $0.02
369c563b: posts big blind $0.05
*** HOLE CARDS ***
Dealt to 915746c1 
Dealt to 244640eb 
Dealt to 369c563b 
Dealt to 139381a3 
Dealt to Hero [2c 2s]
Dealt to 83a6192e 
139381a3: raises $0.05 to $0.1
Hero: folds
83a6192e: raises $0.21 to $0.31
915746c1: raises $0.6 to $0.91
244640eb: folds
369c563b: folds
139381a3: folds
83a6192e: calls $0.6
*** FLOP *** [9h 5h 8h]
83a6192e: checks
915746c1: checks
*** TURN *** [9h 5h 8h] [Qc]
83a6192e: bets $0.66
915746c1: calls $0.66
*** RIVER *** [9h 5h 8h Qc] [7s]
83a6192e: bets $4.31
915746c1: folds
Uncalled bet ($4.31) returned to 83a6192e
*** SHOWDOWN ***
83a6192e collected $3.09 from pot
*** SUMMARY ***
Total pot $3.31 | Rake $0.15 | Jackpot $0.07 | Bingo $0 | Fortune $0 | Tax $0
Board [9h 5h 8h Qc 7s]
Seat 1: 915746c1 (button) folded on the River
Seat 2: 244640eb (small blind) folded before Flop
Seat 3: 369c563b (big blind) folded before Flop
Seat 4: 139381a3 folded before Flop
Seat 5: Hero folded before Flop (didn't bet)
Seat 6: 83a6192e won ($3.09)


Poker Hand #RC3794708078: Hold'em No Limit ($0.02/$0.05) - 2025/08/09 20:41:49
Table 'RushAndCash10833338' 6-max Seat #1 is the button
Seat 1: 96e8c78e ($5.36 in chips)
Seat 2: dac36cfe ($6.01 in chips)
Seat 3: 566a0a3d ($5.23 in chips)
Seat 4: 244640eb ($5.58 in chips)
Seat 5: Hero ($8.31 in chips)
Seat 6: 5ed6f5ab ($5 in chips)
dac36cfe: posts small blind $0.02
566a0a3d: posts big blind $0.05
*** HOLE CARDS ***
Dealt to 96e8c78e 
Dealt to dac36cfe 
Dealt to 566a0a3d 
Dealt to 244640eb 
Dealt to Hero [9c Qh]
Dealt to 5ed6f5ab 
244640eb: folds
Hero: folds
5ed6f5ab: raises $0.05 to $0.1
96e8c78e: folds
dac36cfe: calls $0.08
566a0a3d: raises $0.6 to $0.7
5ed6f5ab: folds
dac36cfe: folds
Uncalled bet ($0.6) returned to 566a0a3d
*** SHOWDOWN ***
566a0a3d collected $0.29 from pot
*** SUMMARY ***
Total pot $0.3 | Rake $0.01 | Jackpot $0 | Bingo $0 | Fortune $0 | Tax $0
Seat 1: 96e8c78e (button) folded before Flop (didn't bet)
Seat 2: dac36cfe (small blind) folded before Flop
Seat 3: 566a0a3d (big blind) collected ($0.29)
Seat 4: 244640eb folded before Flop (didn't bet)
Seat 5: Hero folded before Flop (didn't bet)
Seat 6: 5ed6f5ab folded before Flop


Poker Hand #RC3794708020: Hold'em No Limit ($0.02/$0.05) - 2025/08/09 20:41:40
Table 'RushAndCash10833280' 6-max Seat #1 is the button
Seat 1: 79ca254c ($6.05 in chips)
Seat 2: f9619147 ($11.36 in chips)
Seat 3: Hero ($8.29 in chips)
Seat 4: cc6d0af5 ($9.78 in chips)
Seat 5: e608b61d ($5.96 in chips)
Seat 6: 4565936a ($10.19 in chips)
f9619147: posts small blind $0.02
Hero: posts big blind $0.05
*** HOLE CARDS ***
Dealt to 79ca254c 
Dealt to f9619147 
Dealt to Hero [Qd Ts]
Dealt to cc6d0af5 
Dealt to e608b61d 
Dealt to 4565936a 
cc6d0af5: folds
e608b61d: folds
4565936a: folds
79ca254c: folds
f9619147: folds
Uncalled bet ($0.03) returned to Hero
*** SHOWDOWN ***
Hero collected $0.04 from pot
*** SUMMARY ***
Total pot $0.04 | Rake $0 | Jackpot $0 | Bingo $0 | Fortune $0 | Tax $0
Seat 1: 79ca254c (button) folded before Flop (didn't bet)
Seat 2: f9619147 (small blind) folded before Flop
Seat 3: Hero (big blind) collected ($0.04)
Seat 4: cc6d0af5 folded before Flop (didn't bet)
Seat 5: e608b61d folded before Flop (didn't bet)
Seat 6: 4565936a folded before Flop (didn't bet)


Poker Hand #RC3794707979: Hold'em No Limit ($0.02/$0.05) - 2025/08/09 20:41:34
Table 'RushAndCash10833239' 6-max Seat #1 is the button
Seat 1: Hero ($8.29 in chips)
Seat 2: e7aeb0ef ($6.66 in chips)
Seat 3: dac36cfe ($5.99 in chips)
Seat 4: 60c6f1bd ($12.19 in chips)
Seat 5: 67bcd014 ($9.74 in chips)
Seat 6: 25fc7652 ($8.64 in chips)
e7aeb0ef: posts small blind $0.02
dac36cfe: posts big blind $0.05
*** HOLE CARDS ***
Dealt to Hero [Qd 8c]
Dealt to e7aeb0ef 
Dealt to dac36cfe 
Dealt to 60c6f1bd 
Dealt to 67bcd014 
Dealt to 25fc7652 
60c6f1bd: folds
67bcd014: folds
25fc7652: folds
Hero: folds
e7aeb0ef: folds
Uncalled bet ($0.03) returned to dac36cfe
*** SHOWDOWN ***
dac36cfe collected $0.04 from pot
*** SUMMARY ***
Total pot $0.04 | Rake $0 | Jackpot $0 | Bingo $0 | Fortune $0 | Tax $0
Seat 1: Hero (button) folded before Flop (didn't bet)
Seat 2: e7aeb0ef (small blind) folded before Flop
Seat 3: dac36cfe (big blind) collected ($0.04)
Seat 4: 60c6f1bd folded before Flop (didn't bet)
Seat 5: 67bcd014 folded before Flop (didn't bet)
Seat 6: 25fc7652 folded before Flop (didn't bet)


Poker Hand #RC3794707944: Hold'em No Limit ($0.02/$0.05) - 2025/08/09 20:41:29
Table 'RushAndCash10833204' 6-max Seat #1 is the button
Seat 1: 56bee3fc ($5.04 in chips)
Seat 2: 86e90fab ($8.17 in chips)
Seat 3: 2b7992bd ($5.09 in chips)
Seat 4: Hero ($8.29 in chips)
Seat 5: 94769ee ($8.4 in chips)
Seat 6: cac2a4db ($2.12 in chips)
86e90fab: posts small blind $0.02
2b7992bd: posts big blind $0.05
*** HOLE CARDS ***
Dealt to 56bee3fc 
Dealt to 86e90fab 
Dealt to 2b7992bd 
Dealt to Hero [3c 5s]
Dealt to 94769ee 
Dealt to cac2a4db 
Hero: folds
94769ee: folds
cac2a4db: folds
56bee3fc: folds
86e90fab: folds
Uncalled bet ($0.03) returned to 2b7992bd
*** SHOWDOWN ***
2b7992bd collected $0.04 from pot
*** SUMMARY ***
Total pot $0.04 | Rake $0 | Jackpot $0 | Bingo $0 | Fortune $0 | Tax $0
Seat 1: 56bee3fc (button) folded before Flop (didn't bet)
Seat 2: 86e90fab (small blind) folded before Flop
Seat 3: 2b7992bd (big blind) collected ($0.04)
Seat 4: Hero folded before Flop (didn't bet)
Seat 5: 94769ee folded before Flop (didn't bet)
Seat 6: cac2a4db folded before Flop (didn't bet)


Poker Hand #RC3794707844: Hold'em No Limit ($0.02/$0.05) - 2025/08/09 20:41:14
Table 'RushAndCash10833104' 6-max Seat #1 is the button
Seat 1: 95e696fc ($5.52 in chips)
Seat 2: 96e1967a ($5 in chips)
Seat 3: Hero ($8.34 in chips)
Seat 4: 5107ce24 ($2.47 in chips)
Seat 5: da431f83 ($11.39 in chips)
Seat 6: 40bc30b8 ($6.49 in chips)
96e1967a: posts small blind $0.02
Hero: posts big blind $0.05
*** HOLE CARDS ***
Dealt to 95e696fc 
Dealt to 96e1967a 
Dealt to Hero [3s 7c]
Dealt to 5107ce24 
Dealt to da431f83 
Dealt to 40bc30b8 
5107ce24: raises $0.05 to $0.1
da431f83: folds
40bc30b8: folds
95e696fc: folds
96e1967a: folds
Hero: folds
Uncalled bet ($0.05) returned to 5107ce24
*** SHOWDOWN ***
5107ce24 collected $0.12 from pot
*** SUMMARY ***
Total pot $0.12 | Rake $0 | Jackpot $0 | Bingo $0 | Fortune $0 | Tax $0
Seat 1: 95e696fc (button) folded before Flop (didn't bet)
Seat 2: 96e1967a (small blind) folded before Flop
Seat 3: Hero (big blind) folded before Flop
Seat 4: 5107ce24 collected ($0.12)
Seat 5: da431f83 folded before Flop (didn't bet)
Seat 6: 40bc30b8 folded before Flop (didn't bet)


Poker Hand #RC3794707787: Hold'em No Limit ($0.02/$0.05) - 2025/08/09 20:41:05
Table 'RushAndCash10833047' 6-max Seat #1 is the button
Seat 1: Hero ($8.34 in chips)
Seat 2: e850eac7 ($5 in chips)
Seat 3: 6aa1d0de ($5.35 in chips)
Seat 4: 862bbf4 ($5.04 in chips)
Seat 5: 68e76e87 ($6.06 in chips)
Seat 6: 76ef6bc6 ($6.82 in chips)
e850eac7: posts small blind $0.02
6aa1d0de: posts big blind $0.05
*** HOLE CARDS ***
Dealt to Hero [Js 3h]
Dealt to e850eac7 
Dealt to 6aa1d0de 
Dealt to 862bbf4 
Dealt to 68e76e87 
Dealt to 76ef6bc6 
862bbf4: folds
68e76e87: folds
76ef6bc6: folds
Hero: folds
e850eac7: folds
Uncalled bet ($0.03) returned to 6aa1d0de
*** SHOWDOWN ***
6aa1d0de collected $0.04 from pot
*** SUMMARY ***
Total pot $0.04 | Rake $0 | Jackpot $0 | Bingo $0 | Fortune $0 | Tax $0
Seat 1: Hero (button) folded before Flop (didn't bet)
Seat 2: e850eac7 (small blind) folded before Flop
Seat 3: 6aa1d0de (big blind) collected ($0.04)
Seat 4: 862bbf4 folded before Flop (didn't bet)
Seat 5: 68e76e87 folded before Flop (didn't bet)
Seat 6: 76ef6bc6 folded before Flop (didn't bet)


Poker Hand #RC3794707765: Hold'em No Limit ($0.02/$0.05) - 2025/08/09 20:41:02
Table 'RushAndCash10833025' 6-max Seat #1 is the button
Seat 1: 6ac5bc1b ($7.82 in chips)
Seat 2: 17f014c8 ($5.35 in chips)
Seat 3: 74de7472 ($5 in chips)
Seat 4: 564c3a6e ($5.86 in chips)
Seat 5: Hero ($8.34 in chips)
Seat 6: 7d23353b ($9.47 in chips)
17f014c8: posts small blind $0.02
74de7472: posts big blind $0.05
*** HOLE CARDS ***
Dealt to 6ac5bc1b 
Dealt to 17f014c8 
Dealt to 74de7472 
Dealt to 564c3a6e 
Dealt to Hero [Jd 6h]
Dealt to 7d23353b 
564c3a6e: folds
Hero: folds
7d23353b: raises $0.1 to $0.15
6ac5bc1b: folds
17f014c8: raises $0.5 to $0.65
74de7472: folds
7d23353b: folds
Uncalled bet ($0.5) returned to 17f014c8
*** SHOWDOWN ***
17f014c8 collected $0.34 from pot
*** SUMMARY ***
Total pot $0.35 | Rake $0.01 | Jackpot $0 | Bingo $0 | Fortune $0 | Tax $0
Seat 1: 6ac5bc1b (button) folded before Flop (didn't bet)
Seat 2: 17f014c8 (small blind) collected ($0.34)
Seat 3: 74de7472 (big blind) folded before Flop
Seat 4: 564c3a6e folded before Flop (didn't bet)
Seat 5: Hero folded before Flop (didn't bet)
Seat 6: 7d23353b folded before Flop


Poker Hand #RC3794707734: Hold'em No Limit ($0.02/$0.05) - 2025/08/09 20:40:56
Table 'RushAndCash10832994' 6-max Seat #1 is the button
Seat 1: e4cddcac ($5.14 in chips)
Seat 2: Hero ($8.36 in chips)
Seat 3: 12fd5edb ($7.84 in chips)
Seat 4: 137d687a ($7.72 in chips)
Seat 5: e30cadfa ($5.17 in chips)
Seat 6: fe8c7c0 ($5 in chips)
Hero: posts small blind $0.02
12fd5edb: posts big blind $0.05
*** HOLE CARDS ***
Dealt to e4cddcac 
Dealt to Hero [3d Kh]
Dealt to 12fd5edb 
Dealt to 137d687a 
Dealt to e30cadfa 
Dealt to fe8c7c0 
137d687a: folds
e30cadfa: folds
fe8c7c0: folds
e4cddcac: folds
Hero: folds
Uncalled bet ($0.03) returned to 12fd5edb
*** SHOWDOWN ***
12fd5edb collected $0.04 from pot
*** SUMMARY ***
Total pot $0.04 | Rake $0 | Jackpot $0 | Bingo $0 | Fortune $0 | Tax $0
Seat 1: e4cddcac (button) folded before Flop (didn't bet)
Seat 2: Hero (small blind) folded before Flop
Seat 3: 12fd5edb (big blind) collected ($0.04)
Seat 4: 137d687a folded before Flop (didn't bet)
Seat 5: e30cadfa folded before Flop (didn't bet)
Seat 6: fe8c7c0 folded before Flop (didn't bet)


Poker Hand #RC3794707596: Hold'em No Limit ($0.02/$0.05) - 2025/08/09 20:40:34
Table 'RushAndCash10832856' 6-max Seat #1 is the button
Seat 1: 88c522d ($5 in chips)
Seat 2: Hero ($8.31 in chips)
Seat 3: f3b4b12f ($10.36 in chips)
Seat 4: 79ca254c ($6.13 in chips)
Seat 5: 93caec3a ($5.37 in chips)
Seat 6: 82001fdc ($2.9 in chips)
Hero: posts small blind $0.02
f3b4b12f: posts big blind $0.05
*** HOLE CARDS ***
Dealt to 88c522d 
Dealt to Hero [7h Ad]
Dealt to f3b4b12f 
Dealt to 79ca254c 
Dealt to 93caec3a 
Dealt to 82001fdc 
79ca254c: folds
93caec3a: folds
82001fdc: folds
88c522d: folds
Hero: calls $0.03
f3b4b12f: checks
*** FLOP *** [Kh 2h 7s]
Hero: checks
f3b4b12f: checks
*** TURN *** [Kh 2h 7s] [3h]
Hero: bets $0.08
f3b4b12f: folds
Uncalled bet ($0.08) returned to Hero
*** SHOWDOWN ***
Hero collected $0.1 from pot
*** SUMMARY ***
Total pot $0.1 | Rake $0 | Jackpot $0 | Bingo $0 | Fortune $0 | Tax $0
Board [Kh 2h 7s 3h]
Seat 1: 88c522d (button) folded before Flop (didn't bet)
Seat 2: Hero (small blind) won ($0.1)
Seat 3: f3b4b12f (big blind) folded on the Turn
Seat 4: 79ca254c folded before Flop (didn't bet)
Seat 5: 93caec3a folded before Flop (didn't bet)
Seat 6: 82001fdc folded before Flop (didn't bet)


Poker Hand #RC3794707568: Hold'em No Limit ($0.02/$0.05) - 2025/08/09 20:40:30
Table 'RushAndCash10832828' 6-max Seat #1 is the button
Seat 1: ca2c4d02 ($5 in chips)
Seat 2: 722603f4 ($23.46 in chips)
Seat 3: 3515fb39 ($5.22 in chips)
Seat 4: 43ec0d17 ($5.07 in chips)
Seat 5: Hero ($8.31 in chips)
Seat 6: 8e319cf8 ($5.63 in chips)
722603f4: posts small blind $0.02
3515fb39: posts big blind $0.05
*** HOLE CARDS ***
Dealt to ca2c4d02 
Dealt to 722603f4 
Dealt to 3515fb39 
Dealt to 43ec0d17 
Dealt to Hero [8d Qh]
Dealt to 8e319cf8 
43ec0d17: folds
Hero: folds
8e319cf8: folds
ca2c4d02: raises $0.07 to $0.12
722603f4: folds
3515fb39: calls $0.07
*** FLOP *** [9h 2h 6s]
3515fb39: checks
ca2c4d02: bets $0.1
3515fb39: folds
Uncalled bet ($0.1) returned to ca2c4d02
*** SHOWDOWN ***
ca2c4d02 collected $0.25 from pot
*** SUMMARY ***
Total pot $0.26 | Rake $0.01 | Jackpot $0 | Bingo $0 | Fortune $0 | Tax $0
Board [9h 2h 6s]
Seat 1: ca2c4d02 (button) won ($0.25)
Seat 2: 722603f4 (small blind) folded before Flop
Seat 3: 3515fb39 (big blind) folded on the Flop
Seat 4: 43ec0d17 folded before Flop (didn't bet)
Seat 5: Hero folded before Flop (didn't bet)
Seat 6: 8e319cf8 folded before Flop (didn't bet)


Poker Hand #RC3794707543: Hold'em No Limit ($0.02/$0.05) - 2025/08/09 20:40:26
Table 'RushAndCash10832803' 6-max Seat #1 is the button
Seat 1: 4d9bdcc ($10.29 in chips)
Seat 2: ff77eb99 ($7.71 in chips)
Seat 3: 216d3aab ($5.81 in chips)
Seat 4: 6b2102fe ($26.61 in chips)
Seat 5: Hero ($8.31 in chips)
Seat 6: 2c2e56bc ($7.99 in chips)
ff77eb99: posts small blind $0.02
216d3aab: posts big blind $0.05
*** HOLE CARDS ***
Dealt to 4d9bdcc 
Dealt to ff77eb99 
Dealt to 216d3aab 
Dealt to 6b2102fe 
Dealt to Hero [7s Qh]
Dealt to 2c2e56bc 
6b2102fe: raises $0.08 to $0.13
Hero: folds
2c2e56bc: folds
4d9bdcc: folds
ff77eb99: folds
216d3aab: folds
Uncalled bet ($0.08) returned to 6b2102fe
*** SHOWDOWN ***
6b2102fe collected $0.12 from pot
*** SUMMARY ***
Total pot $0.12 | Rake $0 | Jackpot $0 | Bingo $0 | Fortune $0 | Tax $0
Seat 1: 4d9bdcc (button) folded before Flop (didn't bet)
Seat 2: ff77eb99 (small blind) folded before Flop
Seat 3: 216d3aab (big blind) folded before Flop
Seat 4: 6b2102fe collected ($0.12)
Seat 5: Hero folded before Flop (didn't bet)
Seat 6: 2c2e56bc folded before Flop (didn't bet)


Poker Hand #RC3794707519: Hold'em No Limit ($0.02/$0.05) - 2025/08/09 20:40:23
Table 'RushAndCash10832779' 6-max Seat #1 is the button
Seat 1: 8c1a1f90 ($5.22 in chips)
Seat 2: 4d9bdcc ($10.31 in chips)
Seat 3: e285caaf ($5.63 in chips)
Seat 4: Hero ($8.31 in chips)
Seat 5: e1e6a6ec ($5.12 in chips)
Seat 6: 9ad0155e ($5 in chips)
4d9bdcc: posts small blind $0.02
e285caaf: posts big blind $0.05
*** HOLE CARDS ***
Dealt to 8c1a1f90 
Dealt to 4d9bdcc 
Dealt to e285caaf 
Dealt to Hero [6d Th]
Dealt to e1e6a6ec 
Dealt to 9ad0155e 
Hero: folds
e1e6a6ec: folds
9ad0155e: raises $0.07 to $0.12
8c1a1f90: folds
4d9bdcc: folds
e285caaf: folds
Uncalled bet ($0.07) returned to 9ad0155e
*** SHOWDOWN ***
9ad0155e collected $0.12 from pot
*** SUMMARY ***
Total pot $0.12 | Rake $0 | Jackpot $0 | Bingo $0 | Fortune $0 | Tax $0
Seat 1: 8c1a1f90 (button) folded before Flop (didn't bet)
Seat 2: 4d9bdcc (small blind) folded before Flop
Seat 3: e285caaf (big blind) folded before Flop
Seat 4: Hero folded before Flop (didn't bet)
Seat 5: e1e6a6ec folded before Flop (didn't bet)
Seat 6: 9ad0155e collected ($0.12)


Poker Hand #RC3794707489: Hold'em No Limit ($0.02/$0.05) - 2025/08/09 20:40:19
Table 'RushAndCash10832749' 6-max Seat #1 is the button
Seat 1: Hero ($8.31 in chips)
Seat 2: 43ec0d17 ($5.09 in chips)
Seat 3: 82d96bf0 ($7.16 in chips)
Seat 4: 196ab49 ($6.65 in chips)
Seat 5: 188d9a08 ($10.27 in chips)
Seat 6: 7f521697 ($10.43 in chips)
43ec0d17: posts small blind $0.02
82d96bf0: posts big blind $0.05
*** HOLE CARDS ***
Dealt to Hero [Qd 8d]
Dealt to 43ec0d17 
Dealt to 82d96bf0 
Dealt to 196ab49 
Dealt to 188d9a08 
Dealt to 7f521697 
196ab49: folds
188d9a08: folds
7f521697: folds
Hero: folds
43ec0d17: folds
Uncalled bet ($0.03) returned to 82d96bf0
*** SHOWDOWN ***
82d96bf0 collected $0.04 from pot
*** SUMMARY ***
Total pot $0.04 | Rake $0 | Jackpot $0 | Bingo $0 | Fortune $0 | Tax $0
Seat 1: Hero (button) folded before Flop (didn't bet)
Seat 2: 43ec0d17 (small blind) folded before Flop
Seat 3: 82d96bf0 (big blind) collected ($0.04)
Seat 4: 196ab49 folded before Flop (didn't bet)
Seat 5: 188d9a08 folded before Flop (didn't bet)
Seat 6: 7f521697 folded before Flop (didn't bet)


Poker Hand #RC3794707419: Hold'em No Limit ($0.02/$0.05) - 2025/08/09 20:40:08
Table 'RushAndCash10832679' 6-max Seat #1 is the button
Seat 1: d3d9959a ($5 in chips)
Seat 2: e8f50e7c ($5.34 in chips)
Seat 3: Hero ($8.36 in chips)
Seat 4: 1468f0ed ($20.78 in chips)
Seat 5: 1b4b12f0 ($5 in chips)
Seat 6: 7a6ee12b ($28.03 in chips)
e8f50e7c: posts small blind $0.02
Hero: posts big blind $0.05
*** HOLE CARDS ***
Dealt to d3d9959a 
Dealt to e8f50e7c 
Dealt to Hero [Jh 5s]
Dealt to 1468f0ed 
Dealt to 1b4b12f0 
Dealt to 7a6ee12b 
1468f0ed: folds
1b4b12f0: raises $0.05 to $0.1
7a6ee12b: raises $0.21 to $0.31
d3d9959a: folds
e8f50e7c: folds
Hero: folds
1b4b12f0: folds
Uncalled bet ($0.21) returned to 7a6ee12b
*** SHOWDOWN ***
7a6ee12b collected $0.26 from pot
*** SUMMARY ***
Total pot $0.27 | Rake $0.01 | Jackpot $0 | Bingo $0 | Fortune $0 | Tax $0
Seat 1: d3d9959a (button) folded before Flop (didn't bet)
Seat 2: e8f50e7c (small blind) folded before Flop
Seat 3: Hero (big blind) folded before Flop
Seat 4: 1468f0ed folded before Flop (didn't bet)
Seat 5: 1b4b12f0 folded before Flop
Seat 6: 7a6ee12b collected ($0.26)


Poker Hand #RC3794707374: Hold'em No Limit ($0.02/$0.05) - 2025/08/09 20:40:02
Table 'RushAndCash10832634' 6-max Seat #1 is the button
Seat 1: f26aeb53 ($5.1 in chips)
Seat 2: Hero ($8.38 in chips)
Seat 3: 6aa1d0de ($5.37 in chips)
Seat 4: 3220ff6a ($9.59 in chips)
Seat 5: 119e3298 ($5 in chips)
Seat 6: 2df00cc0 ($6.92 in chips)
Hero: posts small blind $0.02
6aa1d0de: posts big blind $0.05
*** HOLE CARDS ***
Dealt to f26aeb53 
Dealt to Hero [7d Ts]
Dealt to 6aa1d0de 
Dealt to 3220ff6a 
Dealt to 119e3298 
Dealt to 2df00cc0 
3220ff6a: folds
119e3298: folds
2df00cc0: folds
f26aeb53: raises $0.08 to $0.13
Hero: folds
6aa1d0de: folds
Uncalled bet ($0.08) returned to f26aeb53
*** SHOWDOWN ***
f26aeb53 collected $0.12 from pot
*** SUMMARY ***
Total pot $0.12 | Rake $0 | Jackpot $0 | Bingo $0 | Fortune $0 | Tax $0
Seat 1: f26aeb53 (button) collected ($0.12)
Seat 2: Hero (small blind) folded before Flop
Seat 3: 6aa1d0de (big blind) folded before Flop
Seat 4: 3220ff6a folded before Flop (didn't bet)
Seat 5: 119e3298 folded before Flop (didn't bet)
Seat 6: 2df00cc0 folded before Flop (didn't bet)


Poker Hand #RC3794706991: Hold'em No Limit ($0.02/$0.05) - 2025/08/09 20:39:02
Table 'RushAndCash10832251' 6-max Seat #1 is the button
Seat 1: 20955084 ($7.09 in chips)
Seat 2: e3c47470 ($10.61 in chips)
Seat 3: f26aeb53 ($5 in chips)
Seat 4: Hero ($8.43 in chips)
Seat 5: bbb34e4f ($12.28 in chips)
Seat 6: c957dd13 ($6.25 in chips)
e3c47470: posts small blind $0.02
f26aeb53: posts big blind $0.05
*** HOLE CARDS ***
Dealt to 20955084 
Dealt to e3c47470 
Dealt to f26aeb53 
Dealt to Hero [Ah 9h]
Dealt to bbb34e4f 
Dealt to c957dd13 
Hero: calls $0.05
bbb34e4f: folds
c957dd13: folds
20955084: folds
e3c47470: calls $0.03
f26aeb53: checks
*** FLOP *** [2h Qs 6s]
e3c47470: checks
f26aeb53: bets $0.12
Hero: folds
e3c47470: folds
Uncalled bet ($0.12) returned to f26aeb53
*** SHOWDOWN ***
f26aeb53 collected $0.15 from pot
*** SUMMARY ***
Total pot $0.15 | Rake $0 | Jackpot $0 | Bingo $0 | Fortune $0 | Tax $0
Board [2h Qs 6s]
Seat 1: 20955084 (button) folded before Flop (didn't bet)
Seat 2: e3c47470 (small blind) folded on the Flop
Seat 3: f26aeb53 (big blind) won ($0.15)
Seat 4: Hero folded on the Flop
Seat 5: bbb34e4f folded before Flop (didn't bet)
Seat 6: c957dd13 folded before Flop (didn't bet)


Poker Hand #RC3794706972: Hold'em No Limit ($0.02/$0.05) - 2025/08/09 20:38:59
Table 'RushAndCash10832232' 6-max Seat #1 is the button
Seat 1: c4e02080 ($15.74 in chips)
Seat 2: ab3e4b60 ($15.57 in chips)
Seat 3: 2813af0a ($2.56 in chips)
Seat 4: Hero ($8.43 in chips)
Seat 5: 74d72586 ($5.31 in chips)
Seat 6: 1738cd42 ($4.71 in chips)
ab3e4b60: posts small blind $0.02
2813af0a: posts big blind $0.05
*** HOLE CARDS ***
Dealt to c4e02080 
Dealt to ab3e4b60 
Dealt to 2813af0a 
Dealt to Hero [Ah 6d]
Dealt to 74d72586 
Dealt to 1738cd42 
Hero: folds
74d72586: folds
1738cd42: folds
c4e02080: folds
ab3e4b60: folds
Uncalled bet ($0.03) returned to 2813af0a
*** SHOWDOWN ***
2813af0a collected $0.04 from pot
*** SUMMARY ***
Total pot $0.04 | Rake $0 | Jackpot $0 | Bingo $0 | Fortune $0 | Tax $0
Seat 1: c4e02080 (button) folded before Flop (didn't bet)
Seat 2: ab3e4b60 (small blind) folded before Flop
Seat 3: 2813af0a (big blind) collected ($0.04)
Seat 4: Hero folded before Flop (didn't bet)
Seat 5: 74d72586 folded before Flop (didn't bet)
Seat 6: 1738cd42 folded before Flop (didn't bet)


Poker Hand #RC3794706932: Hold'em No Limit ($0.02/$0.05) - 2025/08/09 20:38:51
Table 'RushAndCash10832192' 6-max Seat #1 is the button
Seat 1: 137d687a ($7.56 in chips)
Seat 2: Hero ($8.45 in chips)
Seat 3: 417e5a8f ($6.77 in chips)
Seat 4: 1738cd42 ($4.71 in chips)
Seat 5: caf5392e ($9.5 in chips)
Seat 6: dad9f022 ($5.68 in chips)
Hero: posts small blind $0.02
417e5a8f: posts big blind $0.05
*** HOLE CARDS ***
Dealt to 137d687a 
Dealt to Hero [7d 8c]
Dealt to 417e5a8f 
Dealt to 1738cd42 
Dealt to caf5392e 
Dealt to dad9f022 
1738cd42: folds
caf5392e: folds
dad9f022: raises $0.1 to $0.15
137d687a: folds
Hero: folds
417e5a8f: calls $0.1
*** FLOP *** [8h 6d 8d]
417e5a8f: checks
dad9f022: bets $0.11
417e5a8f: raises $0.38 to $0.49
dad9f022: folds
Uncalled bet ($0.38) returned to 417e5a8f
*** SHOWDOWN ***
417e5a8f collected $0.52 from pot
*** SUMMARY ***
Total pot $0.54 | Rake $0.02 | Jackpot $0 | Bingo $0 | Fortune $0 | Tax $0
Board [8h 6d 8d]
Seat 1: 137d687a (button) folded before Flop (didn't bet)
Seat 2: Hero (small blind) folded before Flop
Seat 3: 417e5a8f (big blind) won ($0.52)
Seat 4: 1738cd42 folded before Flop (didn't bet)
Seat 5: caf5392e folded before Flop (didn't bet)
Seat 6: dad9f022 folded on the Flop


Poker Hand #RC3794706910: Hold'em No Limit ($0.02/$0.05) - 2025/08/09 20:38:48
Table 'RushAndCash10832170' 6-max Seat #1 is the button
Seat 1: d2917ab1 ($6 in chips)
Seat 2: 8edf7521 ($5.4 in chips)
Seat 3: bc07fe7a ($5.43 in chips)
Seat 4: 3a1685e0 ($5.12 in chips)
Seat 5: 9db480b3 ($6.53 in chips)
Seat 6: Hero ($8.38 in chips)
8edf7521: posts small blind $0.02
bc07fe7a: posts big blind $0.05
*** HOLE CARDS ***
Dealt to d2917ab1 
Dealt to 8edf7521 
Dealt to bc07fe7a 
Dealt to 3a1685e0 
Dealt to 9db480b3 
Dealt to Hero [5d 8s]
3a1685e0: raises $0.06 to $0.11
9db480b3: raises $0.39 to $0.5
Hero: folds
d2917ab1: folds
8edf7521: raises $0.75 to $1.25
bc07fe7a: folds
3a1685e0: raises $3.87 to $5.12 and is all-in
9db480b3: folds
8edf7521: calls $3.87
3a1685e0: shows [Kc Kd]
8edf7521: shows [Ks As]
*** FLOP *** [Qc 7s Kh]
*** TURN *** [Qc 7s Kh] [5c]
*** RIVER *** [Qc 7s Kh 5c] [3c]
*** SHOWDOWN ***
3a1685e0 collected $10.57 from pot
*** SUMMARY ***
Total pot $10.79 | Rake $0.15 | Jackpot $0.07 | Bingo $0 | Fortune $0 | Tax $0
Board [Qc 7s Kh 5c 3c]
Seat 1: d2917ab1 (button) folded before Flop (didn't bet)
Seat 2: 8edf7521 (small blind) showed [Ks As] and lost with a pair of Kings
Seat 3: bc07fe7a (big blind) folded before Flop
Seat 4: 3a1685e0 showed [Kc Kd] and won ($10.57) with three of a kind, Kings
Seat 5: 9db480b3 folded before Flop
Seat 6: Hero folded before Flop (didn't bet)


Poker Hand #RC3794706850: Hold'em No Limit ($0.02/$0.05) - 2025/08/09 20:38:38
Table 'RushAndCash10832110' 6-max Seat #1 is the button
Seat 1: 43ca3d44 ($5.71 in chips)
Seat 2: e670ea93 ($5.78 in chips)
Seat 3: Hero ($8.43 in chips)
Seat 4: 995d90c4 ($5 in chips)
Seat 5: 8870db0f ($4.28 in chips)
Seat 6: c182d3ad ($7.97 in chips)
e670ea93: posts small blind $0.02
Hero: posts big blind $0.05
*** HOLE CARDS ***
Dealt to 43ca3d44 
Dealt to e670ea93 
Dealt to Hero [6s 2c]
Dealt to 995d90c4 
Dealt to 8870db0f 
Dealt to c182d3ad 
995d90c4: folds
8870db0f: folds
c182d3ad: folds
43ca3d44: folds
e670ea93: folds
Uncalled bet ($0.03) returned to Hero
*** SHOWDOWN ***
Hero collected $0.04 from pot
*** SUMMARY ***
Total pot $0.04 | Rake $0 | Jackpot $0 | Bingo $0 | Fortune $0 | Tax $0
Seat 1: 43ca3d44 (button) folded before Flop (didn't bet)
Seat 2: e670ea93 (small blind) folded before Flop
Seat 3: Hero (big blind) collected ($0.04)
Seat 4: 995d90c4 folded before Flop (didn't bet)
Seat 5: 8870db0f folded before Flop (didn't bet)
Seat 6: c182d3ad folded before Flop (didn't bet)


Poker Hand #RC3794706825: Hold'em No Limit ($0.02/$0.05) - 2025/08/09 20:38:35
Table 'RushAndCash10832085' 6-max Seat #1 is the button
Seat 1: 977d9090 ($6.58 in chips)
Seat 2: 4b982b0b ($8.89 in chips)
Seat 3: 9fa787cc ($6.15 in chips)
Seat 4: 98ea3b90 ($10.39 in chips)
Seat 5: aaa99871 ($10.34 in chips)
Seat 6: Hero ($8.43 in chips)
4b982b0b: posts small blind $0.02
9fa787cc: posts big blind $0.05
*** HOLE CARDS ***
Dealt to 977d9090 
Dealt to 4b982b0b 
Dealt to 9fa787cc 
Dealt to 98ea3b90 
Dealt to aaa99871 
Dealt to Hero [3c Js]
98ea3b90: folds
aaa99871: folds
Hero: folds
977d9090: raises $0.05 to $0.1
4b982b0b: folds
9fa787cc: calls $0.05
*** FLOP *** [Jc 4s 3h]
9fa787cc: checks
977d9090: checks
*** TURN *** [Jc 4s 3h] [7s]
9fa787cc: bets $0.08
977d9090: raises $0.1 to $0.18
9fa787cc: folds
Uncalled bet ($0.1) returned to 977d9090
*** SHOWDOWN ***
977d9090 collected $0.37 from pot
*** SUMMARY ***
Total pot $0.38 | Rake $0.01 | Jackpot $0 | Bingo $0 | Fortune $0 | Tax $0
Board [Jc 4s 3h 7s]
Seat 1: 977d9090 (button) won ($0.37)
Seat 2: 4b982b0b (small blind) folded before Flop
Seat 3: 9fa787cc (big blind) folded on the Turn
Seat 4: 98ea3b90 folded before Flop (didn't bet)
Seat 5: aaa99871 folded before Flop (didn't bet)
Seat 6: Hero folded before Flop (didn't bet)


Poker Hand #RC3794706764: Hold'em No Limit ($0.02/$0.05) - 2025/08/09 20:38:25
Table 'RushAndCash10832024' 6-max Seat #1 is the button
Seat 1: Hero ($8.43 in chips)
Seat 2: 60c6f1bd ($12.54 in chips)
Seat 3: 43ca3d44 ($5.76 in chips)
Seat 4: 5c7ea22b ($6.01 in chips)
Seat 5: e74908c2 ($5.68 in chips)
Seat 6: e285caaf ($5.56 in chips)
60c6f1bd: posts small blind $0.02
43ca3d44: posts big blind $0.05
*** HOLE CARDS ***
Dealt to Hero [3c Jc]
Dealt to 60c6f1bd 
Dealt to 43ca3d44 
Dealt to 5c7ea22b 
Dealt to e74908c2 
Dealt to e285caaf 
5c7ea22b: folds
e74908c2: raises $0.08 to $0.13
e285caaf: folds
Hero: folds
60c6f1bd: folds
43ca3d44: folds
Uncalled bet ($0.08) returned to e74908c2
*** SHOWDOWN ***
e74908c2 collected $0.12 from pot
*** SUMMARY ***
Total pot $0.12 | Rake $0 | Jackpot $0 | Bingo $0 | Fortune $0 | Tax $0
Seat 1: Hero (button) folded before Flop (didn't bet)
Seat 2: 60c6f1bd (small blind) folded before Flop
Seat 3: 43ca3d44 (big blind) folded before Flop
Seat 4: 5c7ea22b folded before Flop (didn't bet)
Seat 5: e74908c2 collected ($0.12)
Seat 6: e285caaf folded before Flop (didn't bet)


Poker Hand #RC3794706732: Hold'em No Limit ($0.02/$0.05) - 2025/08/09 20:38:19
Table 'RushAndCash10831992' 6-max Seat #1 is the button
Seat 1: 566a0a3d ($5 in chips)
Seat 2: aaa99871 ($10.34 in chips)
Seat 3: 8ffaa73b ($9.95 in chips)
Seat 4: Hero ($8.43 in chips)
Seat 5: bd2b7d94 ($3.97 in chips)
Seat 6: e850eac7 ($5.27 in chips)
aaa99871: posts small blind $0.02
8ffaa73b: posts big blind $0.05
*** HOLE CARDS ***
Dealt to 566a0a3d 
Dealt to aaa99871 
Dealt to 8ffaa73b 
Dealt to Hero [3c 3s]
Dealt to bd2b7d94 
Dealt to e850eac7 
Hero: folds
bd2b7d94: folds
e850eac7: folds
566a0a3d: folds
aaa99871: folds
Uncalled bet ($0.03) returned to 8ffaa73b
*** SHOWDOWN ***
8ffaa73b collected $0.04 from pot
*** SUMMARY ***
Total pot $0.04 | Rake $0 | Jackpot $0 | Bingo $0 | Fortune $0 | Tax $0
Seat 1: 566a0a3d (button) folded before Flop (didn't bet)
Seat 2: aaa99871 (small blind) folded before Flop
Seat 3: 8ffaa73b (big blind) collected ($0.04)
Seat 4: Hero folded before Flop (didn't bet)
Seat 5: bd2b7d94 folded before Flop (didn't bet)
Seat 6: e850eac7 folded before Flop (didn't bet)


Poker Hand #RC3794706644: Hold'em No Limit ($0.02/$0.05) - 2025/08/09 20:38:04
Table 'RushAndCash10831904' 6-max Seat #1 is the button
Seat 1: Hero ($8.43 in chips)
Seat 2: 972aadb9 ($5 in chips)
Seat 3: 2b7992bd ($5.81 in chips)
Seat 4: 5b29662a ($4.39 in chips)
Seat 5: fe523983 ($14.01 in chips)
Seat 6: 2642a224 ($5.95 in chips)
972aadb9: posts small blind $0.02
2b7992bd: posts big blind $0.05
*** HOLE CARDS ***
Dealt to Hero [2d Qc]
Dealt to 972aadb9 
Dealt to 2b7992bd 
Dealt to 5b29662a 
Dealt to fe523983 
Dealt to 2642a224 
5b29662a: raises $0.05 to $0.1
fe523983: folds
2642a224: folds
Hero: folds
972aadb9: folds
2b7992bd: folds
Uncalled bet ($0.05) returned to 5b29662a
*** SHOWDOWN ***
5b29662a collected $0.12 from pot
*** SUMMARY ***
Total pot $0.12 | Rake $0 | Jackpot $0 | Bingo $0 | Fortune $0 | Tax $0
Seat 1: Hero (button) folded before Flop (didn't bet)
Seat 2: 972aadb9 (small blind) folded before Flop
Seat 3: 2b7992bd (big blind) folded before Flop
Seat 4: 5b29662a collected ($0.12)
Seat 5: fe523983 folded before Flop (didn't bet)
Seat 6: 2642a224 folded before Flop (didn't bet)


Poker Hand #RC3794706623: Hold'em No Limit ($0.02/$0.05) - 2025/08/09 20:38:00
Table 'RushAndCash10831883' 6-max Seat #1 is the button
Seat 1: 352957b6 ($8.22 in chips)
Seat 2: 8ab5b1be ($5 in chips)
Seat 3: 2642a224 ($6 in chips)
Seat 4: 9582fa39 ($5.58 in chips)
Seat 5: be50ed85 ($6.33 in chips)
Seat 6: Hero ($8.43 in chips)
8ab5b1be: posts small blind $0.02
2642a224: posts big blind $0.05
*** HOLE CARDS ***
Dealt to 352957b6 
Dealt to 8ab5b1be 
Dealt to 2642a224 
Dealt to 9582fa39 
Dealt to be50ed85 
Dealt to Hero [2s Kc]
9582fa39: raises $0.05 to $0.1
be50ed85: folds
Hero: folds
352957b6: folds
8ab5b1be: folds
2642a224: folds
Uncalled bet ($0.05) returned to 9582fa39
*** SHOWDOWN ***
9582fa39 collected $0.12 from pot
*** SUMMARY ***
Total pot $0.12 | Rake $0 | Jackpot $0 | Bingo $0 | Fortune $0 | Tax $0
Seat 1: 352957b6 (button) folded before Flop (didn't bet)
Seat 2: 8ab5b1be (small blind) folded before Flop
Seat 3: 2642a224 (big blind) folded before Flop
Seat 4: 9582fa39 collected ($0.12)
Seat 5: be50ed85 folded before Flop (didn't bet)
Seat 6: Hero folded before Flop (didn't bet)


Poker Hand #RC3794706266: Hold'em No Limit ($0.02/$0.05) - 2025/08/09 20:37:01
Table 'RushAndCash10831526' 6-max Seat #1 is the button
Seat 1: f079ec2c ($19.12 in chips)
Seat 2: 76d3c749 ($5.19 in chips)
Seat 3: Hero ($9.18 in chips)
Seat 4: b75bb947 ($4.58 in chips)
Seat 5: 2642a224 ($5.37 in chips)
Seat 6: 7d6169ad ($5.84 in chips)
76d3c749: posts small blind $0.02
Hero: posts big blind $0.05
*** HOLE CARDS ***
Dealt to f079ec2c 
Dealt to 76d3c749 
Dealt to Hero [Jd Qs]
Dealt to b75bb947 
Dealt to 2642a224 
Dealt to 7d6169ad 
b75bb947: folds
2642a224: raises $0.08 to $0.13
7d6169ad: folds
f079ec2c: folds
76d3c749: folds
Hero: calls $0.08
*** FLOP *** [8d 4h Jc]
Hero: checks
2642a224: checks
*** TURN *** [8d 4h Jc] [5d]
Hero: checks
2642a224: bets $0.14
Hero: calls $0.14
*** RIVER *** [8d 4h Jc 5d] [6s]
Hero: checks
2642a224: bets $0.48
Hero: calls $0.48
2642a224: shows [5c 5s] (three of a kind, Fives)
Hero: shows [Jd Qs] (a pair of Jacks)
*** SHOWDOWN ***
2642a224 collected $1.38 from pot
*** SUMMARY ***
Total pot $1.52 | Rake $0.07 | Jackpot $0.07 | Bingo $0 | Fortune $0 | Tax $0
Board [8d 4h Jc 5d 6s]
Seat 1: f079ec2c (button) folded before Flop (didn't bet)
Seat 2: 76d3c749 (small blind) folded before Flop
Seat 3: Hero (big blind) showed [Jd Qs] and lost with a pair of Jacks
Seat 4: b75bb947 folded before Flop (didn't bet)
Seat 5: 2642a224 showed [5c 5s] and won ($1.38) with three of a kind, Fives
Seat 6: 7d6169ad folded before Flop (didn't bet)


Poker Hand #RC3794706237: Hold'em No Limit ($0.02/$0.05) - 2025/08/09 20:36:57
Table 'RushAndCash10831497' 6-max Seat #1 is the button
Seat 1: e56bda5e ($4.73 in chips)
Seat 2: b9a60126 ($5.66 in chips)
Seat 3: 4d11b576 ($3.69 in chips)
Seat 4: 3c9f1b9d ($5.42 in chips)
Seat 5: Hero ($9.18 in chips)
Seat 6: 2dd63c93 ($5.73 in chips)
b9a60126: posts small blind $0.02
4d11b576: posts big blind $0.05
*** HOLE CARDS ***
Dealt to e56bda5e 
Dealt to b9a60126 
Dealt to 4d11b576 
Dealt to 3c9f1b9d 
Dealt to Hero [Td 5d]
Dealt to 2dd63c93 
3c9f1b9d: folds
Hero: folds
2dd63c93: folds
e56bda5e: folds
b9a60126: folds
Uncalled bet ($0.03) returned to 4d11b576
*** SHOWDOWN ***
4d11b576 collected $0.04 from pot
*** SUMMARY ***
Total pot $0.04 | Rake $0 | Jackpot $0 | Bingo $0 | Fortune $0 | Tax $0
Seat 1: e56bda5e (button) folded before Flop (didn't bet)
Seat 2: b9a60126 (small blind) folded before Flop
Seat 3: 4d11b576 (big blind) collected ($0.04)
Seat 4: 3c9f1b9d folded before Flop (didn't bet)
Seat 5: Hero folded before Flop (didn't bet)
Seat 6: 2dd63c93 folded before Flop (didn't bet)


Poker Hand #RC3794706148: Hold'em No Limit ($0.02/$0.05) - 2025/08/09 20:36:44
Table 'RushAndCash10831408' 6-max Seat #1 is the button
Seat 1: b699d370 ($3.53 in chips)
Seat 2: Hero ($9.2 in chips)
Seat 3: ea2c5486 ($7.65 in chips)
Seat 4: 417e5a8f ($6.73 in chips)
Seat 5: 6e0a9c3f ($5 in chips)
Seat 6: c038e514 ($1.8 in chips)
Hero: posts small blind $0.02
ea2c5486: posts big blind $0.05
*** HOLE CARDS ***
Dealt to b699d370 
Dealt to Hero [2d 6h]
Dealt to ea2c5486 
Dealt to 417e5a8f 
Dealt to 6e0a9c3f 
Dealt to c038e514 
417e5a8f: raises $0.06 to $0.11
6e0a9c3f: calls $0.11
c038e514: folds
b699d370: folds
Hero: folds
ea2c5486: folds
*** FLOP *** [5d 6s Th]
417e5a8f: checks
6e0a9c3f: checks
*** TURN *** [5d 6s Th] [7d]
417e5a8f: checks
6e0a9c3f: checks
*** RIVER *** [5d 6s Th 7d] [Qd]
417e5a8f: checks
6e0a9c3f: checks
417e5a8f: shows [Tc Ts] (three of a kind, Tens)
6e0a9c3f: shows [2c 2h] (a pair of Twos)
*** SHOWDOWN ***
417e5a8f collected $0.28 from pot
*** SUMMARY ***
Total pot $0.29 | Rake $0.01 | Jackpot $0 | Bingo $0 | Fortune $0 | Tax $0
Board [5d 6s Th 7d Qd]
Seat 1: b699d370 (button) folded before Flop (didn't bet)
Seat 2: Hero (small blind) folded before Flop
Seat 3: ea2c5486 (big blind) folded before Flop
Seat 4: 417e5a8f showed [Tc Ts] and won ($0.28) with three of a kind, Tens
Seat 5: 6e0a9c3f showed [2c 2h] and lost with a pair of Twos
Seat 6: c038e514 folded before Flop (didn't bet)


Poker Hand #RC3794706115: Hold'em No Limit ($0.02/$0.05) - 2025/08/09 20:36:39
Table 'RushAndCash10831375' 6-max Seat #1 is the button
Seat 1: 8ee8e8d4 ($9.41 in chips)
Seat 2: dfdf8b4b ($5 in chips)
Seat 3: c182d3ad ($8.09 in chips)
Seat 4: 675b6839 ($5.32 in chips)
Seat 5: 79ca254c ($5.4 in chips)
Seat 6: Hero ($9.2 in chips)
dfdf8b4b: posts small blind $0.02
c182d3ad: posts big blind $0.05
*** HOLE CARDS ***
Dealt to 8ee8e8d4 
Dealt to dfdf8b4b 
Dealt to c182d3ad 
Dealt to 675b6839 
Dealt to 79ca254c 
Dealt to Hero [6h Kc]
675b6839: folds
79ca254c: folds
Hero: folds
8ee8e8d4: folds
dfdf8b4b: folds
Uncalled bet ($0.03) returned to c182d3ad
*** SHOWDOWN ***
c182d3ad collected $0.04 from pot
*** SUMMARY ***
Total pot $0.04 | Rake $0 | Jackpot $0 | Bingo $0 | Fortune $0 | Tax $0
Seat 1: 8ee8e8d4 (button) folded before Flop (didn't bet)
Seat 2: dfdf8b4b (small blind) folded before Flop
Seat 3: c182d3ad (big blind) collected ($0.04)
Seat 4: 675b6839 folded before Flop (didn't bet)
Seat 5: 79ca254c folded before Flop (didn't bet)
Seat 6: Hero folded before Flop (didn't bet)


Poker Hand #RC3794706046: Hold'em No Limit ($0.02/$0.05) - 2025/08/09 20:36:27
Table 'RushAndCash10831306' 6-max Seat #1 is the button
Seat 1: 422e6720 ($5.13 in chips)
Seat 2: Hero ($9.22 in chips)
Seat 3: 8c1a1f90 ($5.23 in chips)
Seat 4: 46991b8a ($9.45 in chips)
Seat 5: 977d9090 ($6.85 in chips)
Seat 6: bc07fe7a ($4.93 in chips)
Hero: posts small blind $0.02
8c1a1f90: posts big blind $0.05
*** HOLE CARDS ***
Dealt to 422e6720 
Dealt to Hero [Kd 2s]
Dealt to 8c1a1f90 
Dealt to 46991b8a 
Dealt to 977d9090 
Dealt to bc07fe7a 
46991b8a: folds
977d9090: folds
bc07fe7a: folds
422e6720: raises $0.07 to $0.12
Hero: folds
8c1a1f90: folds
Uncalled bet ($0.07) returned to 422e6720
*** SHOWDOWN ***
422e6720 collected $0.12 from pot
*** SUMMARY ***
Total pot $0.12 | Rake $0 | Jackpot $0 | Bingo $0 | Fortune $0 | Tax $0
Seat 1: 422e6720 (button) collected ($0.12)
Seat 2: Hero (small blind) folded before Flop
Seat 3: 8c1a1f90 (big blind) folded before Flop
Seat 4: 46991b8a folded before Flop (didn't bet)
Seat 5: 977d9090 folded before Flop (didn't bet)
Seat 6: bc07fe7a folded before Flop (didn't bet)


Poker Hand #RC3794705864: Hold'em No Limit ($0.02/$0.05) - 2025/08/09 20:35:56
Table 'RushAndCash10831124' 6-max Seat #1 is the button
Seat 1: 8c1a1f90 ($5.12 in chips)
Seat 2: 8fefc684 ($4.65 in chips)
Seat 3: Hero ($9.32 in chips)
Seat 4: 85c83f7e ($5 in chips)
Seat 5: 862bbf4 ($5.19 in chips)
Seat 6: 1c648a7f ($5.34 in chips)
8fefc684: posts small blind $0.02
Hero: posts big blind $0.05
*** HOLE CARDS ***
Dealt to 8c1a1f90 
Dealt to 8fefc684 
Dealt to Hero [5s 3d]
Dealt to 85c83f7e 
Dealt to 862bbf4 
Dealt to 1c648a7f 
85c83f7e: folds
862bbf4: folds
1c648a7f: folds
8c1a1f90: raises $0.05 to $0.1
8fefc684: folds
Hero: calls $0.05
*** FLOP *** [Qh 6d Jc]
Hero: checks
8c1a1f90: bets $0.11
Hero: folds
Uncalled bet ($0.11) returned to 8c1a1f90
*** SHOWDOWN ***
8c1a1f90 collected $0.21 from pot
*** SUMMARY ***
Total pot $0.22 | Rake $0.01 | Jackpot $0 | Bingo $0 | Fortune $0 | Tax $0
Board [Qh 6d Jc]
Seat 1: 8c1a1f90 (button) won ($0.21)
Seat 2: 8fefc684 (small blind) folded before Flop
Seat 3: Hero (big blind) folded on the Flop
Seat 4: 85c83f7e folded before Flop (didn't bet)
Seat 5: 862bbf4 folded before Flop (didn't bet)
Seat 6: 1c648a7f folded before Flop (didn't bet)


Poker Hand #RC3794705712: Hold'em No Limit ($0.02/$0.05) - 2025/08/09 20:35:31
Table 'RushAndCash10830972' 6-max Seat #1 is the button
Seat 1: e608b61d ($5.1 in chips)
Seat 2: e8f50e7c ($3.45 in chips)
Seat 3: d3377c43 ($5.14 in chips)
Seat 4: 675b6839 ($5.46 in chips)
Seat 5: 297d7072 ($0.81 in chips)
Seat 6: Hero ($9.25 in chips)
e8f50e7c: posts small blind $0.02
d3377c43: posts big blind $0.05
*** HOLE CARDS ***
Dealt to e608b61d 
Dealt to e8f50e7c 
Dealt to d3377c43 
Dealt to 675b6839 
Dealt to 297d7072 
Dealt to Hero [As 5d]
675b6839: folds
297d7072: folds
Hero: raises $0.05 to $0.1
e608b61d: folds
e8f50e7c: folds
d3377c43: folds
Uncalled bet ($0.05) returned to Hero
*** SHOWDOWN ***
Hero collected $0.12 from pot
*** SUMMARY ***
Total pot $0.12 | Rake $0 | Jackpot $0 | Bingo $0 | Fortune $0 | Tax $0
Seat 1: e608b61d (button) folded before Flop (didn't bet)
Seat 2: e8f50e7c (small blind) folded before Flop
Seat 3: d3377c43 (big blind) folded before Flop
Seat 4: 675b6839 folded before Flop (didn't bet)
Seat 5: 297d7072 folded before Flop (didn't bet)
Seat 6: Hero collected ($0.12)


Poker Hand #RC3794705236: Hold'em No Limit ($0.02/$0.05) - 2025/08/09 20:34:12
Table 'RushAndCash10830496' 6-max Seat #1 is the button
Seat 1: Hero ($10.07 in chips)
Seat 2: 5598b6d ($5.02 in chips)
Seat 3: 78084f7b ($5 in chips)
Seat 4: 78147f30 ($6.79 in chips)
Seat 5: 89a7d087 ($10.23 in chips)
Seat 6: ffecc323 ($8.48 in chips)
5598b6d: posts small blind $0.02
78084f7b: posts big blind $0.05
*** HOLE CARDS ***
Dealt to Hero [Js 9s]
Dealt to 5598b6d 
Dealt to 78084f7b 
Dealt to 78147f30 
Dealt to 89a7d087 
Dealt to ffecc323 
78147f30: raises $0.05 to $0.1
89a7d087: folds
ffecc323: folds
Hero: raises $0.05 to $0.15
5598b6d: folds
78084f7b: calls $0.1
78147f30: calls $0.05
*** FLOP *** [3d 8h Ks]
78084f7b: checks
78147f30: checks
Hero: checks
*** TURN *** [3d 8h Ks] [4s]
78084f7b: bets $0.24
78147f30: folds
Hero: raises $0.38 to $0.62
78084f7b: calls $0.38
*** RIVER *** [3d 8h Ks 4s] [Jh]
78084f7b: bets $0.05
Hero: calls $0.05
78084f7b: shows [Kh Qh] (a pair of Kings)
Hero: shows [Js 9s] (a pair of Jacks)
*** SHOWDOWN ***
78084f7b collected $1.66 from pot
*** SUMMARY ***
Total pot $1.81 | Rake $0.08 | Jackpot $0.07 | Bingo $0 | Fortune $0 | Tax $0
Board [3d 8h Ks 4s Jh]
Seat 1: Hero (button) showed [Js 9s] and lost with a pair of Jacks
Seat 2: 5598b6d (small blind) folded before Flop
Seat 3: 78084f7b (big blind) showed [Kh Qh] and won ($1.66) with a pair of Kings
Seat 4: 78147f30 folded on the Turn
Seat 5: 89a7d087 folded before Flop (didn't bet)
Seat 6: ffecc323 folded before Flop (didn't bet)


Poker Hand #RC3794705212: Hold'em No Limit ($0.02/$0.05) - 2025/08/09 20:34:09
Table 'RushAndCash10830472' 6-max Seat #1 is the button
Seat 1: 4df9d96 ($13.89 in chips)
Seat 2: 99073000 ($14.2 in chips)
Seat 3: 8b6f27db ($8.96 in chips)
Seat 4: Hero ($10.07 in chips)
Seat 5: b4df6d29 ($5.92 in chips)
Seat 6: 2af9a41c ($5 in chips)
99073000: posts small blind $0.02
8b6f27db: posts big blind $0.05
*** HOLE CARDS ***
Dealt to 4df9d96 
Dealt to 99073000 
Dealt to 8b6f27db 
Dealt to Hero [3h Th]
Dealt to b4df6d29 
Dealt to 2af9a41c 
Hero: folds
b4df6d29: raises $0.07 to $0.12
2af9a41c: folds
4df9d96: folds
99073000: folds
8b6f27db: calls $0.07
*** FLOP *** [Jh Qd 3s]
8b6f27db: checks
b4df6d29: bets $0.11
8b6f27db: calls $0.11
*** TURN *** [Jh Qd 3s] [Js]
8b6f27db: checks
b4df6d29: checks
*** RIVER *** [Jh Qd 3s Js] [Jd]
8b6f27db: bets $0.68
b4df6d29: folds
Uncalled bet ($0.68) returned to 8b6f27db
*** SHOWDOWN ***
8b6f27db collected $0.46 from pot
*** SUMMARY ***
Total pot $0.48 | Rake $0.02 | Jackpot $0 | Bingo $0 | Fortune $0 | Tax $0
Board [Jh Qd 3s Js Jd]
Seat 1: 4df9d96 (button) folded before Flop (didn't bet)
Seat 2: 99073000 (small blind) folded before Flop
Seat 3: 8b6f27db (big blind) won ($0.46)
Seat 4: Hero folded before Flop (didn't bet)
Seat 5: b4df6d29 folded on the River
Seat 6: 2af9a41c folded before Flop (didn't bet)


Poker Hand #RC3794705189: Hold'em No Limit ($0.02/$0.05) - 2025/08/09 20:34:05
Table 'RushAndCash10830449' 6-max Seat #1 is the button
Seat 1: 4bda779d ($5.09 in chips)
Seat 2: bf09af08 ($19.61 in chips)
Seat 3: f276db18 ($5 in chips)
Seat 4: 7a68c171 ($9.45 in chips)
Seat 5: 9b1b2e9d ($5.07 in chips)
Seat 6: Hero ($10.07 in chips)
bf09af08: posts small blind $0.02
f276db18: posts big blind $0.05
*** HOLE CARDS ***
Dealt to 4bda779d 
Dealt to bf09af08 
Dealt to f276db18 
Dealt to 7a68c171 
Dealt to 9b1b2e9d 
Dealt to Hero [5c 2c]
7a68c171: raises $0.05 to $0.1
9b1b2e9d: folds
Hero: folds
4bda779d: folds
bf09af08: folds
f276db18: folds
Uncalled bet ($0.05) returned to 7a68c171
*** SHOWDOWN ***
7a68c171 collected $0.12 from pot
*** SUMMARY ***
Total pot $0.12 | Rake $0 | Jackpot $0 | Bingo $0 | Fortune $0 | Tax $0
Seat 1: 4bda779d (button) folded before Flop (didn't bet)
Seat 2: bf09af08 (small blind) folded before Flop
Seat 3: f276db18 (big blind) folded before Flop
Seat 4: 7a68c171 collected ($0.12)
Seat 5: 9b1b2e9d folded before Flop (didn't bet)
Seat 6: Hero folded before Flop (didn't bet)


Poker Hand #RC3794705164: Hold'em No Limit ($0.02/$0.05) - 2025/08/09 20:34:01
Table 'RushAndCash10830424' 6-max Seat #1 is the button
Seat 1: Hero ($10.07 in chips)
Seat 2: ea2c5486 ($6.69 in chips)
Seat 3: 1b6d22a3 ($9.99 in chips)
Seat 4: 3beeefcf ($7.65 in chips)
Seat 5: 34cd0dd2 ($5.49 in chips)
Seat 6: 3e9bf952 ($7.01 in chips)
ea2c5486: posts small blind $0.02
1b6d22a3: posts big blind $0.05
*** HOLE CARDS ***
Dealt to Hero [2d 6h]
Dealt to ea2c5486 
Dealt to 1b6d22a3 
Dealt to 3beeefcf 
Dealt to 34cd0dd2 
Dealt to 3e9bf952 
3beeefcf: folds
34cd0dd2: folds
3e9bf952: folds
Hero: folds
ea2c5486: raises $0.1 to $0.15
1b6d22a3: raises $0.35 to $0.5
ea2c5486: raises $6.19 to $6.69 and is all-in
1b6d22a3: folds
Uncalled bet ($6.19) returned to ea2c5486
*** SHOWDOWN ***
ea2c5486 collected $0.95 from pot
*** SUMMARY ***
Total pot $1 | Rake $0.05 | Jackpot $0 | Bingo $0 | Fortune $0 | Tax $0
Seat 1: Hero (button) folded before Flop (didn't bet)
Seat 2: ea2c5486 (small blind) collected ($0.95)
Seat 3: 1b6d22a3 (big blind) folded before Flop
Seat 4: 3beeefcf folded before Flop (didn't bet)
Seat 5: 34cd0dd2 folded before Flop (didn't bet)
Seat 6: 3e9bf952 folded before Flop (didn't bet)


Poker Hand #RC3794705114: Hold'em No Limit ($0.02/$0.05) - 2025/08/09 20:33:54
Table 'RushAndCash10830374' 6-max Seat #1 is the button
Seat 1: 5e6670af ($1.73 in chips)
Seat 2: 3262a3fc ($7.22 in chips)
Seat 3: Hero ($10.12 in chips)
Seat 4: 97c44460 ($4.68 in chips)
Seat 5: e024ccdb ($3.09 in chips)
Seat 6: eed0c1cf ($5.11 in chips)
3262a3fc: posts small blind $0.02
Hero: posts big blind $0.05
*** HOLE CARDS ***
Dealt to 5e6670af 
Dealt to 3262a3fc 
Dealt to Hero [7d 3s]
Dealt to 97c44460 
Dealt to e024ccdb 
Dealt to eed0c1cf 
97c44460: folds
e024ccdb: folds
eed0c1cf: folds
5e6670af: raises $0.05 to $0.1
3262a3fc: folds
Hero: folds
Uncalled bet ($0.05) returned to 5e6670af
*** SHOWDOWN ***
5e6670af collected $0.12 from pot
*** SUMMARY ***
Total pot $0.12 | Rake $0 | Jackpot $0 | Bingo $0 | Fortune $0 | Tax $0
Seat 1: 5e6670af (button) collected ($0.12)
Seat 2: 3262a3fc (small blind) folded before Flop
Seat 3: Hero (big blind) folded before Flop
Seat 4: 97c44460 folded before Flop (didn't bet)
Seat 5: e024ccdb folded before Flop (didn't bet)
Seat 6: eed0c1cf folded before Flop (didn't bet)


Poker Hand #RC3794705090: Hold'em No Limit ($0.02/$0.05) - 2025/08/09 20:33:50
Table 'RushAndCash10830350' 6-max Seat #1 is the button
Seat 1: 675b6839 ($5.39 in chips)
Seat 2: Hero ($10.14 in chips)
Seat 3: 46e14704 ($5 in chips)
Seat 4: 20955084 ($7.42 in chips)
Seat 5: 17f014c8 ($5.16 in chips)
Seat 6: f02c550a ($8.2 in chips)
Hero: posts small blind $0.02
46e14704: posts big blind $0.05
*** HOLE CARDS ***
Dealt to 675b6839 
Dealt to Hero [6d 4c]
Dealt to 46e14704 
Dealt to 20955084 
Dealt to 17f014c8 
Dealt to f02c550a 
20955084: folds
17f014c8: folds
f02c550a: folds
675b6839: raises $0.08 to $0.13
Hero: folds
46e14704: folds
Uncalled bet ($0.08) returned to 675b6839
*** SHOWDOWN ***
675b6839 collected $0.12 from pot
*** SUMMARY ***
Total pot $0.12 | Rake $0 | Jackpot $0 | Bingo $0 | Fortune $0 | Tax $0
Seat 1: 675b6839 (button) collected ($0.12)
Seat 2: Hero (small blind) folded before Flop
Seat 3: 46e14704 (big blind) folded before Flop
Seat 4: 20955084 folded before Flop (didn't bet)
Seat 5: 17f014c8 folded before Flop (didn't bet)
Seat 6: f02c550a folded before Flop (didn't bet)


Poker Hand #RC3794705070: Hold'em No Limit ($0.02/$0.05) - 2025/08/09 20:33:46
Table 'RushAndCash10830330' 6-max Seat #1 is the button
Seat 1: 5c3cfebd ($5.14 in chips)
Seat 2: 9b1b2e9d ($5.09 in chips)
Seat 3: 8bf40f61 ($5 in chips)
Seat 4: Hero ($10.14 in chips)
Seat 5: 49baf997 ($3.92 in chips)
Seat 6: 12fd5edb ($7.6 in chips)
9b1b2e9d: posts small blind $0.02
8bf40f61: posts big blind $0.05
*** HOLE CARDS ***
Dealt to 5c3cfebd 
Dealt to 9b1b2e9d 
Dealt to 8bf40f61 
Dealt to Hero [9s Qc]
Dealt to 49baf997 
Dealt to 12fd5edb 
Hero: folds
49baf997: raises $0.07 to $0.12
12fd5edb: folds
5c3cfebd: raises $0.23 to $0.35
9b1b2e9d: folds
8bf40f61: folds
49baf997: raises $0.77 to $1.12
5c3cfebd: folds
Uncalled bet ($0.77) returned to 49baf997
*** SHOWDOWN ***
49baf997 collected $0.74 from pot
*** SUMMARY ***
Total pot $0.77 | Rake $0.03 | Jackpot $0 | Bingo $0 | Fortune $0 | Tax $0
Seat 1: 5c3cfebd (button) folded before Flop
Seat 2: 9b1b2e9d (small blind) folded before Flop
Seat 3: 8bf40f61 (big blind) folded before Flop
Seat 4: Hero folded before Flop (didn't bet)
Seat 5: 49baf997 collected ($0.74)
Seat 6: 12fd5edb folded before Flop (didn't bet)


Poker Hand #RC3794705050: Hold'em No Limit ($0.02/$0.05) - 2025/08/09 20:33:43
Table 'RushAndCash10830310' 6-max Seat #1 is the button
Seat 1: e9a880e8 ($5.16 in chips)
Seat 2: 8339fd8d ($11.77 in chips)
Seat 3: e040a01e ($4.96 in chips)
Seat 4: 6b07d62c ($5 in chips)
Seat 5: Hero ($10.14 in chips)
Seat 6: 692504b0 ($5.78 in chips)
8339fd8d: posts small blind $0.02
e040a01e: posts big blind $0.05
*** HOLE CARDS ***
Dealt to e9a880e8 
Dealt to 8339fd8d 
Dealt to e040a01e 
Dealt to 6b07d62c 
Dealt to Hero [7d Td]
Dealt to 692504b0 
6b07d62c: folds
Hero: folds
692504b0: folds
e9a880e8: raises $0.06 to $0.11
8339fd8d: folds
e040a01e: folds
Uncalled bet ($0.06) returned to e9a880e8
*** SHOWDOWN ***
e9a880e8 collected $0.12 from pot
*** SUMMARY ***
Total pot $0.12 | Rake $0 | Jackpot $0 | Bingo $0 | Fortune $0 | Tax $0
Seat 1: e9a880e8 (button) collected ($0.12)
Seat 2: 8339fd8d (small blind) folded before Flop
Seat 3: e040a01e (big blind) folded before Flop
Seat 4: 6b07d62c folded before Flop (didn't bet)
Seat 5: Hero folded before Flop (didn't bet)
Seat 6: 692504b0 folded before Flop (didn't bet)


Poker Hand #RC3794705032: Hold'em No Limit ($0.02/$0.05) - 2025/08/09 20:33:39
Table 'RushAndCash10830292' 6-max Seat #1 is the button
Seat 1: 6eb348cf ($6.47 in chips)
Seat 2: 3cdd470b ($5.44 in chips)
Seat 3: f95b915f ($7.41 in chips)
Seat 4: a6234baa ($10.32 in chips)
Seat 5: 43ae5181 ($5.74 in chips)
Seat 6: Hero ($10.14 in chips)
3cdd470b: posts small blind $0.02
f95b915f: posts big blind $0.05
*** HOLE CARDS ***
Dealt to 6eb348cf 
Dealt to 3cdd470b 
Dealt to f95b915f 
Dealt to a6234baa 
Dealt to 43ae5181 
Dealt to Hero [7h Ts]
a6234baa: folds
43ae5181: folds
Hero: folds
6eb348cf: folds
3cdd470b: folds
Uncalled bet ($0.03) returned to f95b915f
*** SHOWDOWN ***
f95b915f collected $0.04 from pot
*** SUMMARY ***
Total pot $0.04 | Rake $0 | Jackpot $0 | Bingo $0 | Fortune $0 | Tax $0
Seat 1: 6eb348cf (button) folded before Flop (didn't bet)
Seat 2: 3cdd470b (small blind) folded before Flop
Seat 3: f95b915f (big blind) collected ($0.04)
Seat 4: a6234baa folded before Flop (didn't bet)
Seat 5: 43ae5181 folded before Flop (didn't bet)
Seat 6: Hero folded before Flop (didn't bet)


Poker Hand #RC3794704746: Hold'em No Limit ($0.02/$0.05) - 2025/08/09 20:32:48
Table 'RushAndCash10830006' 6-max Seat #1 is the button
Seat 1: Hero ($9.94 in chips)
Seat 2: 6eb348cf ($6.64 in chips)
Seat 3: b75bb947 ($5.28 in chips)
Seat 4: 9be0a6fb ($6.3 in chips)
Seat 5: 95e696fc ($6.66 in chips)
Seat 6: 41aab34e ($6.79 in chips)
6eb348cf: posts small blind $0.02
b75bb947: posts big blind $0.05
*** HOLE CARDS ***
Dealt to Hero [Tc 9c]
Dealt to 6eb348cf 
Dealt to b75bb947 
Dealt to 9be0a6fb 
Dealt to 95e696fc 
Dealt to 41aab34e 
9be0a6fb: folds
95e696fc: folds
41aab34e: folds
Hero: raises $0.05 to $0.1
6eb348cf: calls $0.08
b75bb947: folds
*** FLOP *** [Kd 8d 3h]
6eb348cf: checks
Hero: bets $0.07
6eb348cf: calls $0.07
*** TURN *** [Kd 8d 3h] [3s]
6eb348cf: checks
Hero: checks
*** RIVER *** [Kd 8d 3h 3s] [8h]
6eb348cf: checks
Hero: bets $0.47
6eb348cf: folds
Uncalled bet ($0.47) returned to Hero
*** SHOWDOWN ***
Hero collected $0.37 from pot
*** SUMMARY ***
Total pot $0.39 | Rake $0.02 | Jackpot $0 | Bingo $0 | Fortune $0 | Tax $0
Board [Kd 8d 3h 3s 8h]
Seat 1: Hero (button) won ($0.37)
Seat 2: 6eb348cf (small blind) folded on the River
Seat 3: b75bb947 (big blind) folded before Flop
Seat 4: 9be0a6fb folded before Flop (didn't bet)
Seat 5: 95e696fc folded before Flop (didn't bet)
Seat 6: 41aab34e folded before Flop (didn't bet)


Poker Hand #RC3794654652: Hold'em No Limit ($0.02/$0.05) - 2025/08/09 20:32:32
Table 'RushAndCash10829912' 6-max Seat #1 is the button
Seat 1: 3d1f2d3c ($3.77 in chips)
Seat 2: Hero ($9.96 in chips)
Seat 3: 8a520993 ($11.81 in chips)
Seat 4: 62701279 ($5 in chips)
Seat 5: 6e0a9c3f ($5 in chips)
Seat 6: 84afb1f2 ($5.14 in chips)
Hero: posts small blind $0.02
8a520993: posts big blind $0.05
*** HOLE CARDS ***
Dealt to 3d1f2d3c 
Dealt to Hero [6s 6c]
Dealt to 8a520993 
Dealt to 62701279 
Dealt to 6e0a9c3f 
Dealt to 84afb1f2 
62701279: raises $0.06 to $0.11
6e0a9c3f: folds
84afb1f2: folds
3d1f2d3c: folds
Hero: folds
8a520993: folds
Uncalled bet ($0.06) returned to 62701279
*** SHOWDOWN ***
62701279 collected $0.12 from pot
*** SUMMARY ***
Total pot $0.12 | Rake $0 | Jackpot $0 | Bingo $0 | Fortune $0 | Tax $0
Seat 1: 3d1f2d3c (button) folded before Flop (didn't bet)
Seat 2: Hero (small blind) folded before Flop
Seat 3: 8a520993 (big blind) folded before Flop
Seat 4: 62701279 collected ($0.12)
Seat 5: 6e0a9c3f folded before Flop (didn't bet)
Seat 6: 84afb1f2 folded before Flop (didn't bet)


Poker Hand #RC3794654530: Hold'em No Limit ($0.02/$0.05) - 2025/08/09 20:32:11
Table 'RushAndCash10829790' 6-max Seat #1 is the button
Seat 1: 8e38cd0c ($5.07 in chips)
Seat 2: 95e696fc ($6.73 in chips)
Seat 3: Hero ($10.01 in chips)
Seat 4: 487893a0 ($2.65 in chips)
Seat 5: 61061f85 ($7.16 in chips)
Seat 6: 722603f4 ($29 in chips)
95e696fc: posts small blind $0.02
Hero: posts big blind $0.05
*** HOLE CARDS ***
Dealt to 8e38cd0c 
Dealt to 95e696fc 
Dealt to Hero [8c Qs]
Dealt to 487893a0 
Dealt to 61061f85 
Dealt to 722603f4 
487893a0: folds
61061f85: raises $0.05 to $0.1
722603f4: folds
8e38cd0c: folds
95e696fc: folds
Hero: folds
Uncalled bet ($0.05) returned to 61061f85
*** SHOWDOWN ***
61061f85 collected $0.12 from pot
*** SUMMARY ***
Total pot $0.12 | Rake $0 | Jackpot $0 | Bingo $0 | Fortune $0 | Tax $0
Seat 1: 8e38cd0c (button) folded before Flop (didn't bet)
Seat 2: 95e696fc (small blind) folded before Flop
Seat 3: Hero (big blind) folded before Flop
Seat 4: 487893a0 folded before Flop (didn't bet)
Seat 5: 61061f85 collected ($0.12)
Seat 6: 722603f4 folded before Flop (didn't bet)


Poker Hand #RC3794654507: Hold'em No Limit ($0.02/$0.05) - 2025/08/09 20:32:08
Table 'RushAndCash10829767' 6-max Seat #1 is the button
Seat 1: fd4494a3 ($8.64 in chips)
Seat 2: 9a0d1c3 ($5.27 in chips)
Seat 3: 7f521697 ($6.25 in chips)
Seat 4: Hero ($10.01 in chips)
Seat 5: 9bc25ab1 ($7.16 in chips)
Seat 6: 89b2b138 ($4.81 in chips)
9a0d1c3: posts small blind $0.02
7f521697: posts big blind $0.05
*** HOLE CARDS ***
Dealt to fd4494a3 
Dealt to 9a0d1c3 
Dealt to 7f521697 
Dealt to Hero [Kh 4h]
Dealt to 9bc25ab1 
Dealt to 89b2b138 
Hero: folds
9bc25ab1: folds
89b2b138: folds
fd4494a3: raises $0.06 to $0.11
9a0d1c3: folds
7f521697: folds
Uncalled bet ($0.06) returned to fd4494a3
*** SHOWDOWN ***
fd4494a3 collected $0.12 from pot
*** SUMMARY ***
Total pot $0.12 | Rake $0 | Jackpot $0 | Bingo $0 | Fortune $0 | Tax $0
Seat 1: fd4494a3 (button) collected ($0.12)
Seat 2: 9a0d1c3 (small blind) folded before Flop
Seat 3: 7f521697 (big blind) folded before Flop
Seat 4: Hero folded before Flop (didn't bet)
Seat 5: 9bc25ab1 folded before Flop (didn't bet)
Seat 6: 89b2b138 folded before Flop (didn't bet)


Poker Hand #RC3794654308: Hold'em No Limit ($0.02/$0.05) - 2025/08/09 20:31:33
Table 'RushAndCash10829568' 6-max Seat #1 is the button
Seat 1: bc8d7b66 ($5 in chips)
Seat 2: 2353d87c ($10.12 in chips)
Seat 3: ef98ca65 ($7.67 in chips)
Seat 4: ee000096 ($5 in chips)
Seat 5: Hero ($10.16 in chips)
Seat 6: eed0c1cf ($5 in chips)
2353d87c: posts small blind $0.02
ef98ca65: posts big blind $0.05
*** HOLE CARDS ***
Dealt to bc8d7b66 
Dealt to 2353d87c 
Dealt to ef98ca65 
Dealt to ee000096 
Dealt to Hero [7c 8c]
Dealt to eed0c1cf 
ee000096: folds
Hero: raises $0.05 to $0.1
eed0c1cf: folds
bc8d7b66: raises $0.05 to $0.15
2353d87c: folds
ef98ca65: folds
Hero: calls $0.05
*** FLOP *** [4h 3d 2d]
Hero: checks
bc8d7b66: bets $0.19
Hero: folds
Uncalled bet ($0.19) returned to bc8d7b66
*** SHOWDOWN ***
bc8d7b66 collected $0.36 from pot
*** SUMMARY ***
Total pot $0.37 | Rake $0.01 | Jackpot $0 | Bingo $0 | Fortune $0 | Tax $0
Board [4h 3d 2d]
Seat 1: bc8d7b66 (button) won ($0.36)
Seat 2: 2353d87c (small blind) folded before Flop
Seat 3: ef98ca65 (big blind) folded before Flop
Seat 4: ee000096 folded before Flop (didn't bet)
Seat 5: Hero folded on the Flop
Seat 6: eed0c1cf folded before Flop (didn't bet)


Poker Hand #RC3794654288: Hold'em No Limit ($0.02/$0.05) - 2025/08/09 20:31:29
Table 'RushAndCash10829548' 6-max Seat #1 is the button
Seat 1: 4d9bdcc ($7.77 in chips)
Seat 2: 426c3bb6 ($9.69 in chips)
Seat 3: 6b07d62c ($5.28 in chips)
Seat 4: c8bab83 ($5.38 in chips)
Seat 5: 38503bb9 ($5.36 in chips)
Seat 6: Hero ($10.16 in chips)
426c3bb6: posts small blind $0.02
6b07d62c: posts big blind $0.05
*** HOLE CARDS ***
Dealt to 4d9bdcc 
Dealt to 426c3bb6 
Dealt to 6b07d62c 
Dealt to c8bab83 
Dealt to 38503bb9 
Dealt to Hero [Js 5h]
c8bab83: folds
38503bb9: folds
Hero: folds
4d9bdcc: folds
426c3bb6: folds
Uncalled bet ($0.03) returned to 6b07d62c
*** SHOWDOWN ***
6b07d62c collected $0.04 from pot
*** SUMMARY ***
Total pot $0.04 | Rake $0 | Jackpot $0 | Bingo $0 | Fortune $0 | Tax $0
Seat 1: 4d9bdcc (button) folded before Flop (didn't bet)
Seat 2: 426c3bb6 (small blind) folded before Flop
Seat 3: 6b07d62c (big blind) collected ($0.04)
Seat 4: c8bab83 folded before Flop (didn't bet)
Seat 5: 38503bb9 folded before Flop (didn't bet)
Seat 6: Hero folded before Flop (didn't bet)


Poker Hand #RC3794654267: Hold'em No Limit ($0.02/$0.05) - 2025/08/09 20:31:25
Table 'RushAndCash10829527' 6-max Seat #1 is the button
Seat 1: 25e04619 ($5.07 in chips)
Seat 2: 7baaab46 ($5.79 in chips)
Seat 3: bf09af08 ($19.37 in chips)
Seat 4: 76919bdf ($5 in chips)
Seat 5: 3515fb39 ($5.72 in chips)
Seat 6: Hero ($10.16 in chips)
7baaab46: posts small blind $0.02
bf09af08: posts big blind $0.05
*** HOLE CARDS ***
Dealt to 25e04619 
Dealt to 7baaab46 
Dealt to bf09af08 
Dealt to 76919bdf 
Dealt to 3515fb39 
Dealt to Hero [3h 2s]
76919bdf: folds
3515fb39: folds
Hero: folds
25e04619: folds
7baaab46: raises $0.05 to $0.1
bf09af08: calls $0.05
*** FLOP *** [5c Qd 6d]
7baaab46: checks
bf09af08: checks
*** TURN *** [5c Qd 6d] [8h]
7baaab46: bets $0.16
bf09af08: raises $0.18 to $0.34
7baaab46: calls $0.18
*** RIVER *** [5c Qd 6d 8h] [3d]
7baaab46: checks
bf09af08: bets $0.66
7baaab46: folds
Uncalled bet ($0.66) returned to bf09af08
*** SHOWDOWN ***
bf09af08 collected $0.84 from pot
*** SUMMARY ***
Total pot $0.88 | Rake $0.04 | Jackpot $0 | Bingo $0 | Fortune $0 | Tax $0
Board [5c Qd 6d 8h 3d]
Seat 1: 25e04619 (button) folded before Flop (didn't bet)
Seat 2: 7baaab46 (small blind) folded on the River
Seat 3: bf09af08 (big blind) won ($0.84)
Seat 4: 76919bdf folded before Flop (didn't bet)
Seat 5: 3515fb39 folded before Flop (didn't bet)
Seat 6: Hero folded before Flop (didn't bet)


Poker Hand #RC3794654227: Hold'em No Limit ($0.02/$0.05) - 2025/08/09 20:31:19
Table 'RushAndCash10829487' 6-max Seat #1 is the button
Seat 1: beafa9fa ($5.27 in chips)
Seat 2: Hero ($10.18 in chips)
Seat 3: 404ee92a ($5 in chips)
Seat 4: 877edcba ($9.72 in chips)
Seat 5: c21a3788 ($5 in chips)
Seat 6: 8f2a82e3 ($16.46 in chips)
Hero: posts small blind $0.02
404ee92a: posts big blind $0.05
*** HOLE CARDS ***
Dealt to beafa9fa 
Dealt to Hero [4h Ts]
Dealt to 404ee92a 
Dealt to 877edcba 
Dealt to c21a3788 
Dealt to 8f2a82e3 
877edcba: raises $0.08 to $0.13
c21a3788: folds
8f2a82e3: folds
beafa9fa: folds
Hero: folds
404ee92a: folds
Uncalled bet ($0.08) returned to 877edcba
*** SHOWDOWN ***
877edcba collected $0.12 from pot
*** SUMMARY ***
Total pot $0.12 | Rake $0 | Jackpot $0 | Bingo $0 | Fortune $0 | Tax $0
Seat 1: beafa9fa (button) folded before Flop (didn't bet)
Seat 2: Hero (small blind) folded before Flop
Seat 3: 404ee92a (big blind) folded before Flop
Seat 4: 877edcba collected ($0.12)
Seat 5: c21a3788 folded before Flop (didn't bet)
Seat 6: 8f2a82e3 folded before Flop (didn't bet)


Poker Hand #RC3794654137: Hold'em No Limit ($0.02/$0.05) - 2025/08/09 20:31:03
Table 'RushAndCash10829397' 6-max Seat #1 is the button
Seat 1: Hero ($10.18 in chips)
Seat 2: fe523983 ($5 in chips)
Seat 3: 183d1f0c ($1.42 in chips)
Seat 4: 196ab49 ($5.11 in chips)
Seat 5: 8339fd8d ($11.97 in chips)
Seat 6: 41e8efd8 ($5 in chips)
fe523983: posts small blind $0.02
183d1f0c: posts big blind $0.05
*** HOLE CARDS ***
Dealt to Hero [Qc 7d]
Dealt to fe523983 
Dealt to 183d1f0c 
Dealt to 196ab49 
Dealt to 8339fd8d 
Dealt to 41e8efd8 
196ab49: folds
8339fd8d: raises $0.05 to $0.1
41e8efd8: folds
Hero: folds
fe523983: folds
183d1f0c: raises $0.25 to $0.35
8339fd8d: folds
Uncalled bet ($0.25) returned to 183d1f0c
*** SHOWDOWN ***
183d1f0c collected $0.21 from pot
*** SUMMARY ***
Total pot $0.22 | Rake $0.01 | Jackpot $0 | Bingo $0 | Fortune $0 | Tax $0
Seat 1: Hero (button) folded before Flop (didn't bet)
Seat 2: fe523983 (small blind) folded before Flop
Seat 3: 183d1f0c (big blind) collected ($0.21)
Seat 4: 196ab49 folded before Flop (didn't bet)
Seat 5: 8339fd8d folded before Flop
Seat 6: 41e8efd8 folded before Flop (didn't bet)


Poker Hand #RC3794653635: Hold'em No Limit ($0.02/$0.05) - 2025/08/09 20:29:36
Table 'RushAndCash10828895' 6-max Seat #1 is the button
Seat 1: b73fd582 ($12.16 in chips)
Seat 2: 7ce15f0c ($5.13 in chips)
Seat 3: Hero ($10.78 in chips)
Seat 4: 75571327 ($5 in chips)
Seat 5: 990829e2 ($11.2 in chips)
Seat 6: f75da158 ($11.32 in chips)
7ce15f0c: posts small blind $0.02
Hero: posts big blind $0.05
*** HOLE CARDS ***
Dealt to b73fd582 
Dealt to 7ce15f0c 
Dealt to Hero [4d 4c]
Dealt to 75571327 
Dealt to 990829e2 
Dealt to f75da158 
75571327: folds
990829e2: raises $0.05 to $0.1
f75da158: folds
b73fd582: folds
7ce15f0c: folds
Hero: calls $0.05
*** FLOP *** [As Qc Kc]
Hero: bets $0.07
990829e2: calls $0.07
*** TURN *** [As Qc Kc] [Qs]
Hero: checks
990829e2: checks
*** RIVER *** [As Qc Kc Qs] [Ts]
Hero: bets $0.43
990829e2: calls $0.43
Hero: shows [4d 4c] (two pair, Queens and Fours)
990829e2: shows [Jc 8c] (a straight, Ace to Ten)
*** SHOWDOWN ***
990829e2 collected $1.16 from pot
*** SUMMARY ***
Total pot $1.22 | Rake $0.06 | Jackpot $0 | Bingo $0 | Fortune $0 | Tax $0
Board [As Qc Kc Qs Ts]
Seat 1: b73fd582 (button) folded before Flop (didn't bet)
Seat 2: 7ce15f0c (small blind) folded before Flop
Seat 3: Hero (big blind) showed [4d 4c] and lost with two pair, Queens and Fours
Seat 4: 75571327 folded before Flop (didn't bet)
Seat 5: 990829e2 showed [Jc 8c] and won ($1.16) with a straight, Ace to Ten
Seat 6: f75da158 folded before Flop (didn't bet)


Poker Hand #RC3794653236: Hold'em No Limit ($0.02/$0.05) - 2025/08/09 20:28:26
Table 'RushAndCash10828496' 6-max Seat #1 is the button
Seat 1: 244640eb ($5.25 in chips)
Seat 2: 990829e2 ($12.1 in chips)
Seat 3: a5ee16a9 ($3.61 in chips)
Seat 4: Hero ($9.6 in chips)
Seat 5: 76211edb ($6.5 in chips)
Seat 6: 34cd0dd2 ($5.13 in chips)
990829e2: posts small blind $0.02
a5ee16a9: posts big blind $0.05
*** HOLE CARDS ***
Dealt to 244640eb 
Dealt to 990829e2 
Dealt to a5ee16a9 
Dealt to Hero [Qs Kh]
Dealt to 76211edb 
Dealt to 34cd0dd2 
Hero: raises $0.05 to $0.1
76211edb: folds
34cd0dd2: folds
244640eb: raises $0.3 to $0.4
990829e2: calls $0.38
a5ee16a9: folds
Hero: calls $0.3
*** FLOP *** [5h 2h 3h]
990829e2: checks
Hero: checks
244640eb: checks
*** TURN *** [5h 2h 3h] [Ah]
990829e2: checks
Hero: checks
244640eb: checks
*** RIVER *** [5h 2h 3h Ah] [4d]
990829e2: bets $0.5
Hero: raises $1.72 to $2.22
244640eb: folds
990829e2: folds
Uncalled bet ($1.72) returned to Hero
*** SHOWDOWN ***
Hero collected $2.08 from pot
*** SUMMARY ***
Total pot $2.25 | Rake $0.1 | Jackpot $0.07 | Bingo $0 | Fortune $0 | Tax $0
Board [5h 2h 3h Ah 4d]
Seat 1: 244640eb (button) folded on the River
Seat 2: 990829e2 (small blind) folded on the River
Seat 3: a5ee16a9 (big blind) folded before Flop
Seat 4: Hero won ($2.08)
Seat 5: 76211edb folded before Flop (didn't bet)
Seat 6: 34cd0dd2 folded before Flop (didn't bet)


Poker Hand #RC3794653211: Hold'em No Limit ($0.02/$0.05) - 2025/08/09 20:28:21
Table 'RushAndCash10828471' 6-max Seat #1 is the button
Seat 1: 1ad7141a ($5.09 in chips)
Seat 2: 36efdf4e ($5.02 in chips)
Seat 3: 9ff23eea ($6.28 in chips)
Seat 4: 98ea3b90 ($11.09 in chips)
Seat 5: Hero ($9.6 in chips)
Seat 6: 41bb1ee8 ($9.2 in chips)
36efdf4e: posts small blind $0.02
9ff23eea: posts big blind $0.05
*** HOLE CARDS ***
Dealt to 1ad7141a 
Dealt to 36efdf4e 
Dealt to 9ff23eea 
Dealt to 98ea3b90 
Dealt to Hero [Js 2h]
Dealt to 41bb1ee8 
98ea3b90: folds
Hero: folds
41bb1ee8: folds
1ad7141a: folds
36efdf4e: raises $0.1 to $0.15
9ff23eea: folds
Uncalled bet ($0.1) returned to 36efdf4e
*** SHOWDOWN ***
36efdf4e collected $0.1 from pot
*** SUMMARY ***
Total pot $0.1 | Rake $0 | Jackpot $0 | Bingo $0 | Fortune $0 | Tax $0
Seat 1: 1ad7141a (button) folded before Flop (didn't bet)
Seat 2: 36efdf4e (small blind) collected ($0.1)
Seat 3: 9ff23eea (big blind) folded before Flop
Seat 4: 98ea3b90 folded before Flop (didn't bet)
Seat 5: Hero folded before Flop (didn't bet)
Seat 6: 41bb1ee8 folded before Flop (didn't bet)


Poker Hand #RC3794653115: Hold'em No Limit ($0.02/$0.05) - 2025/08/09 20:28:04
Table 'RushAndCash10828375' 6-max Seat #1 is the button
Seat 1: 902a5491 ($5 in chips)
Seat 2: 90cdecbc ($3.18 in chips)
Seat 3: b73fd582 ($11.96 in chips)
Seat 4: 133f34ec ($5.53 in chips)
Seat 5: 4565936a ($6.67 in chips)
Seat 6: Hero ($9.53 in chips)
90cdecbc: posts small blind $0.02
b73fd582: posts big blind $0.05
*** HOLE CARDS ***
Dealt to 902a5491 
Dealt to 90cdecbc 
Dealt to b73fd582 
Dealt to 133f34ec 
Dealt to 4565936a 
Dealt to Hero [Td Ts]
133f34ec: folds
4565936a: folds
Hero: raises $0.05 to $0.1
902a5491: folds
90cdecbc: folds
b73fd582: folds
Uncalled bet ($0.05) returned to Hero
*** SHOWDOWN ***
Hero collected $0.12 from pot
*** SUMMARY ***
Total pot $0.12 | Rake $0 | Jackpot $0 | Bingo $0 | Fortune $0 | Tax $0
Seat 1: 902a5491 (button) folded before Flop (didn't bet)
Seat 2: 90cdecbc (small blind) folded before Flop
Seat 3: b73fd582 (big blind) folded before Flop
Seat 4: 133f34ec folded before Flop (didn't bet)
Seat 5: 4565936a folded before Flop (didn't bet)
Seat 6: Hero collected ($0.12)


Poker Hand #RC3794653068: Hold'em No Limit ($0.02/$0.05) - 2025/08/09 20:27:57
Table 'RushAndCash10828328' 6-max Seat #1 is the button
Seat 1: Hero ($9.53 in chips)
Seat 2: ff85320b ($9.09 in chips)
Seat 3: 701805a2 ($5.95 in chips)
Seat 4: 6ac5bc1b ($7.92 in chips)
Seat 5: b73fd582 ($11.96 in chips)
Seat 6: 57d03c84 ($5.24 in chips)
ff85320b: posts small blind $0.02
701805a2: posts big blind $0.05
*** HOLE CARDS ***
Dealt to Hero [2h Ts]
Dealt to ff85320b 
Dealt to 701805a2 
Dealt to 6ac5bc1b 
Dealt to b73fd582 
Dealt to 57d03c84 
6ac5bc1b: folds
b73fd582: folds
57d03c84: folds
Hero: folds
ff85320b: folds
Uncalled bet ($0.03) returned to 701805a2
*** SHOWDOWN ***
701805a2 collected $0.04 from pot
*** SUMMARY ***
Total pot $0.04 | Rake $0 | Jackpot $0 | Bingo $0 | Fortune $0 | Tax $0
Seat 1: Hero (button) folded before Flop (didn't bet)
Seat 2: ff85320b (small blind) folded before Flop
Seat 3: 701805a2 (big blind) collected ($0.04)
Seat 4: 6ac5bc1b folded before Flop (didn't bet)
Seat 5: b73fd582 folded before Flop (didn't bet)
Seat 6: 57d03c84 folded before Flop (didn't bet)


Poker Hand #RC3794652997: Hold'em No Limit ($0.02/$0.05) - 2025/08/09 20:27:46
Table 'RushAndCash10828257' 6-max Seat #1 is the button
Seat 1: a3c6a076 ($11.82 in chips)
Seat 2: Hero ($9.55 in chips)
Seat 3: 20955084 ($9.2 in chips)
Seat 4: 9e28d55 ($5.05 in chips)
Seat 5: a2405ad ($9.83 in chips)
Seat 6: 8814b7ca ($5.47 in chips)
Hero: posts small blind $0.02
20955084: posts big blind $0.05
*** HOLE CARDS ***
Dealt to a3c6a076 
Dealt to Hero [8h 2h]
Dealt to 20955084 
Dealt to 9e28d55 
Dealt to a2405ad 
Dealt to 8814b7ca 
9e28d55: folds
a2405ad: raises $0.05 to $0.1
8814b7ca: folds
a3c6a076: folds
Hero: folds
20955084: calls $0.05
*** FLOP *** [Ah Ad 9c]
20955084: checks
a2405ad: checks
*** TURN *** [Ah Ad 9c] [8d]
20955084: checks
a2405ad: checks
*** RIVER *** [Ah Ad 9c 8d] [2s]
20955084: checks
a2405ad: checks
20955084: shows [6h 3d] (a pair of Aces)
a2405ad: shows [Kh Qs] (a pair of Aces)
*** SHOWDOWN ***
a2405ad collected $0.21 from pot
*** SUMMARY ***
Total pot $0.22 | Rake $0.01 | Jackpot $0 | Bingo $0 | Fortune $0 | Tax $0
Board [Ah Ad 9c 8d 2s]
Seat 1: a3c6a076 (button) folded before Flop (didn't bet)
Seat 2: Hero (small blind) folded before Flop
Seat 3: 20955084 (big blind) showed [6h 3d] and lost with a pair of Aces
Seat 4: 9e28d55 folded before Flop (didn't bet)
Seat 5: a2405ad showed [Kh Qs] and won ($0.21) with a pair of Aces
Seat 6: 8814b7ca folded before Flop (didn't bet)


Poker Hand #RC3794652622: Hold'em No Limit ($0.02/$0.05) - 2025/08/09 20:26:47
Table 'RushAndCash10827882' 6-max Seat #1 is the button
Seat 1: 76919bdf ($5 in chips)
Seat 2: a7b498bb ($4.95 in chips)
Seat 3: Hero ($9.29 in chips)
Seat 4: 15134e2a ($7.79 in chips)
Seat 5: fdb28128 ($5.44 in chips)
Seat 6: a8977aa6 ($6.51 in chips)
a7b498bb: posts small blind $0.02
Hero: posts big blind $0.05
*** HOLE CARDS ***
Dealt to 76919bdf 
Dealt to a7b498bb 
Dealt to Hero [Th 9h]
Dealt to 15134e2a 
Dealt to fdb28128 
Dealt to a8977aa6 
15134e2a: folds
fdb28128: folds
a8977aa6: folds
76919bdf: raises $0.06 to $0.11
a7b498bb: folds
Hero: calls $0.06
*** FLOP *** [2c 7c Qh]
Hero: checks
76919bdf: bets $0.1
Hero: calls $0.1
*** TURN *** [2c 7c Qh] [2d]
Hero: bets $0.05
76919bdf: calls $0.05
*** RIVER *** [2c 7c Qh 2d] [9d]
Hero: checks
76919bdf: checks
Hero: shows [Th 9h] (two pair, Nines and Twos)
76919bdf: shows [5c Ah] (a pair of Twos)
*** SHOWDOWN ***
Hero collected $0.52 from pot
*** SUMMARY ***
Total pot $0.54 | Rake $0.02 | Jackpot $0 | Bingo $0 | Fortune $0 | Tax $0
Board [2c 7c Qh 2d 9d]
Seat 1: 76919bdf (button) showed [5c Ah] and lost with a pair of Twos
Seat 2: a7b498bb (small blind) folded before Flop
Seat 3: Hero (big blind) showed [Th 9h] and won ($0.52) with two pair, Nines and Twos
Seat 4: 15134e2a folded before Flop (didn't bet)
Seat 5: fdb28128 folded before Flop (didn't bet)
Seat 6: a8977aa6 folded before Flop (didn't bet)


Poker Hand #RC3794652595: Hold'em No Limit ($0.02/$0.05) - 2025/08/09 20:26:43
Table 'RushAndCash10827855' 6-max Seat #1 is the button
Seat 1: fa5c91d9 ($5 in chips)
Seat 2: 57d03c84 ($5.34 in chips)
Seat 3: 61061f85 ($5.65 in chips)
Seat 4: 6f3a2f9a ($12.64 in chips)
Seat 5: Hero ($9.29 in chips)
Seat 6: e8a0b75a ($7.14 in chips)
57d03c84: posts small blind $0.02
61061f85: posts big blind $0.05
*** HOLE CARDS ***
Dealt to fa5c91d9 
Dealt to 57d03c84 
Dealt to 61061f85 
Dealt to 6f3a2f9a 
Dealt to Hero [2c Th]
Dealt to e8a0b75a 
6f3a2f9a: folds
Hero: folds
e8a0b75a: folds
fa5c91d9: raises $0.05 to $0.1
57d03c84: folds
61061f85: calls $0.05
*** FLOP *** [5s 9d 4c]
61061f85: checks
fa5c91d9: bets $0.08
61061f85: calls $0.08
*** TURN *** [5s 9d 4c] [7s]
61061f85: checks
fa5c91d9: checks
*** RIVER *** [5s 9d 4c 7s] [8h]
61061f85: bets $0.3
fa5c91d9: folds
Uncalled bet ($0.3) returned to 61061f85
*** SHOWDOWN ***
61061f85 collected $0.37 from pot
*** SUMMARY ***
Total pot $0.38 | Rake $0.01 | Jackpot $0 | Bingo $0 | Fortune $0 | Tax $0
Board [5s 9d 4c 7s 8h]
Seat 1: fa5c91d9 (button) folded on the River
Seat 2: 57d03c84 (small blind) folded before Flop
Seat 3: 61061f85 (big blind) won ($0.37)
Seat 4: 6f3a2f9a folded before Flop (didn't bet)
Seat 5: Hero folded before Flop (didn't bet)
Seat 6: e8a0b75a folded before Flop (didn't bet)


Poker Hand #RC3794651977: Hold'em No Limit ($0.02/$0.05) - 2025/08/09 20:24:52
Table 'RushAndCash10827237' 6-max Seat #1 is the button
Seat 1: c577f391 ($5.26 in chips)
Seat 2: f1a1e52 ($15.94 in chips)
Seat 3: a7b498bb ($5 in chips)
Seat 4: 28bf1a45 ($4.1 in chips)
Seat 5: Hero ($4.72 in chips)
Seat 6: cec55d75 ($5 in chips)
f1a1e52: posts small blind $0.02
a7b498bb: posts big blind $0.05
*** HOLE CARDS ***
Dealt to c577f391 
Dealt to f1a1e52 
Dealt to a7b498bb 
Dealt to 28bf1a45 
Dealt to Hero [9d 9h]
Dealt to cec55d75 
28bf1a45: folds
Hero: raises $0.05 to $0.1
cec55d75: raises $0.21 to $0.31
c577f391: folds
f1a1e52: folds
a7b498bb: folds
Hero: calls $0.21
*** FLOP *** [4h 2h 9s]
Hero: checks
cec55d75: bets $0.4
Hero: calls $0.4
*** TURN *** [4h 2h 9s] [3d]
Hero: checks
cec55d75: bets $1.1
Hero: calls $1.1
*** RIVER *** [4h 2h 9s 3d] [3c]
Hero: checks
cec55d75: bets $3.19 and is all-in
Hero: calls $2.91 and is all-in
Uncalled bet ($0.28) returned to cec55d75
cec55d75: shows [Jh Jc] (two pair, Jacks and Threes)
Hero: shows [9d 9h] (a full house, Nines full of Threes)
*** SHOWDOWN ***
Hero collected $9.29 from pot
*** SUMMARY ***
Total pot $9.51 | Rake $0.15 | Jackpot $0.07 | Bingo $0 | Fortune $0 | Tax $0
Board [4h 2h 9s 3d 3c]
Seat 1: c577f391 (button) folded before Flop (didn't bet)
Seat 2: f1a1e52 (small blind) folded before Flop
Seat 3: a7b498bb (big blind) folded before Flop
Seat 4: 28bf1a45 folded before Flop (didn't bet)
Seat 5: Hero showed [9d 9h] and won ($9.29) with a full house, Nines full of Threes
Seat 6: cec55d75 showed [Jh Jc] and lost with two pair, Jacks and Threes


Poker Hand #RC3794651838: Hold'em No Limit ($0.02/$0.05) - 2025/08/09 20:24:28
Table 'RushAndCash10827098' 6-max Seat #1 is the button
Seat 1: 8d479104 ($6.13 in chips)
Seat 2: Hero ($4.67 in chips)
Seat 3: ee000096 ($5.62 in chips)
Seat 4: f75da158 ($10.77 in chips)
Seat 5: 77d99075 ($5 in chips)
Seat 6: 9e28d55 ($5.02 in chips)
Hero: posts small blind $0.02
ee000096: posts big blind $0.05
*** HOLE CARDS ***
Dealt to 8d479104 
Dealt to Hero [9c 9s]
Dealt to ee000096 
Dealt to f75da158 
Dealt to 77d99075 
Dealt to 9e28d55 
f75da158: folds
77d99075: folds
9e28d55: folds
8d479104: folds
Hero: raises $0.05 to $0.1
ee000096: folds
Uncalled bet ($0.05) returned to Hero
*** SHOWDOWN ***
Hero collected $0.1 from pot
*** SUMMARY ***
Total pot $0.1 | Rake $0 | Jackpot $0 | Bingo $0 | Fortune $0 | Tax $0
Seat 1: 8d479104 (button) folded before Flop (didn't bet)
Seat 2: Hero (small blind) collected ($0.1)
Seat 3: ee000096 (big blind) folded before Flop
Seat 4: f75da158 folded before Flop (didn't bet)
Seat 5: 77d99075 folded before Flop (didn't bet)
Seat 6: 9e28d55 folded before Flop (didn't bet)


Poker Hand #RC3794651813: Hold'em No Limit ($0.02/$0.05) - 2025/08/09 20:24:24
Table 'RushAndCash10827073' 6-max Seat #1 is the button
Seat 1: addec0b4 ($5.36 in chips)
Seat 2: 663ce6b5 ($5 in chips)
Seat 3: e2e1a66a ($6.07 in chips)
Seat 4: fc68174d ($11.66 in chips)
Seat 5: Hero ($4.67 in chips)
Seat 6: fae54529 ($14.86 in chips)
663ce6b5: posts small blind $0.02
e2e1a66a: posts big blind $0.05
*** HOLE CARDS ***
Dealt to addec0b4 
Dealt to 663ce6b5 
Dealt to e2e1a66a 
Dealt to fc68174d 
Dealt to Hero [Kh 4d]
Dealt to fae54529 
fc68174d: folds
Hero: folds
fae54529: folds
addec0b4: raises $0.05 to $0.1
663ce6b5: folds
e2e1a66a: calls $0.05
*** FLOP *** [5s 7h As]
e2e1a66a: checks
addec0b4: bets $0.08
e2e1a66a: calls $0.08
*** TURN *** [5s 7h As] [9s]
e2e1a66a: checks
addec0b4: bets $0.19
e2e1a66a: folds
Uncalled bet ($0.19) returned to addec0b4
*** SHOWDOWN ***
addec0b4 collected $0.37 from pot
*** SUMMARY ***
Total pot $0.38 | Rake $0.01 | Jackpot $0 | Bingo $0 | Fortune $0 | Tax $0
Board [5s 7h As 9s]
Seat 1: addec0b4 (button) won ($0.37)
Seat 2: 663ce6b5 (small blind) folded before Flop
Seat 3: e2e1a66a (big blind) folded on the Turn
Seat 4: fc68174d folded before Flop (didn't bet)
Seat 5: Hero folded before Flop (didn't bet)
Seat 6: fae54529 folded before Flop (didn't bet)


Poker Hand #RC3794651747: Hold'em No Limit ($0.02/$0.05) - 2025/08/09 20:24:13
Table 'RushAndCash10827007' 6-max Seat #1 is the button
Seat 1: 1ad7141a ($5.09 in chips)
Seat 2: a5964a27 ($5.11 in chips)
Seat 3: Hero ($4.72 in chips)
Seat 4: 14d1241d ($4.77 in chips)
Seat 5: 701805a2 ($5.05 in chips)
Seat 6: caf5392e ($9.45 in chips)
a5964a27: posts small blind $0.02
Hero: posts big blind $0.05
*** HOLE CARDS ***
Dealt to 1ad7141a 
Dealt to a5964a27 
Dealt to Hero [Kc 6d]
Dealt to 14d1241d 
Dealt to 701805a2 
Dealt to caf5392e 
14d1241d: raises $0.05 to $0.1
701805a2: calls $0.1
caf5392e: folds
1ad7141a: folds
a5964a27: folds
Hero: folds
*** FLOP *** [4d Tc 6h]
14d1241d: checks
701805a2: bets $0.14
14d1241d: calls $0.14
*** TURN *** [4d Tc 6h] [6s]
14d1241d: checks
701805a2: bets $0.19
14d1241d: folds
Uncalled bet ($0.19) returned to 701805a2
*** SHOWDOWN ***
701805a2 collected $0.53 from pot
*** SUMMARY ***
Total pot $0.55 | Rake $0.02 | Jackpot $0 | Bingo $0 | Fortune $0 | Tax $0
Board [4d Tc 6h 6s]
Seat 1: 1ad7141a (button) folded before Flop (didn't bet)
Seat 2: a5964a27 (small blind) folded before Flop
Seat 3: Hero (big blind) folded before Flop
Seat 4: 14d1241d folded on the Turn
Seat 5: 701805a2 won ($0.53)
Seat 6: caf5392e folded before Flop (didn't bet)


Poker Hand #RC3794651568: Hold'em No Limit ($0.02/$0.05) - 2025/08/09 20:23:43
Table 'RushAndCash10826828' 6-max Seat #1 is the button
Seat 1: Hero ($4.82 in chips)
Seat 2: 5638b75 ($5.66 in chips)
Seat 3: a5964a27 ($5 in chips)
Seat 4: 4df9d96 ($14.29 in chips)
Seat 5: e182ca29 ($9.58 in chips)
Seat 6: 6fb6f50 ($5.07 in chips)
5638b75: posts small blind $0.02
a5964a27: posts big blind $0.05
*** HOLE CARDS ***
Dealt to Hero [Kc 7h]
Dealt to 5638b75 
Dealt to a5964a27 
Dealt to 4df9d96 
Dealt to e182ca29 
Dealt to 6fb6f50 
4df9d96: folds
e182ca29: folds
6fb6f50: folds
Hero: raises $0.05 to $0.1
5638b75: folds
a5964a27: calls $0.05
*** FLOP *** [2c 8h 9d]
a5964a27: checks
Hero: checks
*** TURN *** [2c 8h 9d] [Tc]
a5964a27: bets $0.17
Hero: folds
Uncalled bet ($0.17) returned to a5964a27
*** SHOWDOWN ***
a5964a27 collected $0.21 from pot
*** SUMMARY ***
Total pot $0.22 | Rake $0.01 | Jackpot $0 | Bingo $0 | Fortune $0 | Tax $0
Board [2c 8h 9d Tc]
Seat 1: Hero (button) folded on the Turn
Seat 2: 5638b75 (small blind) folded before Flop
Seat 3: a5964a27 (big blind) won ($0.21)
Seat 4: 4df9d96 folded before Flop (didn't bet)
Seat 5: e182ca29 folded before Flop (didn't bet)
Seat 6: 6fb6f50 folded before Flop (didn't bet)


Poker Hand #RC3794651510: Hold'em No Limit ($0.02/$0.05) - 2025/08/09 20:23:32
Table 'RushAndCash10826770' 6-max Seat #1 is the button
Seat 1: 2eeff014 ($6.76 in chips)
Seat 2: 961a1e1c ($8.05 in chips)
Seat 3: e323cc5d ($16.8 in chips)
Seat 4: Hero ($4.82 in chips)
Seat 5: 10e58c5f ($11.06 in chips)
Seat 6: 76ef6bc6 ($5.15 in chips)
961a1e1c: posts small blind $0.02
e323cc5d: posts big blind $0.05
*** HOLE CARDS ***
Dealt to 2eeff014 
Dealt to 961a1e1c 
Dealt to e323cc5d 
Dealt to Hero [Js Kh]
Dealt to 10e58c5f 
Dealt to 76ef6bc6 
Hero: folds
10e58c5f: raises $0.06 to $0.11
76ef6bc6: folds
2eeff014: folds
961a1e1c: folds
e323cc5d: folds
Uncalled bet ($0.06) returned to 10e58c5f
*** SHOWDOWN ***
10e58c5f collected $0.12 from pot
*** SUMMARY ***
Total pot $0.12 | Rake $0 | Jackpot $0 | Bingo $0 | Fortune $0 | Tax $0
Seat 1: 2eeff014 (button) folded before Flop (didn't bet)
Seat 2: 961a1e1c (small blind) folded before Flop
Seat 3: e323cc5d (big blind) folded before Flop
Seat 4: Hero folded before Flop (didn't bet)
Seat 5: 10e58c5f collected ($0.12)
Seat 6: 76ef6bc6 folded before Flop (didn't bet)


Poker Hand #RC3794651485: Hold'em No Limit ($0.02/$0.05) - 2025/08/09 20:23:28
Table 'RushAndCash10826745' 6-max Seat #1 is the button
Seat 1: 1a95488c ($5.24 in chips)
Seat 2: 98ea3b90 ($12.6 in chips)
Seat 3: 93ae80ff ($6.34 in chips)
Seat 4: 350f67e5 ($5.97 in chips)
Seat 5: Hero ($4.82 in chips)
Seat 6: 5ecac5e0 ($7.49 in chips)
98ea3b90: posts small blind $0.02
93ae80ff: posts big blind $0.05
*** HOLE CARDS ***
Dealt to 1a95488c 
Dealt to 98ea3b90 
Dealt to 93ae80ff 
Dealt to 350f67e5 
Dealt to Hero [8d 3s]
Dealt to 5ecac5e0 
350f67e5: folds
Hero: folds
5ecac5e0: folds
1a95488c: folds
98ea3b90: folds
Uncalled bet ($0.03) returned to 93ae80ff
*** SHOWDOWN ***
93ae80ff collected $0.04 from pot
*** SUMMARY ***
Total pot $0.04 | Rake $0 | Jackpot $0 | Bingo $0 | Fortune $0 | Tax $0
Seat 1: 1a95488c (button) folded before Flop (didn't bet)
Seat 2: 98ea3b90 (small blind) folded before Flop
Seat 3: 93ae80ff (big blind) collected ($0.04)
Seat 4: 350f67e5 folded before Flop (didn't bet)
Seat 5: Hero folded before Flop (didn't bet)
Seat 6: 5ecac5e0 folded before Flop (didn't bet)


Poker Hand #RC3794651452: Hold'em No Limit ($0.02/$0.05) - 2025/08/09 20:23:23
Table 'RushAndCash10826712' 6-max Seat #1 is the button
Seat 1: Hero ($4.82 in chips)
Seat 2: d9b56102 ($4.3 in chips)
Seat 3: 9dd0ec76 ($5.69 in chips)
Seat 4: 7aa9490f ($4.87 in chips)
Seat 5: 71da6f95 ($3.63 in chips)
Seat 6: f8e8f612 ($6.69 in chips)
d9b56102: posts small blind $0.02
9dd0ec76: posts big blind $0.05
*** HOLE CARDS ***
Dealt to Hero [5s Qc]
Dealt to d9b56102 
Dealt to 9dd0ec76 
Dealt to 7aa9490f 
Dealt to 71da6f95 
Dealt to f8e8f612 
7aa9490f: folds
71da6f95: folds
f8e8f612: folds
Hero: folds
d9b56102: calls $0.03
9dd0ec76: checks
*** FLOP *** [8c 6s Qd]
d9b56102: checks
9dd0ec76: checks
*** TURN *** [8c 6s Qd] [2c]
d9b56102: checks
9dd0ec76: checks
*** RIVER *** [8c 6s Qd 2c] [2d]
d9b56102: checks
9dd0ec76: checks
d9b56102: shows [Kh 3h] (a pair of Twos)
9dd0ec76: shows [9h 6c] (two pair, Sixes and Twos)
*** SHOWDOWN ***
9dd0ec76 collected $0.1 from pot
*** SUMMARY ***
Total pot $0.1 | Rake $0 | Jackpot $0 | Bingo $0 | Fortune $0 | Tax $0
Board [8c 6s Qd 2c 2d]
Seat 1: Hero (button) folded before Flop (didn't bet)
Seat 2: d9b56102 (small blind) showed [Kh 3h] and lost with a pair of Twos
Seat 3: 9dd0ec76 (big blind) showed [9h 6c] and won ($0.1) with two pair, Sixes and Twos
Seat 4: 7aa9490f folded before Flop (didn't bet)
Seat 5: 71da6f95 folded before Flop (didn't bet)
Seat 6: f8e8f612 folded before Flop (didn't bet)


Poker Hand #RC3794651154: Hold'em No Limit ($0.02/$0.05) - 2025/08/09 20:22:31
Table 'RushAndCash10826414' 6-max Seat #1 is the button
Seat 1: d9b56102 ($4.45 in chips)
Seat 2: Hero ($4.63 in chips)
Seat 3: 1a39fdc3 ($13.54 in chips)
Seat 4: 5ecac5e0 ($7.44 in chips)
Seat 5: 877da4b ($8.7 in chips)
Seat 6: 67e2bcc9 ($7.73 in chips)
Hero: posts small blind $0.02
1a39fdc3: posts big blind $0.05
*** HOLE CARDS ***
Dealt to d9b56102 
Dealt to Hero [Jc Ad]
Dealt to 1a39fdc3 
Dealt to 5ecac5e0 
Dealt to 877da4b 
Dealt to 67e2bcc9 
5ecac5e0: folds
877da4b: folds
67e2bcc9: folds
d9b56102: raises $0.1 to $0.15
Hero: raises $0.42 to $0.57
1a39fdc3: folds
d9b56102: folds
Uncalled bet ($0.42) returned to Hero
*** SHOWDOWN ***
Hero collected $0.34 from pot
*** SUMMARY ***
Total pot $0.35 | Rake $0.01 | Jackpot $0 | Bingo $0 | Fortune $0 | Tax $0
Seat 1: d9b56102 (button) folded before Flop
Seat 2: Hero (small blind) collected ($0.34)
Seat 3: 1a39fdc3 (big blind) folded before Flop
Seat 4: 5ecac5e0 folded before Flop (didn't bet)
Seat 5: 877da4b folded before Flop (didn't bet)
Seat 6: 67e2bcc9 folded before Flop (didn't bet)


Poker Hand #RC3794650728: Hold'em No Limit ($0.02/$0.05) - 2025/08/09 20:21:23
Table 'RushAndCash10825988' 6-max Seat #1 is the button
Seat 1: 877da4b ($9.35 in chips)
Seat 2: 1a39fdc3 ($12.77 in chips)
Seat 3: Hero ($4.89 in chips)
Seat 4: db656a0c ($9 in chips)
Seat 5: a52b52ce ($3.29 in chips)
Seat 6: 372db579 ($5 in chips)
1a39fdc3: posts small blind $0.02
Hero: posts big blind $0.05
*** HOLE CARDS ***
Dealt to 877da4b 
Dealt to 1a39fdc3 
Dealt to Hero [4d 6d]
Dealt to db656a0c 
Dealt to a52b52ce 
Dealt to 372db579 
db656a0c: folds
a52b52ce: folds
372db579: folds
877da4b: raises $0.08 to $0.13
1a39fdc3: calls $0.11
Hero: calls $0.08
*** FLOP *** [Jd Qd Qc]
1a39fdc3: bets $0.13
Hero: calls $0.13
877da4b: calls $0.13
*** TURN *** [Jd Qd Qc] [2c]
1a39fdc3: checks
Hero: checks
877da4b: bets $0.39
1a39fdc3: calls $0.39
Hero: folds
*** RIVER *** [Jd Qd Qc 2c] [6s]
1a39fdc3: checks
877da4b: checks
1a39fdc3: shows [9h Qh] (three of a kind, Queens)
877da4b: shows [5d 5c] (two pair, Queens and Fives)
*** SHOWDOWN ***
1a39fdc3 collected $1.42 from pot
*** SUMMARY ***
Total pot $1.56 | Rake $0.07 | Jackpot $0.07 | Bingo $0 | Fortune $0 | Tax $0
Board [Jd Qd Qc 2c 6s]
Seat 1: 877da4b (button) showed [5d 5c] and lost with two pair, Queens and Fives
Seat 2: 1a39fdc3 (small blind) showed [9h Qh] and won ($1.42) with three of a kind, Queens
Seat 3: Hero (big blind) folded on the Turn
Seat 4: db656a0c folded before Flop (didn't bet)
Seat 5: a52b52ce folded before Flop (didn't bet)
Seat 6: 372db579 folded before Flop (didn't bet)


Poker Hand #RC3794650709: Hold'em No Limit ($0.02/$0.05) - 2025/08/09 20:21:19
Table 'RushAndCash10825969' 6-max Seat #1 is the button
Seat 1: 6190aad2 ($6.05 in chips)
Seat 2: f642735a ($5 in chips)
Seat 3: ac06365f ($5.41 in chips)
Seat 4: Hero ($4.89 in chips)
Seat 5: 1a39fdc3 ($12.77 in chips)
Seat 6: 893165d0 ($5.12 in chips)
f642735a: posts small blind $0.02
ac06365f: posts big blind $0.05
*** HOLE CARDS ***
Dealt to 6190aad2 
Dealt to f642735a 
Dealt to ac06365f 
Dealt to Hero [6s 5h]
Dealt to 1a39fdc3 
Dealt to 893165d0 
Hero: folds
1a39fdc3: folds
893165d0: folds
6190aad2: folds
f642735a: raises $0.05 to $0.1
ac06365f: calls $0.05
*** FLOP *** [3s 9s Ks]
f642735a: checks
ac06365f: bets $0.08
f642735a: folds
Uncalled bet ($0.08) returned to ac06365f
*** SHOWDOWN ***
ac06365f collected $0.19 from pot
*** SUMMARY ***
Total pot $0.2 | Rake $0.01 | Jackpot $0 | Bingo $0 | Fortune $0 | Tax $0
Board [3s 9s Ks]
Seat 1: 6190aad2 (button) folded before Flop (didn't bet)
Seat 2: f642735a (small blind) folded on the Flop
Seat 3: ac06365f (big blind) won ($0.19)
Seat 4: Hero folded before Flop (didn't bet)
Seat 5: 1a39fdc3 folded before Flop (didn't bet)
Seat 6: 893165d0 folded before Flop (didn't bet)


Poker Hand #RC3794650690: Hold'em No Limit ($0.02/$0.05) - 2025/08/09 20:21:16
Table 'RushAndCash10825950' 6-max Seat #1 is the button
Seat 1: 1a39fdc3 ($12.77 in chips)
Seat 2: cb8a4bf0 ($5.3 in chips)
Seat 3: 82fb97ba ($4.07 in chips)
Seat 4: 407974df ($8.7 in chips)
Seat 5: 5e6670af ($3.9 in chips)
Seat 6: Hero ($4.89 in chips)
cb8a4bf0: posts small blind $0.02
82fb97ba: posts big blind $0.05
*** HOLE CARDS ***
Dealt to 1a39fdc3 
Dealt to cb8a4bf0 
Dealt to 82fb97ba 
Dealt to 407974df 
Dealt to 5e6670af 
Dealt to Hero [5d Ts]
407974df: raises $0.06 to $0.11
5e6670af: raises $0.1 to $0.21
Hero: folds
1a39fdc3: folds
cb8a4bf0: folds
82fb97ba: calls $0.16
407974df: calls $0.1
*** FLOP *** [5s 7c Js]
82fb97ba: bets $0.33
407974df: folds
5e6670af: calls $0.33
*** TURN *** [5s 7c Js] [Qc]
82fb97ba: checks
5e6670af: checks
*** RIVER *** [5s 7c Js Qc] [9s]
82fb97ba: bets $0.66
5e6670af: folds
Uncalled bet ($0.66) returned to 82fb97ba
*** SHOWDOWN ***
82fb97ba collected $1.25 from pot
*** SUMMARY ***
Total pot $1.31 | Rake $0.06 | Jackpot $0 | Bingo $0 | Fortune $0 | Tax $0
Board [5s 7c Js Qc 9s]
Seat 1: 1a39fdc3 (button) folded before Flop (didn't bet)
Seat 2: cb8a4bf0 (small blind) folded before Flop
Seat 3: 82fb97ba (big blind) won ($1.25)
Seat 4: 407974df folded on the Flop
Seat 5: 5e6670af folded on the River
Seat 6: Hero folded before Flop (didn't bet)


Poker Hand #RC3794650670: Hold'em No Limit ($0.02/$0.05) - 2025/08/09 20:21:12
Table 'RushAndCash10825930' 6-max Seat #1 is the button
Seat 1: 566ca6aa ($11.09 in chips)
Seat 2: 8fefc684 ($5 in chips)
Seat 3: 25393235 ($5.96 in chips)
Seat 4: 9bc25ab1 ($9.5 in chips)
Seat 5: 6355c063 ($5 in chips)
Seat 6: Hero ($4.89 in chips)
8fefc684: posts small blind $0.02
25393235: posts big blind $0.05
*** HOLE CARDS ***
Dealt to 566ca6aa 
Dealt to 8fefc684 
Dealt to 25393235 
Dealt to 9bc25ab1 
Dealt to 6355c063 
Dealt to Hero [4s 4d]
9bc25ab1: folds
6355c063: folds
Hero: folds
566ca6aa: folds
8fefc684: folds
Uncalled bet ($0.03) returned to 25393235
*** SHOWDOWN ***
25393235 collected $0.04 from pot
*** SUMMARY ***
Total pot $0.04 | Rake $0 | Jackpot $0 | Bingo $0 | Fortune $0 | Tax $0
Seat 1: 566ca6aa (button) folded before Flop (didn't bet)
Seat 2: 8fefc684 (small blind) folded before Flop
Seat 3: 25393235 (big blind) collected ($0.04)
Seat 4: 9bc25ab1 folded before Flop (didn't bet)
Seat 5: 6355c063 folded before Flop (didn't bet)
Seat 6: Hero folded before Flop (didn't bet)


Poker Hand #RC3794650642: Hold'em No Limit ($0.02/$0.05) - 2025/08/09 20:21:07
Table 'RushAndCash10825902' 6-max Seat #1 is the button
Seat 1: 487893a0 ($3.79 in chips)
Seat 2: 3d1f2d3c ($1.3 in chips)
Seat 3: 803360e6 ($5.91 in chips)
Seat 4: 1038346a ($5.08 in chips)
Seat 5: 41aab34e ($5.81 in chips)
Seat 6: Hero ($4.89 in chips)
3d1f2d3c: posts small blind $0.02
803360e6: posts big blind $0.05
*** HOLE CARDS ***
Dealt to 487893a0 
Dealt to 3d1f2d3c 
Dealt to 803360e6 
Dealt to 1038346a 
Dealt to 41aab34e 
Dealt to Hero [5c 5h]
1038346a: folds
41aab34e: raises $0.09 to $0.14
Hero: folds
487893a0: folds
3d1f2d3c: folds
803360e6: calls $0.09
*** FLOP *** [Th Qd 9s]
803360e6: bets $0.05
41aab34e: raises $0.1 to $0.15
803360e6: calls $0.1
*** TURN *** [Th Qd 9s] [4c]
803360e6: checks
41aab34e: checks
*** RIVER *** [Th Qd 9s 4c] [8h]
803360e6: bets $0.45
41aab34e: calls $0.45
803360e6: shows [Ah Jc] (a straight, Queen to Eight)
41aab34e: shows [9d 9c] (three of a kind, Nines)
*** SHOWDOWN ***
803360e6 collected $1.36 from pot
*** SUMMARY ***
Total pot $1.5 | Rake $0.07 | Jackpot $0.07 | Bingo $0 | Fortune $0 | Tax $0
Board [Th Qd 9s 4c 8h]
Seat 1: 487893a0 (button) folded before Flop (didn't bet)
Seat 2: 3d1f2d3c (small blind) folded before Flop
Seat 3: 803360e6 (big blind) showed [Ah Jc] and won ($1.36) with a straight, Queen to Eight
Seat 4: 1038346a folded before Flop (didn't bet)
Seat 5: 41aab34e showed [9d 9c] and lost with three of a kind, Nines
Seat 6: Hero folded before Flop (didn't bet)


Poker Hand #RC3794650590: Hold'em No Limit ($0.02/$0.05) - 2025/08/09 20:20:57
Table 'RushAndCash10825850' 6-max Seat #1 is the button
Seat 1: 22cfde96 ($7.22 in chips)
Seat 2: Hero ($4.91 in chips)
Seat 3: 93ae80ff ($6.39 in chips)
Seat 4: 43ec0d17 ($5 in chips)
Seat 5: 2e368438 ($6.44 in chips)
Seat 6: 7fe65f8a ($5.1 in chips)
Hero: posts small blind $0.02
93ae80ff: posts big blind $0.05
*** HOLE CARDS ***
Dealt to 22cfde96 
Dealt to Hero [4s 5c]
Dealt to 93ae80ff 
Dealt to 43ec0d17 
Dealt to 2e368438 
Dealt to 7fe65f8a 
43ec0d17: folds
2e368438: folds
7fe65f8a: folds
22cfde96: folds
Hero: folds
Uncalled bet ($0.03) returned to 93ae80ff
*** SHOWDOWN ***
93ae80ff collected $0.04 from pot
*** SUMMARY ***
Total pot $0.04 | Rake $0 | Jackpot $0 | Bingo $0 | Fortune $0 | Tax $0
Seat 1: 22cfde96 (button) folded before Flop (didn't bet)
Seat 2: Hero (small blind) folded before Flop
Seat 3: 93ae80ff (big blind) collected ($0.04)
Seat 4: 43ec0d17 folded before Flop (didn't bet)
Seat 5: 2e368438 folded before Flop (didn't bet)
Seat 6: 7fe65f8a folded before Flop (didn't bet)


Poker Hand #RC3794650500: Hold'em No Limit ($0.02/$0.05) - 2025/08/09 20:20:42
Table 'RushAndCash10825760' 6-max Seat #1 is the button
Seat 1: Hero ($4.91 in chips)
Seat 2: 422e6720 ($6.79 in chips)
Seat 3: f80f4e3f ($6.81 in chips)
Seat 4: 7c382b20 ($9.08 in chips)
Seat 5: f87e4345 ($5.6 in chips)
Seat 6: 1c9f0219 ($18.63 in chips)
422e6720: posts small blind $0.02
f80f4e3f: posts big blind $0.05
*** HOLE CARDS ***
Dealt to Hero [5s 2c]
Dealt to 422e6720 
Dealt to f80f4e3f 
Dealt to 7c382b20 
Dealt to f87e4345 
Dealt to 1c9f0219 
7c382b20: folds
f87e4345: folds
1c9f0219: raises $0.05 to $0.1
Hero: folds
422e6720: folds
f80f4e3f: folds
Uncalled bet ($0.05) returned to 1c9f0219
*** SHOWDOWN ***
1c9f0219 collected $0.12 from pot
*** SUMMARY ***
Total pot $0.12 | Rake $0 | Jackpot $0 | Bingo $0 | Fortune $0 | Tax $0
Seat 1: Hero (button) folded before Flop (didn't bet)
Seat 2: 422e6720 (small blind) folded before Flop
Seat 3: f80f4e3f (big blind) folded before Flop
Seat 4: 7c382b20 folded before Flop (didn't bet)
Seat 5: f87e4345 folded before Flop (didn't bet)
Seat 6: 1c9f0219 collected ($0.12)


Poker Hand #RC3794650302: Hold'em No Limit ($0.02/$0.05) - 2025/08/09 20:20:09
Table 'RushAndCash10825562' 6-max Seat #1 is the button
Seat 1: 5087f885 ($3.22 in chips)
Seat 2: 668c63b1 ($11 in chips)
Seat 3: Hero ($5.01 in chips)
Seat 4: 7c382b20 ($8.97 in chips)
Seat 5: 94f944fe ($4.45 in chips)
Seat 6: 99d7f159 ($5.93 in chips)
668c63b1: posts small blind $0.02
Hero: posts big blind $0.05
*** HOLE CARDS ***
Dealt to 5087f885 
Dealt to 668c63b1 
Dealt to Hero [2s 3s]
Dealt to 7c382b20 
Dealt to 94f944fe 
Dealt to 99d7f159 
7c382b20: calls $0.05
94f944fe: folds
99d7f159: folds
5087f885: folds
668c63b1: folds
Hero: checks
*** FLOP *** [Jd 7c Qh]
Hero: checks
7c382b20: checks
*** TURN *** [Jd 7c Qh] [Kc]
Hero: checks
7c382b20: checks
*** RIVER *** [Jd 7c Qh Kc] [Ks]
Hero: bets $0.05
7c382b20: calls $0.05
Hero: shows [2s 3s] (a pair of Kings)
7c382b20: shows [Ac 8s] (a pair of Kings)
*** SHOWDOWN ***
7c382b20 collected $0.21 from pot
*** SUMMARY ***
Total pot $0.22 | Rake $0.01 | Jackpot $0 | Bingo $0 | Fortune $0 | Tax $0
Board [Jd 7c Qh Kc Ks]
Seat 1: 5087f885 (button) folded before Flop (didn't bet)
Seat 2: 668c63b1 (small blind) folded before Flop
Seat 3: Hero (big blind) showed [2s 3s] and lost with a pair of Kings
Seat 4: 7c382b20 showed [Ac 8s] and won ($0.21) with a pair of Kings
Seat 5: 94f944fe folded before Flop (didn't bet)
Seat 6: 99d7f159 folded before Flop (didn't bet)


Poker Hand #RC3794650180: Hold'em No Limit ($0.02/$0.05) - 2025/08/09 20:19:50
Table 'RushAndCash10825440' 6-max Seat #1 is the button
Seat 1: 5aeb0c1d ($12.02 in chips)
Seat 2: 3c9f1b9d ($5.48 in chips)
Seat 3: 66fd6ecb ($6.81 in chips)
Seat 4: 2eeff014 ($7.09 in chips)
Seat 5: 690334e3 ($4.01 in chips)
Seat 6: Hero ($4.94 in chips)
3c9f1b9d: posts small blind $0.02
66fd6ecb: posts big blind $0.05
*** HOLE CARDS ***
Dealt to 5aeb0c1d 
Dealt to 3c9f1b9d 
Dealt to 66fd6ecb 
Dealt to 2eeff014 
Dealt to 690334e3 
Dealt to Hero [Kc Jh]
2eeff014: folds
690334e3: folds
Hero: raises $0.05 to $0.1
5aeb0c1d: folds
3c9f1b9d: folds
66fd6ecb: folds
Uncalled bet ($0.05) returned to Hero
*** SHOWDOWN ***
Hero collected $0.12 from pot
*** SUMMARY ***
Total pot $0.12 | Rake $0 | Jackpot $0 | Bingo $0 | Fortune $0 | Tax $0
Seat 1: 5aeb0c1d (button) folded before Flop (didn't bet)
Seat 2: 3c9f1b9d (small blind) folded before Flop
Seat 3: 66fd6ecb (big blind) folded before Flop
Seat 4: 2eeff014 folded before Flop (didn't bet)
Seat 5: 690334e3 folded before Flop (didn't bet)
Seat 6: Hero collected ($0.12)


Poker Hand #RC3794650156: Hold'em No Limit ($0.02/$0.05) - 2025/08/09 20:19:46
Table 'RushAndCash10825416' 6-max Seat #1 is the button
Seat 1: 19b47859 ($14.66 in chips)
Seat 2: 10df8c47 ($5.02 in chips)
Seat 3: 96624292 ($3.63 in chips)
Seat 4: 13d139b4 ($8.38 in chips)
Seat 5: Hero ($4.94 in chips)
Seat 6: 16979a44 ($5.44 in chips)
10df8c47: posts small blind $0.02
96624292: posts big blind $0.05
*** HOLE CARDS ***
Dealt to 19b47859 
Dealt to 10df8c47 
Dealt to 96624292 
Dealt to 13d139b4 
Dealt to Hero [Qs 2h]
Dealt to 16979a44 
13d139b4: folds
Hero: folds
16979a44: folds
19b47859: raises $0.07 to $0.12
10df8c47: folds
96624292: folds
Uncalled bet ($0.07) returned to 19b47859
*** SHOWDOWN ***
19b47859 collected $0.12 from pot
*** SUMMARY ***
Total pot $0.12 | Rake $0 | Jackpot $0 | Bingo $0 | Fortune $0 | Tax $0
Seat 1: 19b47859 (button) collected ($0.12)
Seat 2: 10df8c47 (small blind) folded before Flop
Seat 3: 96624292 (big blind) folded before Flop
Seat 4: 13d139b4 folded before Flop (didn't bet)
Seat 5: Hero folded before Flop (didn't bet)
Seat 6: 16979a44 folded before Flop (didn't bet)


Poker Hand #RC3794650130: Hold'em No Limit ($0.02/$0.05) - 2025/08/09 20:19:42
Table 'RushAndCash10825390' 6-max Seat #1 is the button
Seat 1: 734169f9 ($10.54 in chips)
Seat 2: b270c307 ($5.28 in chips)
Seat 3: 10df8c47 ($5.07 in chips)
Seat 4: Hero ($4.94 in chips)
Seat 5: 2fb6b299 ($5.75 in chips)
Seat 6: e77308da ($5.05 in chips)
b270c307: posts small blind $0.02
10df8c47: posts big blind $0.05
*** HOLE CARDS ***
Dealt to 734169f9 
Dealt to b270c307 
Dealt to 10df8c47 
Dealt to Hero [Js 4c]
Dealt to 2fb6b299 
Dealt to e77308da 
Hero: folds
2fb6b299: folds
e77308da: folds
734169f9: folds
b270c307: raises $0.1 to $0.15
10df8c47: folds
Uncalled bet ($0.1) returned to b270c307
*** SHOWDOWN ***
b270c307 collected $0.1 from pot
*** SUMMARY ***
Total pot $0.1 | Rake $0 | Jackpot $0 | Bingo $0 | Fortune $0 | Tax $0
Seat 1: 734169f9 (button) folded before Flop (didn't bet)
Seat 2: b270c307 (small blind) collected ($0.1)
Seat 3: 10df8c47 (big blind) folded before Flop
Seat 4: Hero folded before Flop (didn't bet)
Seat 5: 2fb6b299 folded before Flop (didn't bet)
Seat 6: e77308da folded before Flop (didn't bet)


Poker Hand #RC3794650086: Hold'em No Limit ($0.02/$0.05) - 2025/08/09 20:19:34
Table 'RushAndCash10825346' 6-max Seat #1 is the button
Seat 1: Hero ($4.94 in chips)
Seat 2: 4a5a413c ($5.21 in chips)
Seat 3: 60c6f1bd ($7.12 in chips)
Seat 4: 5aeb0c1d ($12.07 in chips)
Seat 5: f95b915f ($5 in chips)
Seat 6: ecc56a27 ($7.68 in chips)
4a5a413c: posts small blind $0.02
60c6f1bd: posts big blind $0.05
*** HOLE CARDS ***
Dealt to Hero [Qd 5h]
Dealt to 4a5a413c 
Dealt to 60c6f1bd 
Dealt to 5aeb0c1d 
Dealt to f95b915f 
Dealt to ecc56a27 
5aeb0c1d: folds
f95b915f: folds
ecc56a27: folds
Hero: folds
4a5a413c: raises $0.1 to $0.15
60c6f1bd: calls $0.1
*** FLOP *** [8c 5s As]
4a5a413c: checks
60c6f1bd: checks
*** TURN *** [8c 5s As] [2h]
4a5a413c: bets $0.35
60c6f1bd: folds
Uncalled bet ($0.35) returned to 4a5a413c
*** SHOWDOWN ***
4a5a413c collected $0.29 from pot
*** SUMMARY ***
Total pot $0.3 | Rake $0.01 | Jackpot $0 | Bingo $0 | Fortune $0 | Tax $0
Board [8c 5s As 2h]
Seat 1: Hero (button) folded before Flop (didn't bet)
Seat 2: 4a5a413c (small blind) won ($0.29)
Seat 3: 60c6f1bd (big blind) folded on the Turn
Seat 4: 5aeb0c1d folded before Flop (didn't bet)
Seat 5: f95b915f folded before Flop (didn't bet)
Seat 6: ecc56a27 folded before Flop (didn't bet)


Poker Hand #RC3794650014: Hold'em No Limit ($0.02/$0.05) - 2025/08/09 20:19:20
Table 'RushAndCash10825274' 6-max Seat #1 is the button
Seat 1: 9c128641 ($5.33 in chips)
Seat 2: Hero ($4.96 in chips)
Seat 3: c957dd13 ($9.06 in chips)
Seat 4: 10df8c47 ($5 in chips)
Seat 5: b270c307 ($5.33 in chips)
Seat 6: 668c63b1 ($11.05 in chips)
Hero: posts small blind $0.02
c957dd13: posts big blind $0.05
*** HOLE CARDS ***
Dealt to 9c128641 
Dealt to Hero [Qc 8h]
Dealt to c957dd13 
Dealt to 10df8c47 
Dealt to b270c307 
Dealt to 668c63b1 
10df8c47: folds
b270c307: folds
668c63b1: folds
9c128641: raises $0.05 to $0.1
Hero: folds
c957dd13: calls $0.05
*** FLOP *** [Kc 8d 6c]
c957dd13: checks
9c128641: checks
*** TURN *** [Kc 8d 6c] [8c]
c957dd13: checks
9c128641: checks
*** RIVER *** [Kc 8d 6c 8c] [Jh]
c957dd13: bets $0.08
9c128641: folds
Uncalled bet ($0.08) returned to c957dd13
*** SHOWDOWN ***
c957dd13 collected $0.21 from pot
*** SUMMARY ***
Total pot $0.22 | Rake $0.01 | Jackpot $0 | Bingo $0 | Fortune $0 | Tax $0
Board [Kc 8d 6c 8c Jh]
Seat 1: 9c128641 (button) folded on the River
Seat 2: Hero (small blind) folded before Flop
Seat 3: c957dd13 (big blind) won ($0.21)
Seat 4: 10df8c47 folded before Flop (didn't bet)
Seat 5: b270c307 folded before Flop (didn't bet)
Seat 6: 668c63b1 folded before Flop (didn't bet)


Poker Hand #RC3794649923: Hold'em No Limit ($0.02/$0.05) - 2025/08/09 20:19:06
Table 'RushAndCash10825183' 6-max Seat #1 is the button
Seat 1: 1a39fdc3 ($11.7 in chips)
Seat 2: 96134fe8 ($5 in chips)
Seat 3: Hero ($5.01 in chips)
Seat 4: 3f63937d ($6.52 in chips)
Seat 5: 9fa787cc ($6.13 in chips)
Seat 6: 43d0a198 ($7.29 in chips)
96134fe8: posts small blind $0.02
Hero: posts big blind $0.05
*** HOLE CARDS ***
Dealt to 1a39fdc3 
Dealt to 96134fe8 
Dealt to Hero [9h 4d]
Dealt to 3f63937d 
Dealt to 9fa787cc 
Dealt to 43d0a198 
3f63937d: folds
9fa787cc: raises $0.05 to $0.1
43d0a198: folds
1a39fdc3: folds
96134fe8: folds
Hero: folds
Uncalled bet ($0.05) returned to 9fa787cc
*** SHOWDOWN ***
9fa787cc collected $0.12 from pot
*** SUMMARY ***
Total pot $0.12 | Rake $0 | Jackpot $0 | Bingo $0 | Fortune $0 | Tax $0
Seat 1: 1a39fdc3 (button) folded before Flop (didn't bet)
Seat 2: 96134fe8 (small blind) folded before Flop
Seat 3: Hero (big blind) folded before Flop
Seat 4: 3f63937d folded before Flop (didn't bet)
Seat 5: 9fa787cc collected ($0.12)
Seat 6: 43d0a198 folded before Flop (didn't bet)


Poker Hand #RC3794649900: Hold'em No Limit ($0.02/$0.05) - 2025/08/09 20:19:03
Table 'RushAndCash10825160' 6-max Seat #1 is the button
Seat 1: 8814b7ca ($5.18 in chips)
Seat 2: 5e6670af ($3.91 in chips)
Seat 3: 96134fe8 ($5 in chips)
Seat 4: 407974df ($10.34 in chips)
Seat 5: Hero ($5.01 in chips)
Seat 6: 67e2bcc9 ($7.99 in chips)
5e6670af: posts small blind $0.02
96134fe8: posts big blind $0.05
*** HOLE CARDS ***
Dealt to 8814b7ca 
Dealt to 5e6670af 
Dealt to 96134fe8 
Dealt to 407974df 
Dealt to Hero [Qh 7c]
Dealt to 67e2bcc9 
407974df: folds
Hero: folds
67e2bcc9: folds
8814b7ca: folds
5e6670af: raises $0.05 to $0.1
96134fe8: folds
Uncalled bet ($0.05) returned to 5e6670af
*** SHOWDOWN ***
5e6670af collected $0.1 from pot
*** SUMMARY ***
Total pot $0.1 | Rake $0 | Jackpot $0 | Bingo $0 | Fortune $0 | Tax $0
Seat 1: 8814b7ca (button) folded before Flop (didn't bet)
Seat 2: 5e6670af (small blind) collected ($0.1)
Seat 3: 96134fe8 (big blind) folded before Flop
Seat 4: 407974df folded before Flop (didn't bet)
Seat 5: Hero folded before Flop (didn't bet)
Seat 6: 67e2bcc9 folded before Flop (didn't bet)


Poker Hand #RC3794649876: Hold'em No Limit ($0.02/$0.05) - 2025/08/09 20:18:59
Table 'RushAndCash10825136' 6-max Seat #1 is the button
Seat 1: 690334e3 ($4.26 in chips)
Seat 2: 52831a4a ($2.82 in chips)
Seat 3: 7fe65f8a ($5.07 in chips)
Seat 4: 7ec38d90 ($5 in chips)
Seat 5: Hero ($5.01 in chips)
Seat 6: 93ae80ff ($6.65 in chips)
52831a4a: posts small blind $0.02
7fe65f8a: posts big blind $0.05
*** HOLE CARDS ***
Dealt to 690334e3 
Dealt to 52831a4a 
Dealt to 7fe65f8a 
Dealt to 7ec38d90 
Dealt to Hero [4s 6h]
Dealt to 93ae80ff 
7ec38d90: folds
Hero: folds
93ae80ff: calls $0.05
690334e3: folds
52831a4a: folds
7fe65f8a: checks
*** FLOP *** [9d Tc Td]
7fe65f8a: checks
93ae80ff: checks
*** TURN *** [9d Tc Td] [Th]
7fe65f8a: checks
93ae80ff: checks
*** RIVER *** [9d Tc Td Th] [6c]
7fe65f8a: checks
93ae80ff: bets $0.09
7fe65f8a: folds
Uncalled bet ($0.09) returned to 93ae80ff
*** SHOWDOWN ***
93ae80ff collected $0.12 from pot
*** SUMMARY ***
Total pot $0.12 | Rake $0 | Jackpot $0 | Bingo $0 | Fortune $0 | Tax $0
Board [9d Tc Td Th 6c]
Seat 1: 690334e3 (button) folded before Flop (didn't bet)
Seat 2: 52831a4a (small blind) folded before Flop
Seat 3: 7fe65f8a (big blind) folded on the River
Seat 4: 7ec38d90 folded before Flop (didn't bet)
Seat 5: Hero folded before Flop (didn't bet)
Seat 6: 93ae80ff won ($0.12)


Poker Hand #RC3794649853: Hold'em No Limit ($0.02/$0.05) - 2025/08/09 20:18:56
Table 'RushAndCash10825113' 6-max Seat #1 is the button
Seat 1: 52831a4a ($2.82 in chips)
Seat 2: c038e514 ($1.37 in chips)
Seat 3: 791a0094 ($5.35 in chips)
Seat 4: Hero ($5.01 in chips)
Seat 5: e56bda5e ($4.57 in chips)
Seat 6: 15b6aa91 ($5.63 in chips)
c038e514: posts small blind $0.02
791a0094: posts big blind $0.05
*** HOLE CARDS ***
Dealt to 52831a4a 
Dealt to c038e514 
Dealt to 791a0094 
Dealt to Hero [Tc 6c]
Dealt to e56bda5e 
Dealt to 15b6aa91 
Hero: folds
e56bda5e: folds
15b6aa91: folds
52831a4a: folds
c038e514: folds
Uncalled bet ($0.03) returned to 791a0094
*** SHOWDOWN ***
791a0094 collected $0.04 from pot
*** SUMMARY ***
Total pot $0.04 | Rake $0 | Jackpot $0 | Bingo $0 | Fortune $0 | Tax $0
Seat 1: 52831a4a (button) folded before Flop (didn't bet)
Seat 2: c038e514 (small blind) folded before Flop
Seat 3: 791a0094 (big blind) collected ($0.04)
Seat 4: Hero folded before Flop (didn't bet)
Seat 5: e56bda5e folded before Flop (didn't bet)
Seat 6: 15b6aa91 folded before Flop (didn't bet)


Poker Hand #RC3794649530: Hold'em No Limit ($0.02/$0.05) - 2025/08/09 20:18:01
Table 'RushAndCash10824790' 6-max Seat #1 is the button
Seat 1: 15b6aa91 ($5.47 in chips)
Seat 2: 9c843316 ($5.07 in chips)
Seat 3: f4379cef ($5.17 in chips)
Seat 4: c957dd13 ($9.2 in chips)
Seat 5: cefc746 ($4.27 in chips)
Seat 6: Hero ($5.11 in chips)
9c843316: posts small blind $0.02
f4379cef: posts big blind $0.05
*** HOLE CARDS ***
Dealt to 15b6aa91 
Dealt to 9c843316 
Dealt to f4379cef 
Dealt to c957dd13 
Dealt to cefc746 
Dealt to Hero [Tc Js]
c957dd13: folds
cefc746: folds
Hero: raises $0.05 to $0.1
15b6aa91: calls $0.1
9c843316: folds
f4379cef: folds
*** FLOP *** [Ah 5s As]
Hero: checks
15b6aa91: checks
*** TURN *** [Ah 5s As] [Qc]
Hero: checks
15b6aa91: checks
*** RIVER *** [Ah 5s As Qc] [7s]
Hero: checks
15b6aa91: checks
Hero: shows [Tc Js] (a pair of Aces)
15b6aa91: shows [7c 8c] (two pair, Aces and Sevens)
*** SHOWDOWN ***
15b6aa91 collected $0.26 from pot
*** SUMMARY ***
Total pot $0.27 | Rake $0.01 | Jackpot $0 | Bingo $0 | Fortune $0 | Tax $0
Board [Ah 5s As Qc 7s]
Seat 1: 15b6aa91 (button) showed [7c 8c] and won ($0.26) with two pair, Aces and Sevens
Seat 2: 9c843316 (small blind) folded before Flop
Seat 3: f4379cef (big blind) folded before Flop
Seat 4: c957dd13 folded before Flop (didn't bet)
Seat 5: cefc746 folded before Flop (didn't bet)
Seat 6: Hero showed [Tc Js] and lost with a pair of Aces


Poker Hand #RC3794649463: Hold'em No Limit ($0.02/$0.05) - 2025/08/09 20:17:49
Table 'RushAndCash10824723' 6-max Seat #1 is the button
Seat 1: 34eb3d81 ($5.54 in chips)
Seat 2: Hero ($5.13 in chips)
Seat 3: 183d1f0c ($2.56 in chips)
Seat 4: ab0f9e83 ($5 in chips)
Seat 5: 6b07d62c ($5.32 in chips)
Seat 6: 4df9d96 ($11.38 in chips)
Hero: posts small blind $0.02
183d1f0c: posts big blind $0.05
*** HOLE CARDS ***
Dealt to 34eb3d81 
Dealt to Hero [4d Qd]
Dealt to 183d1f0c 
Dealt to ab0f9e83 
Dealt to 6b07d62c 
Dealt to 4df9d96 
ab0f9e83: folds
6b07d62c: folds
4df9d96: raises $0.07 to $0.12
34eb3d81: folds
Hero: folds
183d1f0c: folds
Uncalled bet ($0.07) returned to 4df9d96
*** SHOWDOWN ***
4df9d96 collected $0.12 from pot
*** SUMMARY ***
Total pot $0.12 | Rake $0 | Jackpot $0 | Bingo $0 | Fortune $0 | Tax $0
Seat 1: 34eb3d81 (button) folded before Flop (didn't bet)
Seat 2: Hero (small blind) folded before Flop
Seat 3: 183d1f0c (big blind) folded before Flop
Seat 4: ab0f9e83 folded before Flop (didn't bet)
Seat 5: 6b07d62c folded before Flop (didn't bet)
Seat 6: 4df9d96 collected ($0.12)


Poker Hand #RC3794649375: Hold'em No Limit ($0.02/$0.05) - 2025/08/09 20:17:34
Table 'RushAndCash10824635' 6-max Seat #1 is the button
Seat 1: cb8a4bf0 ($5 in chips)
Seat 2: 8906266 ($6.32 in chips)
Seat 3: Hero ($5.11 in chips)
Seat 4: 6d3ecd55 ($5.02 in chips)
Seat 5: e61ba ($5.68 in chips)
Seat 6: 781d2ec4 ($2.79 in chips)
8906266: posts small blind $0.02
Hero: posts big blind $0.05
*** HOLE CARDS ***
Dealt to cb8a4bf0 
Dealt to 8906266 
Dealt to Hero [Jh 7h]
Dealt to 6d3ecd55 
Dealt to e61ba 
Dealt to 781d2ec4 
6d3ecd55: folds
e61ba: folds
781d2ec4: folds
cb8a4bf0: folds
8906266: folds
Uncalled bet ($0.03) returned to Hero
*** SHOWDOWN ***
Hero collected $0.04 from pot
*** SUMMARY ***
Total pot $0.04 | Rake $0 | Jackpot $0 | Bingo $0 | Fortune $0 | Tax $0
Seat 1: cb8a4bf0 (button) folded before Flop (didn't bet)
Seat 2: 8906266 (small blind) folded before Flop
Seat 3: Hero (big blind) collected ($0.04)
Seat 4: 6d3ecd55 folded before Flop (didn't bet)
Seat 5: e61ba folded before Flop (didn't bet)
Seat 6: 781d2ec4 folded before Flop (didn't bet)


Poker Hand #RC3794649312: Hold'em No Limit ($0.02/$0.05) - 2025/08/09 20:17:24
Table 'RushAndCash10824572' 6-max Seat #1 is the button
Seat 1: Hero ($5.11 in chips)
Seat 2: 1a39fdc3 ($12.48 in chips)
Seat 3: a1801e2f ($5 in chips)
Seat 4: 20955084 ($5.88 in chips)
Seat 5: 94f944fe ($3.85 in chips)
Seat 6: 9fa787cc ($6.29 in chips)
1a39fdc3: posts small blind $0.02
a1801e2f: posts big blind $0.05
*** HOLE CARDS ***
Dealt to Hero [As Td]
Dealt to 1a39fdc3 
Dealt to a1801e2f 
Dealt to 20955084 
Dealt to 94f944fe 
Dealt to 9fa787cc 
20955084: folds
94f944fe: calls $0.05
9fa787cc: raises $0.1 to $0.15
Hero: folds
1a39fdc3: calls $0.13
a1801e2f: folds
94f944fe: calls $0.1
*** FLOP *** [5c Jh 6s]
1a39fdc3: checks
94f944fe: checks
9fa787cc: bets $0.38
1a39fdc3: calls $0.38
94f944fe: raises $3.32 to $3.7 and is all-in
9fa787cc: folds
1a39fdc3: folds
Uncalled bet ($3.32) returned to 94f944fe
*** SHOWDOWN ***
94f944fe collected $1.5 from pot
*** SUMMARY ***
Total pot $1.64 | Rake $0.07 | Jackpot $0.07 | Bingo $0 | Fortune $0 | Tax $0
Board [5c Jh 6s]
Seat 1: Hero (button) folded before Flop (didn't bet)
Seat 2: 1a39fdc3 (small blind) folded on the Flop
Seat 3: a1801e2f (big blind) folded before Flop
Seat 4: 20955084 folded before Flop (didn't bet)
Seat 5: 94f944fe won ($1.5)
Seat 6: 9fa787cc folded on the Flop


Poker Hand #RC3794649281: Hold'em No Limit ($0.02/$0.05) - 2025/08/09 20:17:19
Table 'RushAndCash10824541' 6-max Seat #1 is the button
Seat 1: 8e5ca1c9 ($11.31 in chips)
Seat 2: 902a5491 ($5.41 in chips)
Seat 3: e670ea93 ($8.44 in chips)
Seat 4: Hero ($5.11 in chips)
Seat 5: 17b2485e ($5.1 in chips)
Seat 6: 806d731 ($4.77 in chips)
902a5491: posts small blind $0.02
e670ea93: posts big blind $0.05
*** HOLE CARDS ***
Dealt to 8e5ca1c9 
Dealt to 902a5491 
Dealt to e670ea93 
Dealt to Hero [Ks 7h]
Dealt to 17b2485e 
Dealt to 806d731 
Hero: folds
17b2485e: folds
806d731: folds
8e5ca1c9: folds
902a5491: folds
Uncalled bet ($0.03) returned to e670ea93
*** SHOWDOWN ***
e670ea93 collected $0.04 from pot
*** SUMMARY ***
Total pot $0.04 | Rake $0 | Jackpot $0 | Bingo $0 | Fortune $0 | Tax $0
Seat 1: 8e5ca1c9 (button) folded before Flop (didn't bet)
Seat 2: 902a5491 (small blind) folded before Flop
Seat 3: e670ea93 (big blind) collected ($0.04)
Seat 4: Hero folded before Flop (didn't bet)
Seat 5: 17b2485e folded before Flop (didn't bet)
Seat 6: 806d731 folded before Flop (didn't bet)


Poker Hand #RC3794649259: Hold'em No Limit ($0.02/$0.05) - 2025/08/09 20:17:16
Table 'RushAndCash10824519' 6-max Seat #1 is the button
Seat 1: 372db579 ($5 in chips)
Seat 2: 82647319 ($5.06 in chips)
Seat 3: f5de5b66 ($11.68 in chips)
Seat 4: 3beeefcf ($8.32 in chips)
Seat 5: ada030ad ($3.72 in chips)
Seat 6: Hero ($5.11 in chips)
82647319: posts small blind $0.02
f5de5b66: posts big blind $0.05
*** HOLE CARDS ***
Dealt to 372db579 
Dealt to 82647319 
Dealt to f5de5b66 
Dealt to 3beeefcf 
Dealt to ada030ad 
Dealt to Hero [2h 8c]
3beeefcf: folds
ada030ad: folds
Hero: folds
372db579: folds
82647319: raises $0.08 to $0.13
f5de5b66: raises $0.37 to $0.5
82647319: calls $0.37
*** FLOP *** [Ts 3s 5h]
82647319: checks
f5de5b66: bets $0.5
82647319: folds
Uncalled bet ($0.5) returned to f5de5b66
*** SHOWDOWN ***
f5de5b66 collected $0.95 from pot
*** SUMMARY ***
Total pot $1 | Rake $0.05 | Jackpot $0 | Bingo $0 | Fortune $0 | Tax $0
Board [Ts 3s 5h]
Seat 1: 372db579 (button) folded before Flop (didn't bet)
Seat 2: 82647319 (small blind) folded on the Flop
Seat 3: f5de5b66 (big blind) won ($0.95)
Seat 4: 3beeefcf folded before Flop (didn't bet)
Seat 5: ada030ad folded before Flop (didn't bet)
Seat 6: Hero folded before Flop (didn't bet)


Poker Hand #RC3794648829: Hold'em No Limit ($0.02/$0.05) - 2025/08/09 20:16:03
Table 'RushAndCash10824089' 6-max Seat #1 is the button
Seat 1: Hero ($5.21 in chips)
Seat 2: 577c89cb ($5.87 in chips)
Seat 3: 4df9d96 ($11.04 in chips)
Seat 4: 681ce6e1 ($9.93 in chips)
Seat 5: dff426f5 ($12.15 in chips)
Seat 6: 9c843316 ($5 in chips)
577c89cb: posts small blind $0.02
4df9d96: posts big blind $0.05
*** HOLE CARDS ***
Dealt to Hero [8s Ac]
Dealt to 577c89cb 
Dealt to 4df9d96 
Dealt to 681ce6e1 
Dealt to dff426f5 
Dealt to 9c843316 
681ce6e1: folds
dff426f5: folds
9c843316: folds
Hero: raises $0.05 to $0.1
577c89cb: folds
4df9d96: calls $0.05
*** FLOP *** [Jd 2h 3c]
4df9d96: checks
Hero: checks
*** TURN *** [Jd 2h 3c] [Jh]
4df9d96: checks
Hero: checks
*** RIVER *** [Jd 2h 3c Jh] [5s]
4df9d96: checks
Hero: checks
4df9d96: shows [3s Ks] (two pair, Jacks and Threes)
Hero: shows [8s Ac] (a pair of Jacks)
*** SHOWDOWN ***
4df9d96 collected $0.21 from pot
*** SUMMARY ***
Total pot $0.22 | Rake $0.01 | Jackpot $0 | Bingo $0 | Fortune $0 | Tax $0
Board [Jd 2h 3c Jh 5s]
Seat 1: Hero (button) showed [8s Ac] and lost with a pair of Jacks
Seat 2: 577c89cb (small blind) folded before Flop
Seat 3: 4df9d96 (big blind) showed [3s Ks] and won ($0.21) with two pair, Jacks and Threes
Seat 4: 681ce6e1 folded before Flop (didn't bet)
Seat 5: dff426f5 folded before Flop (didn't bet)
Seat 6: 9c843316 folded before Flop (didn't bet)


Poker Hand #RC3794648540: Hold'em No Limit ($0.02/$0.05) - 2025/08/09 20:15:16
Table 'RushAndCash10823800' 6-max Seat #1 is the button
Seat 1: f9619147 ($4.77 in chips)
Seat 2: Hero ($5.57 in chips)
Seat 3: 1ffc6e5a ($5.09 in chips)
Seat 4: e77308da ($5.19 in chips)
Seat 5: 681ce6e1 ($9.55 in chips)
Seat 6: ea842dd0 ($5.81 in chips)
Hero: posts small blind $0.02
1ffc6e5a: posts big blind $0.05
*** HOLE CARDS ***
Dealt to f9619147 
Dealt to Hero [Jc Ah]
Dealt to 1ffc6e5a 
Dealt to e77308da 
Dealt to 681ce6e1 
Dealt to ea842dd0 
e77308da: folds
681ce6e1: raises $0.06 to $0.11
ea842dd0: folds
f9619147: folds
Hero: raises $0.25 to $0.36
1ffc6e5a: folds
681ce6e1: calls $0.25
*** FLOP *** [9h Ks 9d]
Hero: checks
681ce6e1: checks
*** TURN *** [9h Ks 9d] [Qh]
Hero: checks
681ce6e1: bets $0.62
Hero: folds
Uncalled bet ($0.62) returned to 681ce6e1
*** SHOWDOWN ***
681ce6e1 collected $0.74 from pot
*** SUMMARY ***
Total pot $0.77 | Rake $0.03 | Jackpot $0 | Bingo $0 | Fortune $0 | Tax $0
Board [9h Ks 9d Qh]
Seat 1: f9619147 (button) folded before Flop (didn't bet)
Seat 2: Hero (small blind) folded on the Turn
Seat 3: 1ffc6e5a (big blind) folded before Flop
Seat 4: e77308da folded before Flop (didn't bet)
Seat 5: 681ce6e1 won ($0.74)
Seat 6: ea842dd0 folded before Flop (didn't bet)


Poker Hand #RC3794648463: Hold'em No Limit ($0.02/$0.05) - 2025/08/09 20:15:03
Table 'RushAndCash10823723' 6-max Seat #1 is the button
Seat 1: 14369c30 ($7.99 in chips)
Seat 2: 15134e2a ($5 in chips)
Seat 3: Hero ($5.62 in chips)
Seat 4: f75da158 ($12.52 in chips)
Seat 5: f8e8f612 ($5.99 in chips)
Seat 6: c755210d ($5 in chips)
15134e2a: posts small blind $0.02
Hero: posts big blind $0.05
*** HOLE CARDS ***
Dealt to 14369c30 
Dealt to 15134e2a 
Dealt to Hero [Kd 8c]
Dealt to f75da158 
Dealt to f8e8f612 
Dealt to c755210d 
f75da158: folds
f8e8f612: folds
c755210d: raises $0.05 to $0.1
14369c30: folds
15134e2a: folds
Hero: folds
Uncalled bet ($0.05) returned to c755210d
*** SHOWDOWN ***
c755210d collected $0.12 from pot
*** SUMMARY ***
Total pot $0.12 | Rake $0 | Jackpot $0 | Bingo $0 | Fortune $0 | Tax $0
Seat 1: 14369c30 (button) folded before Flop (didn't bet)
Seat 2: 15134e2a (small blind) folded before Flop
Seat 3: Hero (big blind) folded before Flop
Seat 4: f75da158 folded before Flop (didn't bet)
Seat 5: f8e8f612 folded before Flop (didn't bet)
Seat 6: c755210d collected ($0.12)


Poker Hand #RC3794648439: Hold'em No Limit ($0.02/$0.05) - 2025/08/09 20:15:00
Table 'RushAndCash10823699' 6-max Seat #1 is the button
Seat 1: 28992a16 ($3.7 in chips)
Seat 2: 89d6ddfd ($5 in chips)
Seat 3: 9c128641 ($5 in chips)
Seat 4: 67a9b1ab ($8.05 in chips)
Seat 5: Hero ($5.62 in chips)
Seat 6: 75e79623 ($4.53 in chips)
89d6ddfd: posts small blind $0.02
9c128641: posts big blind $0.05
*** HOLE CARDS ***
Dealt to 28992a16 
Dealt to 89d6ddfd 
Dealt to 9c128641 
Dealt to 67a9b1ab 
Dealt to Hero [4s 6c]
Dealt to 75e79623 
67a9b1ab: folds
Hero: folds
75e79623: folds
28992a16: folds
89d6ddfd: folds
Uncalled bet ($0.03) returned to 9c128641
*** SHOWDOWN ***
9c128641 collected $0.04 from pot
*** SUMMARY ***
Total pot $0.04 | Rake $0 | Jackpot $0 | Bingo $0 | Fortune $0 | Tax $0
Seat 1: 28992a16 (button) folded before Flop (didn't bet)
Seat 2: 89d6ddfd (small blind) folded before Flop
Seat 3: 9c128641 (big blind) collected ($0.04)
Seat 4: 67a9b1ab folded before Flop (didn't bet)
Seat 5: Hero folded before Flop (didn't bet)
Seat 6: 75e79623 folded before Flop (didn't bet)


Poker Hand #RC3794648415: Hold'em No Limit ($0.02/$0.05) - 2025/08/09 20:14:56
Table 'RushAndCash10823675' 6-max Seat #1 is the button
Seat 1: 7709512c ($5.53 in chips)
Seat 2: fa38fd1c ($5.69 in chips)
Seat 3: b0c4a4cc ($5 in chips)
Seat 4: Hero ($5.62 in chips)
Seat 5: 803360e6 ($7.17 in chips)
Seat 6: e0d61549 ($4.44 in chips)
fa38fd1c: posts small blind $0.02
b0c4a4cc: posts big blind $0.05
*** HOLE CARDS ***
Dealt to 7709512c 
Dealt to fa38fd1c 
Dealt to b0c4a4cc 
Dealt to Hero [7d 6s]
Dealt to 803360e6 
Dealt to e0d61549 
Hero: folds
803360e6: folds
e0d61549: folds
7709512c: folds
fa38fd1c: raises $0.1 to $0.15
b0c4a4cc: raises $0.3 to $0.45
fa38fd1c: folds
Uncalled bet ($0.3) returned to b0c4a4cc
*** SHOWDOWN ***
b0c4a4cc collected $0.29 from pot
*** SUMMARY ***
Total pot $0.3 | Rake $0.01 | Jackpot $0 | Bingo $0 | Fortune $0 | Tax $0
Seat 1: 7709512c (button) folded before Flop (didn't bet)
Seat 2: fa38fd1c (small blind) folded before Flop
Seat 3: b0c4a4cc (big blind) collected ($0.29)
Seat 4: Hero folded before Flop (didn't bet)
Seat 5: 803360e6 folded before Flop (didn't bet)
Seat 6: e0d61549 folded before Flop (didn't bet)


Poker Hand #RC3794648375: Hold'em No Limit ($0.02/$0.05) - 2025/08/09 20:14:49
Table 'RushAndCash10823635' 6-max Seat #1 is the button
Seat 1: f1f20f76 ($14.67 in chips)
Seat 2: 4b982b0b ($5.37 in chips)
Seat 3: 36ad83d8 ($5 in chips)
Seat 4: 20955084 ($5.59 in chips)
Seat 5: Hero ($5.62 in chips)
Seat 6: f95b915f ($5.07 in chips)
4b982b0b: posts small blind $0.02
36ad83d8: posts big blind $0.05
*** HOLE CARDS ***
Dealt to f1f20f76 
Dealt to 4b982b0b 
Dealt to 36ad83d8 
Dealt to 20955084 
Dealt to Hero [5d 5h]
Dealt to f95b915f 
20955084: folds
Hero: folds
f95b915f: folds
f1f20f76: folds
4b982b0b: folds
Uncalled bet ($0.03) returned to 36ad83d8
*** SHOWDOWN ***
36ad83d8 collected $0.04 from pot
*** SUMMARY ***
Total pot $0.04 | Rake $0 | Jackpot $0 | Bingo $0 | Fortune $0 | Tax $0
Seat 1: f1f20f76 (button) folded before Flop (didn't bet)
Seat 2: 4b982b0b (small blind) folded before Flop
Seat 3: 36ad83d8 (big blind) collected ($0.04)
Seat 4: 20955084 folded before Flop (didn't bet)
Seat 5: Hero folded before Flop (didn't bet)
Seat 6: f95b915f folded before Flop (didn't bet)


Poker Hand #RC3794648299: Hold'em No Limit ($0.02/$0.05) - 2025/08/09 20:14:35
Table 'RushAndCash10823559' 6-max Seat #1 is the button
Seat 1: Hero ($5.55 in chips)
Seat 2: e61ba ($6.02 in chips)
Seat 3: 6b91637b ($5.32 in chips)
Seat 4: 50c5a413 ($5.75 in chips)
Seat 5: 41aab34e ($5.79 in chips)
Seat 6: 2353d87c ($4.61 in chips)
e61ba: posts small blind $0.02
6b91637b: posts big blind $0.05
*** HOLE CARDS ***
Dealt to Hero [2c 2s]
Dealt to e61ba 
Dealt to 6b91637b 
Dealt to 50c5a413 
Dealt to 41aab34e 
Dealt to 2353d87c 
50c5a413: folds
41aab34e: folds
2353d87c: folds
Hero: raises $0.05 to $0.1
e61ba: folds
6b91637b: folds
Uncalled bet ($0.05) returned to Hero
*** SHOWDOWN ***
Hero collected $0.12 from pot
*** SUMMARY ***
Total pot $0.12 | Rake $0 | Jackpot $0 | Bingo $0 | Fortune $0 | Tax $0
Seat 1: Hero (button) collected ($0.12)
Seat 2: e61ba (small blind) folded before Flop
Seat 3: 6b91637b (big blind) folded before Flop
Seat 4: 50c5a413 folded before Flop (didn't bet)
Seat 5: 41aab34e folded before Flop (didn't bet)
Seat 6: 2353d87c folded before Flop (didn't bet)


Poker Hand #RC3794648271: Hold'em No Limit ($0.02/$0.05) - 2025/08/09 20:14:30
Table 'RushAndCash10823531' 6-max Seat #1 is the button
Seat 1: 9c843316 ($5.16 in chips)
Seat 2: Hero ($5.57 in chips)
Seat 3: 3bf2df84 ($5.07 in chips)
Seat 4: 41bb1ee8 ($10.19 in chips)
Seat 5: 2dec3c8b ($17.25 in chips)
Seat 6: 902a5491 ($5 in chips)
Hero: posts small blind $0.02
3bf2df84: posts big blind $0.05
*** HOLE CARDS ***
Dealt to 9c843316 
Dealt to Hero [3c Kd]
Dealt to 3bf2df84 
Dealt to 41bb1ee8 
Dealt to 2dec3c8b 
Dealt to 902a5491 
41bb1ee8: folds
2dec3c8b: folds
902a5491: folds
9c843316: folds
Hero: folds
Uncalled bet ($0.03) returned to 3bf2df84
*** SHOWDOWN ***
3bf2df84 collected $0.04 from pot
*** SUMMARY ***
Total pot $0.04 | Rake $0 | Jackpot $0 | Bingo $0 | Fortune $0 | Tax $0
Seat 1: 9c843316 (button) folded before Flop (didn't bet)
Seat 2: Hero (small blind) folded before Flop
Seat 3: 3bf2df84 (big blind) collected ($0.04)
Seat 4: 41bb1ee8 folded before Flop (didn't bet)
Seat 5: 2dec3c8b folded before Flop (didn't bet)
Seat 6: 902a5491 folded before Flop (didn't bet)


Poker Hand #RC3794648061: Hold'em No Limit ($0.02/$0.05) - 2025/08/09 20:13:54
Table 'RushAndCash10823321' 6-max Seat #1 is the button
Seat 1: 59e8c082 ($6.4 in chips)
Seat 2: 76211edb ($5.06 in chips)
Seat 3: Hero ($5.67 in chips)
Seat 4: f780196d ($5.03 in chips)
Seat 5: 9c843316 ($5.05 in chips)
Seat 6: e96fa401 ($22.36 in chips)
76211edb: posts small blind $0.02
Hero: posts big blind $0.05
*** HOLE CARDS ***
Dealt to 59e8c082 
Dealt to 76211edb 
Dealt to Hero [5s Qs]
Dealt to f780196d 
Dealt to 9c843316 
Dealt to e96fa401 
f780196d: folds
9c843316: raises $0.05 to $0.1
e96fa401: folds
59e8c082: folds
76211edb: folds
Hero: calls $0.05
*** FLOP *** [9s Ac 3h]
Hero: checks
9c843316: bets $0.06
Hero: folds
Uncalled bet ($0.06) returned to 9c843316
*** SHOWDOWN ***
9c843316 collected $0.21 from pot
*** SUMMARY ***
Total pot $0.22 | Rake $0.01 | Jackpot $0 | Bingo $0 | Fortune $0 | Tax $0
Board [9s Ac 3h]
Seat 1: 59e8c082 (button) folded before Flop (didn't bet)
Seat 2: 76211edb (small blind) folded before Flop
Seat 3: Hero (big blind) folded on the Flop
Seat 4: f780196d folded before Flop (didn't bet)
Seat 5: 9c843316 won ($0.21)
Seat 6: e96fa401 folded before Flop (didn't bet)


Poker Hand #RC3794648029: Hold'em No Limit ($0.02/$0.05) - 2025/08/09 20:13:48
Table 'RushAndCash10823289' 6-max Seat #1 is the button
Seat 1: fd64ece6 ($5.07 in chips)
Seat 2: 60f7245e ($5.61 in chips)
Seat 3: 5b355661 ($17.63 in chips)
Seat 4: 41aab34e ($5.79 in chips)
Seat 5: Hero ($5.67 in chips)
Seat 6: 426c3bb6 ($9 in chips)
60f7245e: posts small blind $0.02
5b355661: posts big blind $0.05
*** HOLE CARDS ***
Dealt to fd64ece6 
Dealt to 60f7245e 
Dealt to 5b355661 
Dealt to 41aab34e 
Dealt to Hero [Th 2s]
Dealt to 426c3bb6 
41aab34e: raises $0.09 to $0.14
Hero: folds
426c3bb6: folds
fd64ece6: folds
60f7245e: folds
5b355661: folds
Uncalled bet ($0.09) returned to 41aab34e
*** SHOWDOWN ***
41aab34e collected $0.12 from pot
*** SUMMARY ***
Total pot $0.12 | Rake $0 | Jackpot $0 | Bingo $0 | Fortune $0 | Tax $0
Seat 1: fd64ece6 (button) folded before Flop (didn't bet)
Seat 2: 60f7245e (small blind) folded before Flop
Seat 3: 5b355661 (big blind) folded before Flop
Seat 4: 41aab34e collected ($0.12)
Seat 5: Hero folded before Flop (didn't bet)
Seat 6: 426c3bb6 folded before Flop (didn't bet)


Poker Hand #RC3794648006: Hold'em No Limit ($0.02/$0.05) - 2025/08/09 20:13:44
Table 'RushAndCash10823266' 6-max Seat #1 is the button
Seat 1: ed87465 ($5.83 in chips)
Seat 2: d3c5a5d1 ($6.48 in chips)
Seat 3: db656a0c ($7.11 in chips)
Seat 4: b0c4a4cc ($5 in chips)
Seat 5: Hero ($5.67 in chips)
Seat 6: 84cbdd37 ($4.79 in chips)
d3c5a5d1: posts small blind $0.02
db656a0c: posts big blind $0.05
*** HOLE CARDS ***
Dealt to ed87465 
Dealt to d3c5a5d1 
Dealt to db656a0c 
Dealt to b0c4a4cc 
Dealt to Hero [Th 9d]
Dealt to 84cbdd37 
b0c4a4cc: folds
Hero: folds
84cbdd37: raises $0.08 to $0.13
ed87465: folds
d3c5a5d1: folds
db656a0c: folds
Uncalled bet ($0.08) returned to 84cbdd37
*** SHOWDOWN ***
84cbdd37 collected $0.12 from pot
*** SUMMARY ***
Total pot $0.12 | Rake $0 | Jackpot $0 | Bingo $0 | Fortune $0 | Tax $0
Seat 1: ed87465 (button) folded before Flop (didn't bet)
Seat 2: d3c5a5d1 (small blind) folded before Flop
Seat 3: db656a0c (big blind) folded before Flop
Seat 4: b0c4a4cc folded before Flop (didn't bet)
Seat 5: Hero folded before Flop (didn't bet)
Seat 6: 84cbdd37 collected ($0.12)


Poker Hand #RC3794647986: Hold'em No Limit ($0.02/$0.05) - 2025/08/09 20:13:40
Table 'RushAndCash10823246' 6-max Seat #1 is the button
Seat 1: f276db18 ($6.22 in chips)
Seat 2: 1d80d01b ($5.71 in chips)
Seat 3: 216d3aab ($5.64 in chips)
Seat 4: 9e6769f4 ($7.98 in chips)
Seat 5: Hero ($5.67 in chips)
Seat 6: 97369df2 ($7.89 in chips)
1d80d01b: posts small blind $0.02
216d3aab: posts big blind $0.05
*** HOLE CARDS ***
Dealt to f276db18 
Dealt to 1d80d01b 
Dealt to 216d3aab 
Dealt to 9e6769f4 
Dealt to Hero [7h Jd]
Dealt to 97369df2 
9e6769f4: folds
Hero: folds
97369df2: folds
f276db18: raises $0.05 to $0.1
1d80d01b: folds
216d3aab: folds
Uncalled bet ($0.05) returned to f276db18
*** SHOWDOWN ***
f276db18 collected $0.12 from pot
*** SUMMARY ***
Total pot $0.12 | Rake $0 | Jackpot $0 | Bingo $0 | Fortune $0 | Tax $0
Seat 1: f276db18 (button) collected ($0.12)
Seat 2: 1d80d01b (small blind) folded before Flop
Seat 3: 216d3aab (big blind) folded before Flop
Seat 4: 9e6769f4 folded before Flop (didn't bet)
Seat 5: Hero folded before Flop (didn't bet)
Seat 6: 97369df2 folded before Flop (didn't bet)


Poker Hand #RC3794647794: Hold'em No Limit ($0.02/$0.05) - 2025/08/09 20:13:08
Table 'RushAndCash10823054' 6-max Seat #1 is the button
Seat 1: Hero ($5.77 in chips)
Seat 2: 1ad7141a ($5.07 in chips)
Seat 3: 1d80d01b ($5.81 in chips)
Seat 4: 216d3aab ($5.43 in chips)
Seat 5: e07aa006 ($7.77 in chips)
Seat 6: f780196d ($5.1 in chips)
1ad7141a: posts small blind $0.02
1d80d01b: posts big blind $0.05
*** HOLE CARDS ***
Dealt to Hero [4h 7h]
Dealt to 1ad7141a 
Dealt to 1d80d01b 
Dealt to 216d3aab 
Dealt to e07aa006 
Dealt to f780196d 
216d3aab: raises $0.05 to $0.1
e07aa006: folds
f780196d: folds
Hero: calls $0.1
1ad7141a: folds
1d80d01b: calls $0.05
*** FLOP *** [Ad Qd 5c]
1d80d01b: checks
216d3aab: bets $0.24
Hero: folds
1d80d01b: folds
Uncalled bet ($0.24) returned to 216d3aab
*** SHOWDOWN ***
216d3aab collected $0.31 from pot
*** SUMMARY ***
Total pot $0.32 | Rake $0.01 | Jackpot $0 | Bingo $0 | Fortune $0 | Tax $0
Board [Ad Qd 5c]
Seat 1: Hero (button) folded on the Flop
Seat 2: 1ad7141a (small blind) folded before Flop
Seat 3: 1d80d01b (big blind) folded on the Flop
Seat 4: 216d3aab won ($0.31)
Seat 5: e07aa006 folded before Flop (didn't bet)
Seat 6: f780196d folded before Flop (didn't bet)


Poker Hand #RC3794647693: Hold'em No Limit ($0.02/$0.05) - 2025/08/09 20:12:50
Table 'RushAndCash10822953' 6-max Seat #1 is the button
Seat 1: c182d3ad ($7.01 in chips)
Seat 2: Hero ($5.79 in chips)
Seat 3: 2fb6b299 ($5.87 in chips)
Seat 4: 84543994 ($13.67 in chips)
Seat 5: cb8a4bf0 ($5.1 in chips)
Seat 6: e040a01e ($4.93 in chips)
Hero: posts small blind $0.02
2fb6b299: posts big blind $0.05
*** HOLE CARDS ***
Dealt to c182d3ad 
Dealt to Hero [9h Qd]
Dealt to 2fb6b299 
Dealt to 84543994 
Dealt to cb8a4bf0 
Dealt to e040a01e 
84543994: folds
cb8a4bf0: folds
e040a01e: folds
c182d3ad: raises $0.06 to $0.11
Hero: folds
2fb6b299: folds
Uncalled bet ($0.06) returned to c182d3ad
*** SHOWDOWN ***
c182d3ad collected $0.12 from pot
*** SUMMARY ***
Total pot $0.12 | Rake $0 | Jackpot $0 | Bingo $0 | Fortune $0 | Tax $0
Seat 1: c182d3ad (button) collected ($0.12)
Seat 2: Hero (small blind) folded before Flop
Seat 3: 2fb6b299 (big blind) folded before Flop
Seat 4: 84543994 folded before Flop (didn't bet)
Seat 5: cb8a4bf0 folded before Flop (didn't bet)
Seat 6: e040a01e folded before Flop (didn't bet)


Poker Hand #RC3794647386: Hold'em No Limit ($0.02/$0.05) - 2025/08/09 20:11:52
Table 'RushAndCash10822646' 6-max Seat #1 is the button
Seat 1: b3d6c5f5 ($5.97 in chips)
Seat 2: 6331aca6 ($5.97 in chips)
Seat 3: Hero ($5.58 in chips)
Seat 4: 3d1f2d3c ($4 in chips)
Seat 5: 2fb6b299 ($6.57 in chips)
Seat 6: 29231caf ($11.63 in chips)
6331aca6: posts small blind $0.02
Hero: posts big blind $0.05
*** HOLE CARDS ***
Dealt to b3d6c5f5 
Dealt to 6331aca6 
Dealt to Hero [Qc 9d]
Dealt to 3d1f2d3c 
Dealt to 2fb6b299 
Dealt to 29231caf 
3d1f2d3c: folds
2fb6b299: folds
29231caf: folds
b3d6c5f5: raises $0.05 to $0.1
6331aca6: folds
Hero: calls $0.05
*** FLOP *** [Qs 2s 7c]
Hero: checks
b3d6c5f5: checks
*** TURN *** [Qs 2s 7c] [Jd]
Hero: checks
b3d6c5f5: checks
*** RIVER *** [Qs 2s 7c Jd] [3s]
Hero: bets $0.11
b3d6c5f5: calls $0.11
Hero: shows [Qc 9d] (a pair of Queens)
b3d6c5f5: shows [8d 8h] (a pair of Eights)
*** SHOWDOWN ***
Hero collected $0.42 from pot
*** SUMMARY ***
Total pot $0.44 | Rake $0.02 | Jackpot $0 | Bingo $0 | Fortune $0 | Tax $0
Board [Qs 2s 7c Jd 3s]
Seat 1: b3d6c5f5 (button) showed [8d 8h] and lost with a pair of Eights
Seat 2: 6331aca6 (small blind) folded before Flop
Seat 3: Hero (big blind) showed [Qc 9d] and won ($0.42) with a pair of Queens
Seat 4: 3d1f2d3c folded before Flop (didn't bet)
Seat 5: 2fb6b299 folded before Flop (didn't bet)
Seat 6: 29231caf folded before Flop (didn't bet)


Poker Hand #RC3794647365: Hold'em No Limit ($0.02/$0.05) - 2025/08/09 20:11:49
Table 'RushAndCash10822625' 6-max Seat #1 is the button
Seat 1: 681ce6e1 ($11.01 in chips)
Seat 2: f92a9c25 ($6.29 in chips)
Seat 3: 9fa787cc ($5 in chips)
Seat 4: 67a0e05f ($10.68 in chips)
Seat 5: 45302a4c ($5.27 in chips)
Seat 6: Hero ($5.58 in chips)
f92a9c25: posts small blind $0.02
9fa787cc: posts big blind $0.05
*** HOLE CARDS ***
Dealt to 681ce6e1 
Dealt to f92a9c25 
Dealt to 9fa787cc 
Dealt to 67a0e05f 
Dealt to 45302a4c 
Dealt to Hero [Ks 8c]
67a0e05f: folds
45302a4c: raises $0.05 to $0.1
Hero: folds
681ce6e1: calls $0.1
f92a9c25: folds
9fa787cc: folds
*** FLOP *** [7c 5c 3s]
45302a4c: checks
681ce6e1: bets $0.22
45302a4c: calls $0.22
*** TURN *** [7c 5c 3s] [6c]
45302a4c: checks
681ce6e1: checks
*** RIVER *** [7c 5c 3s 6c] [8d]
45302a4c: checks
681ce6e1: checks
45302a4c: shows [Ah Qh] (Ace high)
681ce6e1: shows [Qd 9d] (a straight, Nine to Five)
*** SHOWDOWN ***
681ce6e1 collected $0.68 from pot
*** SUMMARY ***
Total pot $0.71 | Rake $0.03 | Jackpot $0 | Bingo $0 | Fortune $0 | Tax $0
Board [7c 5c 3s 6c 8d]
Seat 1: 681ce6e1 (button) showed [Qd 9d] and won ($0.68) with a straight, Nine to Five
Seat 2: f92a9c25 (small blind) folded before Flop
Seat 3: 9fa787cc (big blind) folded before Flop
Seat 4: 67a0e05f folded before Flop (didn't bet)
Seat 5: 45302a4c showed [Ah Qh] and lost with Ace high
Seat 6: Hero folded before Flop (didn't bet)


Poker Hand #RC3794647338: Hold'em No Limit ($0.02/$0.05) - 2025/08/09 20:11:44
Table 'RushAndCash10822598' 6-max Seat #1 is the button
Seat 1: 705a5934 ($5.3 in chips)
Seat 2: 13d139b4 ($9.34 in chips)
Seat 3: a689b6f3 ($9.61 in chips)
Seat 4: 6eb348cf ($5.46 in chips)
Seat 5: 9bdaa6e3 ($5 in chips)
Seat 6: Hero ($5.58 in chips)
13d139b4: posts small blind $0.02
a689b6f3: posts big blind $0.05
*** HOLE CARDS ***
Dealt to 705a5934 
Dealt to 13d139b4 
Dealt to a689b6f3 
Dealt to 6eb348cf 
Dealt to 9bdaa6e3 
Dealt to Hero [Tc 4c]
6eb348cf: folds
9bdaa6e3: raises $0.08 to $0.13
Hero: folds
705a5934: folds
13d139b4: folds
a689b6f3: folds
Uncalled bet ($0.08) returned to 9bdaa6e3
*** SHOWDOWN ***
9bdaa6e3 collected $0.12 from pot
*** SUMMARY ***
Total pot $0.12 | Rake $0 | Jackpot $0 | Bingo $0 | Fortune $0 | Tax $0
Seat 1: 705a5934 (button) folded before Flop (didn't bet)
Seat 2: 13d139b4 (small blind) folded before Flop
Seat 3: a689b6f3 (big blind) folded before Flop
Seat 4: 6eb348cf folded before Flop (didn't bet)
Seat 5: 9bdaa6e3 collected ($0.12)
Seat 6: Hero folded before Flop (didn't bet)


Poker Hand #RC3794647319: Hold'em No Limit ($0.02/$0.05) - 2025/08/09 20:11:40
Table 'RushAndCash10822579' 6-max Seat #1 is the button
Seat 1: dfdf8b4b ($5.92 in chips)
Seat 2: bc8d7b66 ($5.02 in chips)
Seat 3: 90cdecbc ($2 in chips)
Seat 4: 7a6ee12b ($30.45 in chips)
Seat 5: Hero ($5.58 in chips)
Seat 6: 705a5934 ($5.3 in chips)
bc8d7b66: posts small blind $0.02
90cdecbc: posts big blind $0.05
*** HOLE CARDS ***
Dealt to dfdf8b4b 
Dealt to bc8d7b66 
Dealt to 90cdecbc 
Dealt to 7a6ee12b 
Dealt to Hero [Kd 5c]
Dealt to 705a5934 
7a6ee12b: raises $0.05 to $0.1
Hero: folds
705a5934: folds
dfdf8b4b: calls $0.1
bc8d7b66: raises $0.05 to $0.15
90cdecbc: folds
7a6ee12b: calls $0.05
dfdf8b4b: calls $0.05
*** FLOP *** [2s 7c Qh]
bc8d7b66: checks
7a6ee12b: checks
dfdf8b4b: checks
*** TURN *** [2s 7c Qh] [3d]
bc8d7b66: checks
7a6ee12b: checks
dfdf8b4b: checks
*** RIVER *** [2s 7c Qh 3d] [5s]
bc8d7b66: checks
7a6ee12b: checks
dfdf8b4b: checks
bc8d7b66: shows [Ad Kc] (Ace high)
7a6ee12b: shows [9s 9d] (a pair of Nines)
dfdf8b4b: shows [6h 6d] (a pair of Sixes)
*** SHOWDOWN ***
7a6ee12b collected $0.48 from pot
*** SUMMARY ***
Total pot $0.5 | Rake $0.02 | Jackpot $0 | Bingo $0 | Fortune $0 | Tax $0
Board [2s 7c Qh 3d 5s]
Seat 1: dfdf8b4b (button) showed [6h 6d] and lost with a pair of Sixes
Seat 2: bc8d7b66 (small blind) showed [Ad Kc] and lost with Ace high
Seat 3: 90cdecbc (big blind) folded before Flop
Seat 4: 7a6ee12b showed [9s 9d] and won ($0.48) with a pair of Nines
Seat 5: Hero folded before Flop (didn't bet)
Seat 6: 705a5934 folded before Flop (didn't bet)


Poker Hand #RC3794647258: Hold'em No Limit ($0.02/$0.05) - 2025/08/09 20:11:29
Table 'RushAndCash10822518' 6-max Seat #1 is the button
Seat 1: Hero ($5.58 in chips)
Seat 2: 33ba5517 ($9.94 in chips)
Seat 3: 5fe6460e ($7.77 in chips)
Seat 4: 1ad7141a ($5 in chips)
Seat 5: de1de17c ($5.83 in chips)
Seat 6: 1891aa43 ($5.2 in chips)
33ba5517: posts small blind $0.02
5fe6460e: posts big blind $0.05
*** HOLE CARDS ***
Dealt to Hero [Ah 2c]
Dealt to 33ba5517 
Dealt to 5fe6460e 
Dealt to 1ad7141a 
Dealt to de1de17c 
Dealt to 1891aa43 
1ad7141a: folds
de1de17c: folds
1891aa43: raises $0.15 to $0.2
Hero: folds
33ba5517: folds
5fe6460e: calls $0.15
*** FLOP *** [6h 3c 2s]
5fe6460e: checks
1891aa43: bets $0.21
5fe6460e: folds
Uncalled bet ($0.21) returned to 1891aa43
*** SHOWDOWN ***
1891aa43 collected $0.4 from pot
*** SUMMARY ***
Total pot $0.42 | Rake $0.02 | Jackpot $0 | Bingo $0 | Fortune $0 | Tax $0
Board [6h 3c 2s]
Seat 1: Hero (button) folded before Flop (didn't bet)
Seat 2: 33ba5517 (small blind) folded before Flop
Seat 3: 5fe6460e (big blind) folded on the Flop
Seat 4: 1ad7141a folded before Flop (didn't bet)
Seat 5: de1de17c folded before Flop (didn't bet)
Seat 6: 1891aa43 won ($0.4)


Poker Hand #RC3794647199: Hold'em No Limit ($0.02/$0.05) - 2025/08/09 20:11:18
Table 'RushAndCash10822459' 6-max Seat #1 is the button
Seat 1: f69fcb6f ($8.8 in chips)
Seat 2: Hero ($5.6 in chips)
Seat 3: 8339fd8d ($9.89 in chips)
Seat 4: 8d479104 ($7.17 in chips)
Seat 5: be50ed85 ($5.56 in chips)
Seat 6: 970f41b ($14.86 in chips)
Hero: posts small blind $0.02
8339fd8d: posts big blind $0.05
*** HOLE CARDS ***
Dealt to f69fcb6f 
Dealt to Hero [5c 8h]
Dealt to 8339fd8d 
Dealt to 8d479104 
Dealt to be50ed85 
Dealt to 970f41b 
8d479104: folds
be50ed85: folds
970f41b: raises $0.06 to $0.11
f69fcb6f: folds
Hero: folds
8339fd8d: folds
Uncalled bet ($0.06) returned to 970f41b
*** SHOWDOWN ***
970f41b collected $0.12 from pot
*** SUMMARY ***
Total pot $0.12 | Rake $0 | Jackpot $0 | Bingo $0 | Fortune $0 | Tax $0
Seat 1: f69fcb6f (button) folded before Flop (didn't bet)
Seat 2: Hero (small blind) folded before Flop
Seat 3: 8339fd8d (big blind) folded before Flop
Seat 4: 8d479104 folded before Flop (didn't bet)
Seat 5: be50ed85 folded before Flop (didn't bet)
Seat 6: 970f41b collected ($0.12)


Poker Hand #RC3794647156: Hold'em No Limit ($0.02/$0.05) - 2025/08/09 20:11:10
Table 'RushAndCash10822416' 6-max Seat #1 is the button
Seat 1: 8d3fcd8a ($5.03 in chips)
Seat 2: 4e895153 ($3.16 in chips)
Seat 3: Hero ($5.58 in chips)
Seat 4: de364cc2 ($5.11 in chips)
Seat 5: 49de9552 ($5.07 in chips)
Seat 6: ddcac422 ($5.45 in chips)
4e895153: posts small blind $0.02
Hero: posts big blind $0.05
*** HOLE CARDS ***
Dealt to 8d3fcd8a 
Dealt to 4e895153 
Dealt to Hero [As 2s]
Dealt to de364cc2 
Dealt to 49de9552 
Dealt to ddcac422 
de364cc2: folds
49de9552: folds
ddcac422: folds
8d3fcd8a: folds
4e895153: folds
Uncalled bet ($0.03) returned to Hero
*** SHOWDOWN ***
Hero collected $0.04 from pot
*** SUMMARY ***
Total pot $0.04 | Rake $0 | Jackpot $0 | Bingo $0 | Fortune $0 | Tax $0
Seat 1: 8d3fcd8a (button) folded before Flop (didn't bet)
Seat 2: 4e895153 (small blind) folded before Flop
Seat 3: Hero (big blind) collected ($0.04)
Seat 4: de364cc2 folded before Flop (didn't bet)
Seat 5: 49de9552 folded before Flop (didn't bet)
Seat 6: ddcac422 folded before Flop (didn't bet)


Poker Hand #RC3794646778: Hold'em No Limit ($0.02/$0.05) - 2025/08/09 20:10:05
Table 'RushAndCash10822038' 6-max Seat #1 is the button
Seat 1: 9abd286f ($5 in chips)
Seat 2: 4e895153 ($3.26 in chips)
Seat 3: 8b6f27db ($5.77 in chips)
Seat 4: d6786ac6 ($5.21 in chips)
Seat 5: Hero ($5.39 in chips)
Seat 6: 376fe9ef ($5.55 in chips)
4e895153: posts small blind $0.02
8b6f27db: posts big blind $0.05
*** HOLE CARDS ***
Dealt to 9abd286f 
Dealt to 4e895153 
Dealt to 8b6f27db 
Dealt to d6786ac6 
Dealt to Hero [Qh Kc]
Dealt to 376fe9ef 
d6786ac6: folds
Hero: raises $0.05 to $0.1
376fe9ef: folds
9abd286f: folds
4e895153: calls $0.08
8b6f27db: calls $0.05
*** FLOP *** [9h Ac 2c]
4e895153: checks
8b6f27db: checks
Hero: checks
*** TURN *** [9h Ac 2c] [5d]
4e895153: checks
8b6f27db: checks
Hero: checks
*** RIVER *** [9h Ac 2c 5d] [Qs]
4e895153: checks
8b6f27db: checks
Hero: bets $0.15
4e895153: folds
8b6f27db: folds
Uncalled bet ($0.15) returned to Hero
*** SHOWDOWN ***
Hero collected $0.29 from pot
*** SUMMARY ***
Total pot $0.3 | Rake $0.01 | Jackpot $0 | Bingo $0 | Fortune $0 | Tax $0
Board [9h Ac 2c 5d Qs]
Seat 1: 9abd286f (button) folded before Flop (didn't bet)
Seat 2: 4e895153 (small blind) folded on the River
Seat 3: 8b6f27db (big blind) folded on the River
Seat 4: d6786ac6 folded before Flop (didn't bet)
Seat 5: Hero won ($0.29)
Seat 6: 376fe9ef folded before Flop (didn't bet)


Poker Hand #RC3794646758: Hold'em No Limit ($0.02/$0.05) - 2025/08/09 20:10:01
Table 'RushAndCash10822018' 6-max Seat #1 is the button
Seat 1: 9883cab8 ($10.7 in chips)
Seat 2: 7be8f7d0 ($4.11 in chips)
Seat 3: 36ad83d8 ($5.69 in chips)
Seat 4: fae54529 ($11.33 in chips)
Seat 5: Hero ($5.39 in chips)
Seat 6: 9939fc01 ($3.56 in chips)
7be8f7d0: posts small blind $0.02
36ad83d8: posts big blind $0.05
*** HOLE CARDS ***
Dealt to 9883cab8 
Dealt to 7be8f7d0 
Dealt to 36ad83d8 
Dealt to fae54529 
Dealt to Hero [5h Jc]
Dealt to 9939fc01 
fae54529: folds
Hero: folds
9939fc01: folds
9883cab8: raises $0.08 to $0.13
7be8f7d0: raises $0.16 to $0.29
36ad83d8: folds
9883cab8: calls $0.16
*** FLOP *** [9s 5s Ac]
7be8f7d0: checks
9883cab8: checks
*** TURN *** [9s 5s Ac] [Qc]
7be8f7d0: bets $0.32
9883cab8: calls $0.32
*** RIVER *** [9s 5s Ac Qc] [Ks]
7be8f7d0: bets $1.27
9883cab8: calls $1.27
7be8f7d0: shows [Kc Kd] (three of a kind, Kings)
9883cab8: shows [Ah 6h] (a pair of Aces)
*** SHOWDOWN ***
7be8f7d0 collected $3.59 from pot
*** SUMMARY ***
Total pot $3.81 | Rake $0.15 | Jackpot $0.07 | Bingo $0 | Fortune $0 | Tax $0
Board [9s 5s Ac Qc Ks]
Seat 1: 9883cab8 (button) showed [Ah 6h] and lost with a pair of Aces
Seat 2: 7be8f7d0 (small blind) showed [Kc Kd] and won ($3.59) with three of a kind, Kings
Seat 3: 36ad83d8 (big blind) folded before Flop
Seat 4: fae54529 folded before Flop (didn't bet)
Seat 5: Hero folded before Flop (didn't bet)
Seat 6: 9939fc01 folded before Flop (didn't bet)


Poker Hand #RC3794646592: Hold'em No Limit ($0.02/$0.05) - 2025/08/09 20:09:30
Table 'RushAndCash10821852' 6-max Seat #1 is the button
Seat 1: 9c6adacf ($5.91 in chips)
Seat 2: 3c220374 ($13 in chips)
Seat 3: 2f87677a ($6.46 in chips)
Seat 4: 9883cab8 ($10.8 in chips)
Seat 5: Hero ($5.23 in chips)
Seat 6: e2e1a66a ($5.5 in chips)
3c220374: posts small blind $0.02
2f87677a: posts big blind $0.05
*** HOLE CARDS ***
Dealt to 9c6adacf 
Dealt to 3c220374 
Dealt to 2f87677a 
Dealt to 9883cab8 
Dealt to Hero [Kh Ac]
Dealt to e2e1a66a 
9883cab8: raises $0.05 to $0.1
Hero: calls $0.1
e2e1a66a: folds
9c6adacf: folds
3c220374: folds
2f87677a: folds
*** FLOP *** [3d 3s Jd]
9883cab8: checks
Hero: bets $0.13
9883cab8: folds
Uncalled bet ($0.13) returned to Hero
*** SHOWDOWN ***
Hero collected $0.26 from pot
*** SUMMARY ***
Total pot $0.27 | Rake $0.01 | Jackpot $0 | Bingo $0 | Fortune $0 | Tax $0
Board [3d 3s Jd]
Seat 1: 9c6adacf (button) folded before Flop (didn't bet)
Seat 2: 3c220374 (small blind) folded before Flop
Seat 3: 2f87677a (big blind) folded before Flop
Seat 4: 9883cab8 folded on the Flop
Seat 5: Hero won ($0.26)
Seat 6: e2e1a66a folded before Flop (didn't bet)


Poker Hand #RC3794646575: Hold'em No Limit ($0.02/$0.05) - 2025/08/09 20:09:27
Table 'RushAndCash10821835' 6-max Seat #1 is the button
Seat 1: 977d9090 ($5 in chips)
Seat 2: f1b90214 ($5.73 in chips)
Seat 3: 8d3fcd8a ($5.21 in chips)
Seat 4: Hero ($5.23 in chips)
Seat 5: 5638b75 ($6.71 in chips)
Seat 6: 725352c ($5 in chips)
f1b90214: posts small blind $0.02
8d3fcd8a: posts big blind $0.05
*** HOLE CARDS ***
Dealt to 977d9090 
Dealt to f1b90214 
Dealt to 8d3fcd8a 
Dealt to Hero [5d Kh]
Dealt to 5638b75 
Dealt to 725352c 
Hero: folds
5638b75: folds
725352c: raises $0.05 to $0.1
977d9090: folds
f1b90214: folds
8d3fcd8a: folds
Uncalled bet ($0.05) returned to 725352c
*** SHOWDOWN ***
725352c collected $0.12 from pot
*** SUMMARY ***
Total pot $0.12 | Rake $0 | Jackpot $0 | Bingo $0 | Fortune $0 | Tax $0
Seat 1: 977d9090 (button) folded before Flop (didn't bet)
Seat 2: f1b90214 (small blind) folded before Flop
Seat 3: 8d3fcd8a (big blind) folded before Flop
Seat 4: Hero folded before Flop (didn't bet)
Seat 5: 5638b75 folded before Flop (didn't bet)
Seat 6: 725352c collected ($0.12)


Poker Hand #RC3794646537: Hold'em No Limit ($0.02/$0.05) - 2025/08/09 20:09:20
Table 'RushAndCash10821797' 6-max Seat #1 is the button
Seat 1: Hero ($5.23 in chips)
Seat 2: 803360e6 ($7.67 in chips)
Seat 3: 36efdf4e ($5 in chips)
Seat 4: 60f7245e ($5.16 in chips)
Seat 5: 9d465921 ($6.42 in chips)
Seat 6: 426c3bb6 ($6.41 in chips)
803360e6: posts small blind $0.02
36efdf4e: posts big blind $0.05
*** HOLE CARDS ***
Dealt to Hero [5c Qs]
Dealt to 803360e6 
Dealt to 36efdf4e 
Dealt to 60f7245e 
Dealt to 9d465921 
Dealt to 426c3bb6 
60f7245e: raises $0.05 to $0.1
9d465921: folds
426c3bb6: raises $0.25 to $0.35
Hero: folds
803360e6: folds
36efdf4e: folds
60f7245e: folds
Uncalled bet ($0.25) returned to 426c3bb6
*** SHOWDOWN ***
426c3bb6 collected $0.26 from pot
*** SUMMARY ***
Total pot $0.27 | Rake $0.01 | Jackpot $0 | Bingo $0 | Fortune $0 | Tax $0
Seat 1: Hero (button) folded before Flop (didn't bet)
Seat 2: 803360e6 (small blind) folded before Flop
Seat 3: 36efdf4e (big blind) folded before Flop
Seat 4: 60f7245e folded before Flop
Seat 5: 9d465921 folded before Flop (didn't bet)
Seat 6: 426c3bb6 collected ($0.26)


Poker Hand #RC3794646508: Hold'em No Limit ($0.02/$0.05) - 2025/08/09 20:09:14
Table 'RushAndCash10821768' 6-max Seat #1 is the button
Seat 1: f75da158 ($13.64 in chips)
Seat 2: Hero ($5.25 in chips)
Seat 3: 96d60b8f ($10.9 in chips)
Seat 4: 75eec7d7 ($5.27 in chips)
Seat 5: b0c4a4cc ($6.26 in chips)
Seat 6: f04839cf ($5 in chips)
Hero: posts small blind $0.02
96d60b8f: posts big blind $0.05
*** HOLE CARDS ***
Dealt to f75da158 
Dealt to Hero [2c 9d]
Dealt to 96d60b8f 
Dealt to 75eec7d7 
Dealt to b0c4a4cc 
Dealt to f04839cf 
75eec7d7: raises $0.06 to $0.11
b0c4a4cc: folds
f04839cf: raises $0.22 to $0.33
f75da158: folds
Hero: folds
96d60b8f: folds
75eec7d7: calls $0.22
*** FLOP *** [7c 9s 6d]
75eec7d7: checks
f04839cf: bets $0.25
75eec7d7: calls $0.25
*** TURN *** [7c 9s 6d] [8c]
75eec7d7: checks
f04839cf: bets $0.93
75eec7d7: calls $0.93
*** RIVER *** [7c 9s 6d 8c] [5d]
75eec7d7: checks
f04839cf: bets $3.49 and is all-in
75eec7d7: calls $3.49
f04839cf: shows [Ac Kc] (a straight, Nine to Five)
75eec7d7: shows [9h 8h] (a straight, Nine to Five)
*** SHOWDOWN ***
75eec7d7 collected $4.93 from pot
f04839cf collected $4.93 from pot
*** SUMMARY ***
Total pot $10.07 | Rake $0.14 | Jackpot $0.07 | Bingo $0 | Fortune $0 | Tax $0
Board [7c 9s 6d 8c 5d]
Seat 1: f75da158 (button) folded before Flop (didn't bet)
Seat 2: Hero (small blind) folded before Flop
Seat 3: 96d60b8f (big blind) folded before Flop
Seat 4: 75eec7d7 showed [9h 8h] and won ($4.93) with a straight, Nine to Five
Seat 5: b0c4a4cc folded before Flop (didn't bet)
Seat 6: f04839cf showed [Ac Kc] and won ($4.93) with a straight, Nine to Five


Poker Hand #RC3794646131: Hold'em No Limit ($0.02/$0.05) - 2025/08/09 20:08:09
Table 'RushAndCash10821391' 6-max Seat #1 is the button
Seat 1: 6bfc5e4a ($8.57 in chips)
Seat 2: ddcac422 ($5.37 in chips)
Seat 3: Hero ($5 in chips)
Seat 4: 7709512c ($5 in chips)
Seat 5: 63d6148b ($4.97 in chips)
Seat 6: de364cc2 ($5 in chips)
ddcac422: posts small blind $0.02
Hero: posts big blind $0.05
*** HOLE CARDS ***
Dealt to 6bfc5e4a 
Dealt to ddcac422 
Dealt to Hero [Qc Td]
Dealt to 7709512c 
Dealt to 63d6148b 
Dealt to de364cc2 
7709512c: folds
63d6148b: folds
de364cc2: raises $0.07 to $0.12
6bfc5e4a: folds
ddcac422: folds
Hero: calls $0.07
*** FLOP *** [9h 2d 9d]
Hero: checks
de364cc2: bets $0.13
Hero: calls $0.13
*** TURN *** [9h 2d 9d] [6c]
Hero: checks
de364cc2: checks
*** RIVER *** [9h 2d 9d 6c] [3d]
Hero: bets $0.62
de364cc2: folds
Uncalled bet ($0.62) returned to Hero
*** SHOWDOWN ***
Hero collected $0.5 from pot
*** SUMMARY ***
Total pot $0.52 | Rake $0.02 | Jackpot $0 | Bingo $0 | Fortune $0 | Tax $0
Board [9h 2d 9d 6c 3d]
Seat 1: 6bfc5e4a (button) folded before Flop (didn't bet)
Seat 2: ddcac422 (small blind) folded before Flop
Seat 3: Hero (big blind) won ($0.5)
Seat 4: 7709512c folded before Flop (didn't bet)
Seat 5: 63d6148b folded before Flop (didn't bet)
Seat 6: de364cc2 folded on the River


