Poker Hand #RC3812576685: Hold'em No Limit ($0.02/$0.05) - 2025/08/17 00:19:41
Table 'RushAndCash1101945' 6-max Seat #1 is the button
Seat 1: bf5c869a ($16.56 in chips)
Seat 2: d3adba4 ($5.09 in chips)
Seat 3: Hero ($5 in chips)
Seat 4: e19aa51e ($10.8 in chips)
Seat 5: e996df8c ($5.68 in chips)
Seat 6: 7cb23d59 ($5.28 in chips)
d3adba4: posts small blind $0.02
Hero: posts big blind $0.05
*** HOLE CARDS ***
Dealt to bf5c869a 
Dealt to d3adba4 
Dealt to Hero [5d Kh]
Dealt to e19aa51e 
Dealt to e996df8c 
Dealt to 7cb23d59 
e19aa51e: raises $0.06 to $0.11
e996df8c: folds
7cb23d59: calls $0.11
bf5c869a: calls $0.11
d3adba4: folds
Hero: folds
*** FLOP *** [3d Tc 8d]
e19aa51e: checks
7cb23d59: checks
bf5c869a: bets $0.2
e19aa51e: folds
7cb23d59: folds
Uncalled bet ($0.2) returned to bf5c869a
*** SHOWDOWN ***
bf5c869a collected $0.38 from pot
*** SUMMARY ***
Total pot $0.4 | Rake $0.02 | Jackpot $0 | Bingo $0 | Fortune $0 | Tax $0
Board [3d Tc 8d]
Seat 1: bf5c869a (button) won ($0.38)
Seat 2: d3adba4 (small blind) folded before Flop
Seat 3: Hero (big blind) folded before Flop
Seat 4: e19aa51e folded on the Flop
Seat 5: e996df8c folded before Flop (didn't bet)
Seat 6: 7cb23d59 folded on the Flop


Poker Hand #RC3812576662: Hold'em No Limit ($0.02/$0.05) - 2025/08/17 00:19:37
Table 'RushAndCash1101922' 6-max Seat #1 is the button
Seat 1: 579f6e9a ($5.26 in chips)
Seat 2: bab6154f ($31.04 in chips)
Seat 3: acc3e15d ($2.97 in chips)
Seat 4: Hero ($5 in chips)
Seat 5: 370bf11f ($5.39 in chips)
Seat 6: 4dee626c ($6.31 in chips)
bab6154f: posts small blind $0.02
acc3e15d: posts big blind $0.05
*** HOLE CARDS ***
Dealt to 579f6e9a 
Dealt to bab6154f 
Dealt to acc3e15d 
Dealt to Hero [Ts 2s]
Dealt to 370bf11f 
Dealt to 4dee626c 
Hero: folds
370bf11f: folds
4dee626c: folds
579f6e9a: folds
bab6154f: folds
Uncalled bet ($0.03) returned to acc3e15d
*** SHOWDOWN ***
acc3e15d collected $0.04 from pot
*** SUMMARY ***
Total pot $0.04 | Rake $0 | Jackpot $0 | Bingo $0 | Fortune $0 | Tax $0
Seat 1: 579f6e9a (button) folded before Flop (didn't bet)
Seat 2: bab6154f (small blind) folded before Flop
Seat 3: acc3e15d (big blind) collected ($0.04)
Seat 4: Hero folded before Flop (didn't bet)
Seat 5: 370bf11f folded before Flop (didn't bet)
Seat 6: 4dee626c folded before Flop (didn't bet)


Poker Hand #RC3812576639: Hold'em No Limit ($0.02/$0.05) - 2025/08/17 00:19:34
Table 'RushAndCash1101899' 6-max Seat #1 is the button
Seat 1: e497ef0d ($6.55 in chips)
Seat 2: c720730b ($5.15 in chips)
Seat 3: 65b53c53 ($9.75 in chips)
Seat 4: Hero ($5 in chips)
Seat 5: bdb0c64b ($4.35 in chips)
Seat 6: a4c0e017 ($14.48 in chips)
c720730b: posts small blind $0.02
65b53c53: posts big blind $0.05
*** HOLE CARDS ***
Dealt to e497ef0d 
Dealt to c720730b 
Dealt to 65b53c53 
Dealt to Hero [9s Jd]
Dealt to bdb0c64b 
Dealt to a4c0e017 
Hero: folds
bdb0c64b: folds
a4c0e017: raises $0.05 to $0.1
e497ef0d: folds
c720730b: folds
65b53c53: folds
Uncalled bet ($0.05) returned to a4c0e017
*** SHOWDOWN ***
a4c0e017 collected $0.12 from pot
*** SUMMARY ***
Total pot $0.12 | Rake $0 | Jackpot $0 | Bingo $0 | Fortune $0 | Tax $0
Seat 1: e497ef0d (button) folded before Flop (didn't bet)
Seat 2: c720730b (small blind) folded before Flop
Seat 3: 65b53c53 (big blind) folded before Flop
Seat 4: Hero folded before Flop (didn't bet)
Seat 5: bdb0c64b folded before Flop (didn't bet)
Seat 6: a4c0e017 collected ($0.12)


Poker Hand #RC3812576619: Hold'em No Limit ($0.02/$0.05) - 2025/08/17 00:19:30
Table 'RushAndCash1101879' 6-max Seat #1 is the button
Seat 1: d0e0ca78 ($5.76 in chips)
Seat 2: c52dc030 ($4.02 in chips)
Seat 3: 19ee4bf8 ($5.74 in chips)
Seat 4: 40b86fc4 ($6.38 in chips)
Seat 5: Hero ($5 in chips)
Seat 6: 3d217258 ($2.33 in chips)
c52dc030: posts small blind $0.02
19ee4bf8: posts big blind $0.05
*** HOLE CARDS ***
Dealt to d0e0ca78 
Dealt to c52dc030 
Dealt to 19ee4bf8 
Dealt to 40b86fc4 
Dealt to Hero [2c Th]
Dealt to 3d217258 
40b86fc4: folds
Hero: folds
3d217258: folds
d0e0ca78: folds
c52dc030: raises $0.07 to $0.12
19ee4bf8: folds
Uncalled bet ($0.07) returned to c52dc030
*** SHOWDOWN ***
c52dc030 collected $0.1 from pot
*** SUMMARY ***
Total pot $0.1 | Rake $0 | Jackpot $0 | Bingo $0 | Fortune $0 | Tax $0
Seat 1: d0e0ca78 (button) folded before Flop (didn't bet)
Seat 2: c52dc030 (small blind) collected ($0.1)
Seat 3: 19ee4bf8 (big blind) folded before Flop
Seat 4: 40b86fc4 folded before Flop (didn't bet)
Seat 5: Hero folded before Flop (didn't bet)
Seat 6: 3d217258 folded before Flop (didn't bet)


Poker Hand #RC3812576581: Hold'em No Limit ($0.02/$0.05) - 2025/08/17 00:19:24
Table 'RushAndCash1101841' 6-max Seat #1 is the button
Seat 1: 5e8597fe ($5.43 in chips)
Seat 2: Hero ($5.02 in chips)
Seat 3: abd679ca ($10.7 in chips)
Seat 4: fe7b6407 ($12.2 in chips)
Seat 5: 1d14101c ($10.29 in chips)
Seat 6: d6c5e14a ($7.51 in chips)
Hero: posts small blind $0.02
abd679ca: posts big blind $0.05
*** HOLE CARDS ***
Dealt to 5e8597fe 
Dealt to Hero [Js 5d]
Dealt to abd679ca 
Dealt to fe7b6407 
Dealt to 1d14101c 
Dealt to d6c5e14a 
fe7b6407: folds
1d14101c: folds
d6c5e14a: folds
5e8597fe: folds
Hero: folds
Uncalled bet ($0.03) returned to abd679ca
*** SHOWDOWN ***
abd679ca collected $0.04 from pot
*** SUMMARY ***
Total pot $0.04 | Rake $0 | Jackpot $0 | Bingo $0 | Fortune $0 | Tax $0
Seat 1: 5e8597fe (button) folded before Flop (didn't bet)
Seat 2: Hero (small blind) folded before Flop
Seat 3: abd679ca (big blind) collected ($0.04)
Seat 4: fe7b6407 folded before Flop (didn't bet)
Seat 5: 1d14101c folded before Flop (didn't bet)
Seat 6: d6c5e14a folded before Flop (didn't bet)


Poker Hand #RC3812576125: Hold'em No Limit ($0.02/$0.05) - 2025/08/17 00:18:19
Table 'RushAndCash1101385' 6-max Seat #1 is the button
Seat 1: Hero ($5.15 in chips)
Seat 2: c524cca ($7.43 in chips)
Seat 3: 9d090b3f ($14.29 in chips)
Seat 4: 38b3dce8 ($6.75 in chips)
Seat 5: b10bc073 ($7.98 in chips)
Seat 6: a12a73c2 ($14.73 in chips)
c524cca: posts small blind $0.02
9d090b3f: posts big blind $0.05
*** HOLE CARDS ***
Dealt to Hero [7c Qc]
Dealt to c524cca 
Dealt to 9d090b3f 
Dealt to 38b3dce8 
Dealt to b10bc073 
Dealt to a12a73c2 
38b3dce8: raises $0.08 to $0.13
b10bc073: folds
a12a73c2: folds
Hero: calls $0.13
c524cca: calls $0.11
9d090b3f: folds
*** FLOP *** [Jd 4h Td]
c524cca: checks
38b3dce8: bets $0.22
Hero: folds
c524cca: calls $0.22
*** TURN *** [Jd 4h Td] [6h]
c524cca: checks
38b3dce8: bets $0.66
c524cca: calls $0.66
*** RIVER *** [Jd 4h Td 6h] [7d]
c524cca: checks
38b3dce8: checks
c524cca: shows [Th Tc] (three of a kind, Tens)
38b3dce8: shows [Ks Kh] (a pair of Kings)
*** SHOWDOWN ***
c524cca collected $2.03 from pot
*** SUMMARY ***
Total pot $2.2 | Rake $0.1 | Jackpot $0.07 | Bingo $0 | Fortune $0 | Tax $0
Board [Jd 4h Td 6h 7d]
Seat 1: Hero (button) folded on the Flop
Seat 2: c524cca (small blind) showed [Th Tc] and won ($2.03) with three of a kind, Tens
Seat 3: 9d090b3f (big blind) folded before Flop
Seat 4: 38b3dce8 showed [Ks Kh] and lost with a pair of Kings
Seat 5: b10bc073 folded before Flop (didn't bet)
Seat 6: a12a73c2 folded before Flop (didn't bet)


Poker Hand #RC3812576052: Hold'em No Limit ($0.02/$0.05) - 2025/08/17 00:18:09
Table 'RushAndCash1101312' 6-max Seat #1 is the button
Seat 1: a3a25fd6 ($5.27 in chips)
Seat 2: 4e0edac7 ($6.97 in chips)
Seat 3: Hero ($5.2 in chips)
Seat 4: da1a8bb7 ($5.56 in chips)
Seat 5: cfb3ed3a ($5.57 in chips)
Seat 6: 586134b2 ($1.96 in chips)
4e0edac7: posts small blind $0.02
Hero: posts big blind $0.05
*** HOLE CARDS ***
Dealt to a3a25fd6 
Dealt to 4e0edac7 
Dealt to Hero [8h 4d]
Dealt to da1a8bb7 
Dealt to cfb3ed3a 
Dealt to 586134b2 
da1a8bb7: folds
cfb3ed3a: folds
586134b2: folds
a3a25fd6: folds
4e0edac7: raises $0.1 to $0.15
Hero: folds
Uncalled bet ($0.1) returned to 4e0edac7
*** SHOWDOWN ***
4e0edac7 collected $0.1 from pot
*** SUMMARY ***
Total pot $0.1 | Rake $0 | Jackpot $0 | Bingo $0 | Fortune $0 | Tax $0
Seat 1: a3a25fd6 (button) folded before Flop (didn't bet)
Seat 2: 4e0edac7 (small blind) collected ($0.1)
Seat 3: Hero (big blind) folded before Flop
Seat 4: da1a8bb7 folded before Flop (didn't bet)
Seat 5: cfb3ed3a folded before Flop (didn't bet)
Seat 6: 586134b2 folded before Flop (didn't bet)


Poker Hand #RC3812576025: Hold'em No Limit ($0.02/$0.05) - 2025/08/17 00:18:06
Table 'RushAndCash1101285' 6-max Seat #1 is the button
Seat 1: b47d45d ($9.81 in chips)
Seat 2: b3f88d3 ($4.89 in chips)
Seat 3: 5d3f68c1 ($5.26 in chips)
Seat 4: 370bf11f ($5.17 in chips)
Seat 5: 198a273d ($5 in chips)
Seat 6: Hero ($5.2 in chips)
b3f88d3: posts small blind $0.02
5d3f68c1: posts big blind $0.05
*** HOLE CARDS ***
Dealt to b47d45d 
Dealt to b3f88d3 
Dealt to 5d3f68c1 
Dealt to 370bf11f 
Dealt to 198a273d 
Dealt to Hero [4s 7d]
370bf11f: folds
198a273d: raises $0.05 to $0.1
Hero: folds
b47d45d: folds
b3f88d3: folds
5d3f68c1: folds
Uncalled bet ($0.05) returned to 198a273d
*** SHOWDOWN ***
198a273d collected $0.12 from pot
*** SUMMARY ***
Total pot $0.12 | Rake $0 | Jackpot $0 | Bingo $0 | Fortune $0 | Tax $0
Seat 1: b47d45d (button) folded before Flop (didn't bet)
Seat 2: b3f88d3 (small blind) folded before Flop
Seat 3: 5d3f68c1 (big blind) folded before Flop
Seat 4: 370bf11f folded before Flop (didn't bet)
Seat 5: 198a273d collected ($0.12)
Seat 6: Hero folded before Flop (didn't bet)


Poker Hand #RC3812575959: Hold'em No Limit ($0.02/$0.05) - 2025/08/17 00:17:57
Table 'RushAndCash1101219' 6-max Seat #1 is the button
Seat 1: 8cfdd388 ($4.86 in chips)
Seat 2: a9d29b05 ($2.82 in chips)
Seat 3: ff883c83 ($5.51 in chips)
Seat 4: Hero ($5.13 in chips)
Seat 5: be1b7382 ($5.58 in chips)
Seat 6: df17c1a4 ($5.07 in chips)
a9d29b05: posts small blind $0.02
ff883c83: posts big blind $0.05
*** HOLE CARDS ***
Dealt to 8cfdd388 
Dealt to a9d29b05 
Dealt to ff883c83 
Dealt to Hero [Td 8d]
Dealt to be1b7382 
Dealt to df17c1a4 
Hero: raises $0.05 to $0.1
be1b7382: folds
df17c1a4: folds
8cfdd388: folds
a9d29b05: folds
ff883c83: folds
Uncalled bet ($0.05) returned to Hero
*** SHOWDOWN ***
Hero collected $0.12 from pot
*** SUMMARY ***
Total pot $0.12 | Rake $0 | Jackpot $0 | Bingo $0 | Fortune $0 | Tax $0
Seat 1: 8cfdd388 (button) folded before Flop (didn't bet)
Seat 2: a9d29b05 (small blind) folded before Flop
Seat 3: ff883c83 (big blind) folded before Flop
Seat 4: Hero collected ($0.12)
Seat 5: be1b7382 folded before Flop (didn't bet)
Seat 6: df17c1a4 folded before Flop (didn't bet)


Poker Hand #RC3812575932: Hold'em No Limit ($0.02/$0.05) - 2025/08/17 00:17:53
Table 'RushAndCash1101192' 6-max Seat #1 is the button
Seat 1: 64530568 ($6.44 in chips)
Seat 2: 45c428ad ($9.34 in chips)
Seat 3: 23bf44f5 ($19.49 in chips)
Seat 4: Hero ($5.13 in chips)
Seat 5: a76d7ff2 ($6.78 in chips)
Seat 6: ff883c83 ($5.51 in chips)
45c428ad: posts small blind $0.02
23bf44f5: posts big blind $0.05
*** HOLE CARDS ***
Dealt to 64530568 
Dealt to 45c428ad 
Dealt to 23bf44f5 
Dealt to Hero [4s Jd]
Dealt to a76d7ff2 
Dealt to ff883c83 
Hero: folds
a76d7ff2: raises $0.08 to $0.13
ff883c83: folds
64530568: folds
45c428ad: folds
23bf44f5: folds
Uncalled bet ($0.08) returned to a76d7ff2
*** SHOWDOWN ***
a76d7ff2 collected $0.12 from pot
*** SUMMARY ***
Total pot $0.12 | Rake $0 | Jackpot $0 | Bingo $0 | Fortune $0 | Tax $0
Seat 1: 64530568 (button) folded before Flop (didn't bet)
Seat 2: 45c428ad (small blind) folded before Flop
Seat 3: 23bf44f5 (big blind) folded before Flop
Seat 4: Hero folded before Flop (didn't bet)
Seat 5: a76d7ff2 collected ($0.12)
Seat 6: ff883c83 folded before Flop (didn't bet)


Poker Hand #RC3812575909: Hold'em No Limit ($0.02/$0.05) - 2025/08/17 00:17:50
Table 'RushAndCash1101169' 6-max Seat #1 is the button
Seat 1: 23bf44f5 ($19.49 in chips)
Seat 2: 2a067306 ($5.65 in chips)
Seat 3: Hero ($5.18 in chips)
Seat 4: c588248b ($5.89 in chips)
Seat 5: aa25214e ($5.12 in chips)
Seat 6: ff883c83 ($5.51 in chips)
2a067306: posts small blind $0.02
Hero: posts big blind $0.05
*** HOLE CARDS ***
Dealt to 23bf44f5 
Dealt to 2a067306 
Dealt to Hero [Tc 7s]
Dealt to c588248b 
Dealt to aa25214e 
Dealt to ff883c83 
c588248b: folds
aa25214e: folds
ff883c83: folds
23bf44f5: folds
2a067306: raises $0.05 to $0.1
Hero: folds
Uncalled bet ($0.05) returned to 2a067306
*** SHOWDOWN ***
2a067306 collected $0.1 from pot
*** SUMMARY ***
Total pot $0.1 | Rake $0 | Jackpot $0 | Bingo $0 | Fortune $0 | Tax $0
Seat 1: 23bf44f5 (button) folded before Flop (didn't bet)
Seat 2: 2a067306 (small blind) collected ($0.1)
Seat 3: Hero (big blind) folded before Flop
Seat 4: c588248b folded before Flop (didn't bet)
Seat 5: aa25214e folded before Flop (didn't bet)
Seat 6: ff883c83 folded before Flop (didn't bet)


Poker Hand #RC3812575503: Hold'em No Limit ($0.02/$0.05) - 2025/08/17 00:16:50
Table 'RushAndCash1100763' 6-max Seat #1 is the button
Seat 1: Hero ($5.62 in chips)
Seat 2: 2f496583 ($3.77 in chips)
Seat 3: 47791e92 ($5.12 in chips)
Seat 4: 55f6b164 ($9.14 in chips)
Seat 5: b40689b1 ($7.99 in chips)
Seat 6: 49fcfa7d ($7.57 in chips)
2f496583: posts small blind $0.02
47791e92: posts big blind $0.05
*** HOLE CARDS ***
Dealt to Hero [8s 7d]
Dealt to 2f496583 
Dealt to 47791e92 
Dealt to 55f6b164 
Dealt to b40689b1 
Dealt to 49fcfa7d 
55f6b164: folds
b40689b1: folds
49fcfa7d: folds
Hero: raises $0.05 to $0.1
2f496583: folds
47791e92: calls $0.05
*** FLOP *** [3d 9d 8c]
47791e92: checks
Hero: checks
*** TURN *** [3d 9d 8c] [Qc]
47791e92: bets $0.08
Hero: calls $0.08
*** RIVER *** [3d 9d 8c Qc] [3c]
47791e92: bets $0.26
Hero: calls $0.26
47791e92: shows [5c 7c] (a flush Queen high)
Hero: shows [8s 7d] (two pair, Eights and Threes)
*** SHOWDOWN ***
47791e92 collected $0.86 from pot
*** SUMMARY ***
Total pot $0.9 | Rake $0.04 | Jackpot $0 | Bingo $0 | Fortune $0 | Tax $0
Board [3d 9d 8c Qc 3c]
Seat 1: Hero (button) showed [8s 7d] and lost with two pair, Eights and Threes
Seat 2: 2f496583 (small blind) folded before Flop
Seat 3: 47791e92 (big blind) showed [5c 7c] and won ($0.86) with a flush Queen high
Seat 4: 55f6b164 folded before Flop (didn't bet)
Seat 5: b40689b1 folded before Flop (didn't bet)
Seat 6: 49fcfa7d folded before Flop (didn't bet)


Poker Hand #RC3812575421: Hold'em No Limit ($0.02/$0.05) - 2025/08/17 00:16:38
Table 'RushAndCash1100681' 6-max Seat #1 is the button
Seat 1: 38232278 ($11.4 in chips)
Seat 2: Hero ($5.64 in chips)
Seat 3: cfb3ed3a ($5.5 in chips)
Seat 4: a3ad240e ($17.31 in chips)
Seat 5: a14854c0 ($6.01 in chips)
Seat 6: d57b353c ($9.76 in chips)
Hero: posts small blind $0.02
cfb3ed3a: posts big blind $0.05
*** HOLE CARDS ***
Dealt to 38232278 
Dealt to Hero [Ah 2d]
Dealt to cfb3ed3a 
Dealt to a3ad240e 
Dealt to a14854c0 
Dealt to d57b353c 
a3ad240e: folds
a14854c0: raises $0.05 to $0.1
d57b353c: folds
38232278: folds
Hero: folds
cfb3ed3a: folds
Uncalled bet ($0.05) returned to a14854c0
*** SHOWDOWN ***
a14854c0 collected $0.12 from pot
*** SUMMARY ***
Total pot $0.12 | Rake $0 | Jackpot $0 | Bingo $0 | Fortune $0 | Tax $0
Seat 1: 38232278 (button) folded before Flop (didn't bet)
Seat 2: Hero (small blind) folded before Flop
Seat 3: cfb3ed3a (big blind) folded before Flop
Seat 4: a3ad240e folded before Flop (didn't bet)
Seat 5: a14854c0 collected ($0.12)
Seat 6: d57b353c folded before Flop (didn't bet)


Poker Hand #RC3812575395: Hold'em No Limit ($0.02/$0.05) - 2025/08/17 00:16:35
Table 'RushAndCash1100655' 6-max Seat #1 is the button
Seat 1: 50f2aa83 ($0.71 in chips)
Seat 2: a3e00340 ($5.34 in chips)
Seat 3: 69988f3c ($5.74 in chips)
Seat 4: e5bb6ce3 ($4.79 in chips)
Seat 5: af0142ec ($9.64 in chips)
Seat 6: Hero ($5.64 in chips)
a3e00340: posts small blind $0.02
69988f3c: posts big blind $0.05
*** HOLE CARDS ***
Dealt to 50f2aa83 
Dealt to a3e00340 
Dealt to 69988f3c 
Dealt to e5bb6ce3 
Dealt to af0142ec 
Dealt to Hero [Qd 6d]
e5bb6ce3: folds
af0142ec: raises $0.05 to $0.1
Hero: folds
50f2aa83: folds
a3e00340: folds
69988f3c: folds
Uncalled bet ($0.05) returned to af0142ec
*** SHOWDOWN ***
af0142ec collected $0.12 from pot
*** SUMMARY ***
Total pot $0.12 | Rake $0 | Jackpot $0 | Bingo $0 | Fortune $0 | Tax $0
Seat 1: 50f2aa83 (button) folded before Flop (didn't bet)
Seat 2: a3e00340 (small blind) folded before Flop
Seat 3: 69988f3c (big blind) folded before Flop
Seat 4: e5bb6ce3 folded before Flop (didn't bet)
Seat 5: af0142ec collected ($0.12)
Seat 6: Hero folded before Flop (didn't bet)


Poker Hand #RC3812575243: Hold'em No Limit ($0.02/$0.05) - 2025/08/17 00:16:11
Table 'RushAndCash1100503' 6-max Seat #1 is the button
Seat 1: c2818c57 ($7.17 in chips)
Seat 2: e5bb6ce3 ($4.84 in chips)
Seat 3: Hero ($5.59 in chips)
Seat 4: 5b495593 ($4.81 in chips)
Seat 5: ebea61cd ($7.87 in chips)
Seat 6: b462e6a5 ($3.35 in chips)
e5bb6ce3: posts small blind $0.02
Hero: posts big blind $0.05
*** HOLE CARDS ***
Dealt to c2818c57 
Dealt to e5bb6ce3 
Dealt to Hero [4h 7h]
Dealt to 5b495593 
Dealt to ebea61cd 
Dealt to b462e6a5 
5b495593: folds
ebea61cd: folds
b462e6a5: folds
c2818c57: folds
e5bb6ce3: calls $0.03
Hero: raises $0.13 to $0.18
e5bb6ce3: folds
Uncalled bet ($0.13) returned to Hero
*** SHOWDOWN ***
Hero collected $0.1 from pot
*** SUMMARY ***
Total pot $0.1 | Rake $0 | Jackpot $0 | Bingo $0 | Fortune $0 | Tax $0
Seat 1: c2818c57 (button) folded before Flop (didn't bet)
Seat 2: e5bb6ce3 (small blind) folded before Flop
Seat 3: Hero (big blind) collected ($0.1)
Seat 4: 5b495593 folded before Flop (didn't bet)
Seat 5: ebea61cd folded before Flop (didn't bet)
Seat 6: b462e6a5 folded before Flop (didn't bet)


Poker Hand #RC3812575013: Hold'em No Limit ($0.02/$0.05) - 2025/08/17 00:15:37
Table 'RushAndCash1100273' 6-max Seat #1 is the button
Seat 1: cfb3ed3a ($5.5 in chips)
Seat 2: 2f2d0946 ($5.83 in chips)
Seat 3: b462e6a5 ($3.08 in chips)
Seat 4: f091de86 ($7.17 in chips)
Seat 5: c8f14884 ($10.76 in chips)
Seat 6: Hero ($5.86 in chips)
2f2d0946: posts small blind $0.02
b462e6a5: posts big blind $0.05
*** HOLE CARDS ***
Dealt to cfb3ed3a 
Dealt to 2f2d0946 
Dealt to b462e6a5 
Dealt to f091de86 
Dealt to c8f14884 
Dealt to Hero [8c 8h]
f091de86: folds
c8f14884: folds
Hero: raises $0.05 to $0.1
cfb3ed3a: folds
2f2d0946: folds
b462e6a5: raises $0.17 to $0.27
Hero: calls $0.17
*** FLOP *** [5s Qc Kd]
b462e6a5: bets $0.42
Hero: folds
Uncalled bet ($0.42) returned to b462e6a5
*** SHOWDOWN ***
b462e6a5 collected $0.54 from pot
*** SUMMARY ***
Total pot $0.56 | Rake $0.02 | Jackpot $0 | Bingo $0 | Fortune $0 | Tax $0
Board [5s Qc Kd]
Seat 1: cfb3ed3a (button) folded before Flop (didn't bet)
Seat 2: 2f2d0946 (small blind) folded before Flop
Seat 3: b462e6a5 (big blind) won ($0.54)
Seat 4: f091de86 folded before Flop (didn't bet)
Seat 5: c8f14884 folded before Flop (didn't bet)
Seat 6: Hero folded on the Flop


Poker Hand #RC3812574990: Hold'em No Limit ($0.02/$0.05) - 2025/08/17 00:15:33
Table 'RushAndCash1100250' 6-max Seat #1 is the button
Seat 1: b8b4ddac ($3.01 in chips)
Seat 2: 29017380 ($6.64 in chips)
Seat 3: 322df1e2 ($2.95 in chips)
Seat 4: Hero ($5.86 in chips)
Seat 5: b38cf654 ($5.97 in chips)
Seat 6: b9c219d6 ($10.62 in chips)
29017380: posts small blind $0.02
322df1e2: posts big blind $0.05
*** HOLE CARDS ***
Dealt to b8b4ddac 
Dealt to 29017380 
Dealt to 322df1e2 
Dealt to Hero [3c As]
Dealt to b38cf654 
Dealt to b9c219d6 
Hero: folds
b38cf654: raises $0.06 to $0.11
b9c219d6: folds
b8b4ddac: calls $0.11
29017380: folds
322df1e2: calls $0.06
*** FLOP *** [9d Td Ts]
322df1e2: bets $0.18
b38cf654: folds
b8b4ddac: calls $0.18
*** TURN *** [9d Td Ts] [Kc]
322df1e2: bets $0.57
b8b4ddac: calls $0.57
*** RIVER *** [9d Td Ts Kc] [7h]
322df1e2: bets $1.48
b8b4ddac: raises $0.67 to $2.15 and is all-in
322df1e2: calls $0.61 and is all-in
Uncalled bet ($0.06) returned to b8b4ddac
b8b4ddac: shows [Jc Th] (three of a kind, Tens)
322df1e2: shows [9h Kd] (two pair, Kings and Tens)
*** SHOWDOWN ***
b8b4ddac collected $5.71 from pot
*** SUMMARY ***
Total pot $6.03 | Rake $0.25 | Jackpot $0.07 | Bingo $0 | Fortune $0 | Tax $0
Board [9d Td Ts Kc 7h]
Seat 1: b8b4ddac (button) showed [Jc Th] and won ($5.71) with three of a kind, Tens
Seat 2: 29017380 (small blind) folded before Flop
Seat 3: 322df1e2 (big blind) showed [9h Kd] and lost with two pair, Kings and Tens
Seat 4: Hero folded before Flop (didn't bet)
Seat 5: b38cf654 folded on the Flop
Seat 6: b9c219d6 folded before Flop (didn't bet)


Poker Hand #RC3812574937: Hold'em No Limit ($0.02/$0.05) - 2025/08/17 00:15:25
Table 'RushAndCash1100197' 6-max Seat #1 is the button
Seat 1: 4e0edac7 ($5 in chips)
Seat 2: 8b2de828 ($6.46 in chips)
Seat 3: 152d114e ($5 in chips)
Seat 4: b40689b1 ($8.29 in chips)
Seat 5: Hero ($5.86 in chips)
Seat 6: a4c0e017 ($14.82 in chips)
8b2de828: posts small blind $0.02
152d114e: posts big blind $0.05
*** HOLE CARDS ***
Dealt to 4e0edac7 
Dealt to 8b2de828 
Dealt to 152d114e 
Dealt to b40689b1 
Dealt to Hero [8s Qs]
Dealt to a4c0e017 
b40689b1: raises $0.05 to $0.1
Hero: folds
a4c0e017: calls $0.1
4e0edac7: folds
8b2de828: folds
152d114e: calls $0.05
*** FLOP *** [7s Kc 3c]
152d114e: checks
b40689b1: checks
a4c0e017: checks
*** TURN *** [7s Kc 3c] [3s]
152d114e: bets $0.16
b40689b1: calls $0.16
a4c0e017: folds
*** RIVER *** [7s Kc 3c 3s] [8h]
152d114e: bets $0.48
b40689b1: folds
Uncalled bet ($0.48) returned to 152d114e
*** SHOWDOWN ***
152d114e collected $0.61 from pot
*** SUMMARY ***
Total pot $0.64 | Rake $0.03 | Jackpot $0 | Bingo $0 | Fortune $0 | Tax $0
Board [7s Kc 3c 3s 8h]
Seat 1: 4e0edac7 (button) folded before Flop (didn't bet)
Seat 2: 8b2de828 (small blind) folded before Flop
Seat 3: 152d114e (big blind) won ($0.61)
Seat 4: b40689b1 folded on the River
Seat 5: Hero folded before Flop (didn't bet)
Seat 6: a4c0e017 folded on the Turn


Poker Hand #RC3812574914: Hold'em No Limit ($0.02/$0.05) - 2025/08/17 00:15:21
Table 'RushAndCash1100174' 6-max Seat #1 is the button
Seat 1: Hero ($5.86 in chips)
Seat 2: 76a6732 ($1.19 in chips)
Seat 3: 13e6d3a5 ($5.49 in chips)
Seat 4: 15f48232 ($5.17 in chips)
Seat 5: a3e00340 ($5.47 in chips)
Seat 6: be764eb3 ($6.38 in chips)
76a6732: posts small blind $0.02
13e6d3a5: posts big blind $0.05
*** HOLE CARDS ***
Dealt to Hero [6d Ks]
Dealt to 76a6732 
Dealt to 13e6d3a5 
Dealt to 15f48232 
Dealt to a3e00340 
Dealt to be764eb3 
15f48232: folds
a3e00340: folds
be764eb3: folds
Hero: folds
76a6732: raises $0.08 to $0.13
13e6d3a5: folds
Uncalled bet ($0.08) returned to 76a6732
*** SHOWDOWN ***
76a6732 collected $0.1 from pot
*** SUMMARY ***
Total pot $0.1 | Rake $0 | Jackpot $0 | Bingo $0 | Fortune $0 | Tax $0
Seat 1: Hero (button) folded before Flop (didn't bet)
Seat 2: 76a6732 (small blind) collected ($0.1)
Seat 3: 13e6d3a5 (big blind) folded before Flop
Seat 4: 15f48232 folded before Flop (didn't bet)
Seat 5: a3e00340 folded before Flop (didn't bet)
Seat 6: be764eb3 folded before Flop (didn't bet)


Poker Hand #RC3812574892: Hold'em No Limit ($0.02/$0.05) - 2025/08/17 00:15:17
Table 'RushAndCash1100152' 6-max Seat #1 is the button
Seat 1: b3e1cb65 ($3.23 in chips)
Seat 2: dcd1495c ($5 in chips)
Seat 3: eca19587 ($5.88 in chips)
Seat 4: Hero ($5.86 in chips)
Seat 5: 23bf44f5 ($19.19 in chips)
Seat 6: db3f59ad ($6.07 in chips)
dcd1495c: posts small blind $0.02
eca19587: posts big blind $0.05
*** HOLE CARDS ***
Dealt to b3e1cb65 
Dealt to dcd1495c 
Dealt to eca19587 
Dealt to Hero [Kc 9d]
Dealt to 23bf44f5 
Dealt to db3f59ad 
Hero: folds
23bf44f5: folds
db3f59ad: folds
b3e1cb65: folds
dcd1495c: raises $0.1 to $0.15
eca19587: folds
Uncalled bet ($0.1) returned to dcd1495c
*** SHOWDOWN ***
dcd1495c collected $0.1 from pot
*** SUMMARY ***
Total pot $0.1 | Rake $0 | Jackpot $0 | Bingo $0 | Fortune $0 | Tax $0
Seat 1: b3e1cb65 (button) folded before Flop (didn't bet)
Seat 2: dcd1495c (small blind) collected ($0.1)
Seat 3: eca19587 (big blind) folded before Flop
Seat 4: Hero folded before Flop (didn't bet)
Seat 5: 23bf44f5 folded before Flop (didn't bet)
Seat 6: db3f59ad folded before Flop (didn't bet)


Poker Hand #RC3812574854: Hold'em No Limit ($0.02/$0.05) - 2025/08/17 00:15:12
Table 'RushAndCash1100114' 6-max Seat #1 is the button
Seat 1: 45cd7959 ($8.66 in chips)
Seat 2: af0142ec ($10 in chips)
Seat 3: d06a4f64 ($5.07 in chips)
Seat 4: Hero ($5.86 in chips)
Seat 5: b40689b1 ($8.32 in chips)
Seat 6: 82bd9450 ($7.9 in chips)
af0142ec: posts small blind $0.02
d06a4f64: posts big blind $0.05
*** HOLE CARDS ***
Dealt to 45cd7959 
Dealt to af0142ec 
Dealt to d06a4f64 
Dealt to Hero [4h 6s]
Dealt to b40689b1 
Dealt to 82bd9450 
Hero: folds
b40689b1: folds
82bd9450: folds
45cd7959: raises $0.08 to $0.13
af0142ec: calls $0.11
d06a4f64: folds
*** FLOP *** [4d Js 4s]
af0142ec: checks
45cd7959: bets $0.11
af0142ec: folds
Uncalled bet ($0.11) returned to 45cd7959
*** SHOWDOWN ***
45cd7959 collected $0.3 from pot
*** SUMMARY ***
Total pot $0.31 | Rake $0.01 | Jackpot $0 | Bingo $0 | Fortune $0 | Tax $0
Board [4d Js 4s]
Seat 1: 45cd7959 (button) won ($0.3)
Seat 2: af0142ec (small blind) folded on the Flop
Seat 3: d06a4f64 (big blind) folded before Flop
Seat 4: Hero folded before Flop (didn't bet)
Seat 5: b40689b1 folded before Flop (didn't bet)
Seat 6: 82bd9450 folded before Flop (didn't bet)


Poker Hand #RC3812574753: Hold'em No Limit ($0.02/$0.05) - 2025/08/17 00:14:57
Table 'RushAndCash1100013' 6-max Seat #1 is the button
Seat 1: e2d6a8fa ($5 in chips)
Seat 2: Hero ($5.88 in chips)
Seat 3: b5be416 ($6.16 in chips)
Seat 4: 5f1dba5d ($3.68 in chips)
Seat 5: 8796ee10 ($5 in chips)
Seat 6: de87a73 ($9.07 in chips)
Hero: posts small blind $0.02
b5be416: posts big blind $0.05
*** HOLE CARDS ***
Dealt to e2d6a8fa 
Dealt to Hero [9d Kd]
Dealt to b5be416 
Dealt to 5f1dba5d 
Dealt to 8796ee10 
Dealt to de87a73 
5f1dba5d: folds
8796ee10: raises $0.1 to $0.15
de87a73: folds
e2d6a8fa: folds
Hero: folds
b5be416: folds
Uncalled bet ($0.1) returned to 8796ee10
*** SHOWDOWN ***
8796ee10 collected $0.12 from pot
*** SUMMARY ***
Total pot $0.12 | Rake $0 | Jackpot $0 | Bingo $0 | Fortune $0 | Tax $0
Seat 1: e2d6a8fa (button) folded before Flop (didn't bet)
Seat 2: Hero (small blind) folded before Flop
Seat 3: b5be416 (big blind) folded before Flop
Seat 4: 5f1dba5d folded before Flop (didn't bet)
Seat 5: 8796ee10 collected ($0.12)
Seat 6: de87a73 folded before Flop (didn't bet)


Poker Hand #RC3812544285: Hold'em No Limit ($0.02/$0.05) - 2025/08/17 00:13:45
Table 'RushAndCash1099545' 6-max Seat #1 is the button
Seat 1: e19aa51e ($10.27 in chips)
Seat 2: cab7f6dd ($12.33 in chips)
Seat 3: Hero ($6.14 in chips)
Seat 4: b5be416 ($5.66 in chips)
Seat 5: ca6a4ee8 ($17.62 in chips)
Seat 6: d6b9968d ($5 in chips)
cab7f6dd: posts small blind $0.02
Hero: posts big blind $0.05
*** HOLE CARDS ***
Dealt to e19aa51e 
Dealt to cab7f6dd 
Dealt to Hero [8s 7s]
Dealt to b5be416 
Dealt to ca6a4ee8 
Dealt to d6b9968d 
b5be416: raises $0.05 to $0.1
ca6a4ee8: folds
d6b9968d: calls $0.1
e19aa51e: folds
cab7f6dd: folds
Hero: calls $0.05
*** FLOP *** [Js 9d 9h]
Hero: bets $0.16
b5be416: calls $0.16
d6b9968d: calls $0.16
*** TURN *** [Js 9d 9h] [Kh]
Hero: checks
b5be416: checks
d6b9968d: checks
*** RIVER *** [Js 9d 9h Kh] [Qh]
Hero: checks
b5be416: bets $0.27
d6b9968d: folds
Hero: folds
Uncalled bet ($0.27) returned to b5be416
*** SHOWDOWN ***
b5be416 collected $0.76 from pot
*** SUMMARY ***
Total pot $0.8 | Rake $0.04 | Jackpot $0 | Bingo $0 | Fortune $0 | Tax $0
Board [Js 9d 9h Kh Qh]
Seat 1: e19aa51e (button) folded before Flop (didn't bet)
Seat 2: cab7f6dd (small blind) folded before Flop
Seat 3: Hero (big blind) folded on the River
Seat 4: b5be416 won ($0.76)
Seat 5: ca6a4ee8 folded before Flop (didn't bet)
Seat 6: d6b9968d folded on the River


Poker Hand #RC3812544259: Hold'em No Limit ($0.02/$0.05) - 2025/08/17 00:13:42
Table 'RushAndCash1099519' 6-max Seat #1 is the button
Seat 1: adc4285d ($6.37 in chips)
Seat 2: dd2d083a ($14.9 in chips)
Seat 3: 38a6bd57 ($5.14 in chips)
Seat 4: 39ac0eea ($4.58 in chips)
Seat 5: f2b30c1a ($6.09 in chips)
Seat 6: Hero ($6.14 in chips)
dd2d083a: posts small blind $0.02
38a6bd57: posts big blind $0.05
*** HOLE CARDS ***
Dealt to adc4285d 
Dealt to dd2d083a 
Dealt to 38a6bd57 
Dealt to 39ac0eea 
Dealt to f2b30c1a 
Dealt to Hero [7d 9c]
39ac0eea: folds
f2b30c1a: raises $0.1 to $0.15
Hero: folds
adc4285d: raises $0.35 to $0.5
dd2d083a: folds
38a6bd57: folds
f2b30c1a: folds
Uncalled bet ($0.35) returned to adc4285d
*** SHOWDOWN ***
adc4285d collected $0.36 from pot
*** SUMMARY ***
Total pot $0.37 | Rake $0.01 | Jackpot $0 | Bingo $0 | Fortune $0 | Tax $0
Seat 1: adc4285d (button) collected ($0.36)
Seat 2: dd2d083a (small blind) folded before Flop
Seat 3: 38a6bd57 (big blind) folded before Flop
Seat 4: 39ac0eea folded before Flop (didn't bet)
Seat 5: f2b30c1a folded before Flop
Seat 6: Hero folded before Flop (didn't bet)


Poker Hand #RC3812544236: Hold'em No Limit ($0.02/$0.05) - 2025/08/17 00:13:38
Table 'RushAndCash1099496' 6-max Seat #1 is the button
Seat 1: dc3fa085 ($5.05 in chips)
Seat 2: 9236d969 ($5.45 in chips)
Seat 3: cab7f6dd ($12.38 in chips)
Seat 4: 4a3e59cc ($12.42 in chips)
Seat 5: 5de6fbbd ($7.94 in chips)
Seat 6: Hero ($6.14 in chips)
9236d969: posts small blind $0.02
cab7f6dd: posts big blind $0.05
*** HOLE CARDS ***
Dealt to dc3fa085 
Dealt to 9236d969 
Dealt to cab7f6dd 
Dealt to 4a3e59cc 
Dealt to 5de6fbbd 
Dealt to Hero [Kh 7d]
4a3e59cc: folds
5de6fbbd: raises $0.06 to $0.11
Hero: folds
dc3fa085: folds
9236d969: folds
cab7f6dd: folds
Uncalled bet ($0.06) returned to 5de6fbbd
*** SHOWDOWN ***
5de6fbbd collected $0.12 from pot
*** SUMMARY ***
Total pot $0.12 | Rake $0 | Jackpot $0 | Bingo $0 | Fortune $0 | Tax $0
Seat 1: dc3fa085 (button) folded before Flop (didn't bet)
Seat 2: 9236d969 (small blind) folded before Flop
Seat 3: cab7f6dd (big blind) folded before Flop
Seat 4: 4a3e59cc folded before Flop (didn't bet)
Seat 5: 5de6fbbd collected ($0.12)
Seat 6: Hero folded before Flop (didn't bet)


Poker Hand #RC3812544214: Hold'em No Limit ($0.02/$0.05) - 2025/08/17 00:13:35
Table 'RushAndCash1099474' 6-max Seat #1 is the button
Seat 1: 34973e73 ($6.75 in chips)
Seat 2: b12df020 ($5.98 in chips)
Seat 3: 9236d969 ($5.5 in chips)
Seat 4: 76a6732 ($0.92 in chips)
Seat 5: Hero ($6.14 in chips)
Seat 6: e465369f ($3.91 in chips)
b12df020: posts small blind $0.02
9236d969: posts big blind $0.05
*** HOLE CARDS ***
Dealt to 34973e73 
Dealt to b12df020 
Dealt to 9236d969 
Dealt to 76a6732 
Dealt to Hero [9h Js]
Dealt to e465369f 
76a6732: folds
Hero: folds
e465369f: folds
34973e73: raises $0.07 to $0.12
b12df020: folds
9236d969: folds
Uncalled bet ($0.07) returned to 34973e73
*** SHOWDOWN ***
34973e73 collected $0.12 from pot
*** SUMMARY ***
Total pot $0.12 | Rake $0 | Jackpot $0 | Bingo $0 | Fortune $0 | Tax $0
Seat 1: 34973e73 (button) collected ($0.12)
Seat 2: b12df020 (small blind) folded before Flop
Seat 3: 9236d969 (big blind) folded before Flop
Seat 4: 76a6732 folded before Flop (didn't bet)
Seat 5: Hero folded before Flop (didn't bet)
Seat 6: e465369f folded before Flop (didn't bet)


Poker Hand #RC3812544128: Hold'em No Limit ($0.02/$0.05) - 2025/08/17 00:13:21
Table 'RushAndCash1099388' 6-max Seat #1 is the button
Seat 1: 904a6728 ($8.76 in chips)
Seat 2: Hero ($6.16 in chips)
Seat 3: 2bc41931 ($8.17 in chips)
Seat 4: c70f12ac ($6.67 in chips)
Seat 5: e996df8c ($6.4 in chips)
Seat 6: 5a08eb4c ($5.86 in chips)
Hero: posts small blind $0.02
2bc41931: posts big blind $0.05
*** HOLE CARDS ***
Dealt to 904a6728 
Dealt to Hero [8s Kc]
Dealt to 2bc41931 
Dealt to c70f12ac 
Dealt to e996df8c 
Dealt to 5a08eb4c 
c70f12ac: folds
e996df8c: raises $0.05 to $0.1
5a08eb4c: folds
904a6728: folds
Hero: folds
2bc41931: folds
Uncalled bet ($0.05) returned to e996df8c
*** SHOWDOWN ***
e996df8c collected $0.12 from pot
*** SUMMARY ***
Total pot $0.12 | Rake $0 | Jackpot $0 | Bingo $0 | Fortune $0 | Tax $0
Seat 1: 904a6728 (button) folded before Flop (didn't bet)
Seat 2: Hero (small blind) folded before Flop
Seat 3: 2bc41931 (big blind) folded before Flop
Seat 4: c70f12ac folded before Flop (didn't bet)
Seat 5: e996df8c collected ($0.12)
Seat 6: 5a08eb4c folded before Flop (didn't bet)


Poker Hand #RC3812543912: Hold'em No Limit ($0.02/$0.05) - 2025/08/17 00:12:50
Table 'RushAndCash1099172' 6-max Seat #1 is the button
Seat 1: Hero ($6.26 in chips)
Seat 2: e996df8c ($6.26 in chips)
Seat 3: a6ed4953 ($6.33 in chips)
Seat 4: c70f12ac ($6.67 in chips)
Seat 5: 5bca817b ($5.71 in chips)
Seat 6: e7bf8e2c ($5.65 in chips)
e996df8c: posts small blind $0.02
a6ed4953: posts big blind $0.05
*** HOLE CARDS ***
Dealt to Hero [Ah 2d]
Dealt to e996df8c 
Dealt to a6ed4953 
Dealt to c70f12ac 
Dealt to 5bca817b 
Dealt to e7bf8e2c 
c70f12ac: folds
5bca817b: folds
e7bf8e2c: folds
Hero: raises $0.05 to $0.1
e996df8c: calls $0.08
a6ed4953: folds
*** FLOP *** [6c 7s Ks]
e996df8c: checks
Hero: checks
*** TURN *** [6c 7s Ks] [Qh]
e996df8c: bets $0.09
Hero: folds
Uncalled bet ($0.09) returned to e996df8c
*** SHOWDOWN ***
e996df8c collected $0.24 from pot
*** SUMMARY ***
Total pot $0.25 | Rake $0.01 | Jackpot $0 | Bingo $0 | Fortune $0 | Tax $0
Board [6c 7s Ks Qh]
Seat 1: Hero (button) folded on the Turn
Seat 2: e996df8c (small blind) won ($0.24)
Seat 3: a6ed4953 (big blind) folded before Flop
Seat 4: c70f12ac folded before Flop (didn't bet)
Seat 5: 5bca817b folded before Flop (didn't bet)
Seat 6: e7bf8e2c folded before Flop (didn't bet)


Poker Hand #RC3812543577: Hold'em No Limit ($0.02/$0.05) - 2025/08/17 00:12:04
Table 'RushAndCash1098837' 6-max Seat #1 is the button
Seat 1: d6a18d8f ($7.39 in chips)
Seat 2: 1faf0c0f ($9.86 in chips)
Seat 3: Hero ($6.47 in chips)
Seat 4: 140192a0 ($5 in chips)
Seat 5: d908e95f ($8.15 in chips)
Seat 6: 23bf44f5 ($17.2 in chips)
1faf0c0f: posts small blind $0.02
Hero: posts big blind $0.05
*** HOLE CARDS ***
Dealt to d6a18d8f 
Dealt to 1faf0c0f 
Dealt to Hero [9c Ac]
Dealt to 140192a0 
Dealt to d908e95f 
Dealt to 23bf44f5 
140192a0: folds
d908e95f: folds
23bf44f5: folds
d6a18d8f: raises $0.05 to $0.1
1faf0c0f: folds
Hero: calls $0.05
*** FLOP *** [Ad Kd 5s]
Hero: checks
d6a18d8f: checks
*** TURN *** [Ad Kd 5s] [Tc]
Hero: bets $0.11
d6a18d8f: raises $0.33 to $0.44
Hero: folds
Uncalled bet ($0.33) returned to d6a18d8f
*** SHOWDOWN ***
d6a18d8f collected $0.42 from pot
*** SUMMARY ***
Total pot $0.44 | Rake $0.02 | Jackpot $0 | Bingo $0 | Fortune $0 | Tax $0
Board [Ad Kd 5s Tc]
Seat 1: d6a18d8f (button) won ($0.42)
Seat 2: 1faf0c0f (small blind) folded before Flop
Seat 3: Hero (big blind) folded on the Turn
Seat 4: 140192a0 folded before Flop (didn't bet)
Seat 5: d908e95f folded before Flop (didn't bet)
Seat 6: 23bf44f5 folded before Flop (didn't bet)


Poker Hand #RC3812543549: Hold'em No Limit ($0.02/$0.05) - 2025/08/17 00:12:00
Table 'RushAndCash1098809' 6-max Seat #1 is the button
Seat 1: 58a9ed38 ($8.99 in chips)
Seat 2: fc4eb47b ($3.87 in chips)
Seat 3: 84340a2d ($5.21 in chips)
Seat 4: 84123a7e ($5 in chips)
Seat 5: 904a6728 ($7.5 in chips)
Seat 6: Hero ($6.47 in chips)
fc4eb47b: posts small blind $0.02
84340a2d: posts big blind $0.05
*** HOLE CARDS ***
Dealt to 58a9ed38 
Dealt to fc4eb47b 
Dealt to 84340a2d 
Dealt to 84123a7e 
Dealt to 904a6728 
Dealt to Hero [Ts 2c]
84123a7e: folds
904a6728: folds
Hero: folds
58a9ed38: folds
fc4eb47b: raises $0.05 to $0.1
84340a2d: calls $0.05
*** FLOP *** [5h 9d Td]
fc4eb47b: checks
84340a2d: bets $0.1
fc4eb47b: calls $0.1
*** TURN *** [5h 9d Td] [6d]
fc4eb47b: bets $0.14
84340a2d: raises $0.31 to $0.45
fc4eb47b: folds
Uncalled bet ($0.31) returned to 84340a2d
*** SHOWDOWN ***
84340a2d collected $0.65 from pot
*** SUMMARY ***
Total pot $0.68 | Rake $0.03 | Jackpot $0 | Bingo $0 | Fortune $0 | Tax $0
Board [5h 9d Td 6d]
Seat 1: 58a9ed38 (button) folded before Flop (didn't bet)
Seat 2: fc4eb47b (small blind) folded on the Turn
Seat 3: 84340a2d (big blind) won ($0.65)
Seat 4: 84123a7e folded before Flop (didn't bet)
Seat 5: 904a6728 folded before Flop (didn't bet)
Seat 6: Hero folded before Flop (didn't bet)


Poker Hand #RC3812543239: Hold'em No Limit ($0.02/$0.05) - 2025/08/17 00:11:14
Table 'RushAndCash1098499' 6-max Seat #1 is the button
Seat 1: Hero ($6.16 in chips)
Seat 2: 4860fc97 ($7.32 in chips)
Seat 3: 525afd03 ($5 in chips)
Seat 4: c365d633 ($6.14 in chips)
Seat 5: 9166e4c6 ($5.05 in chips)
Seat 6: d0693aa ($5.51 in chips)
4860fc97: posts small blind $0.02
525afd03: posts big blind $0.05
*** HOLE CARDS ***
Dealt to Hero [3d 3s]
Dealt to 4860fc97 
Dealt to 525afd03 
Dealt to c365d633 
Dealt to 9166e4c6 
Dealt to d0693aa 
c365d633: folds
9166e4c6: folds
d0693aa: raises $0.06 to $0.11
Hero: calls $0.11
4860fc97: calls $0.09
525afd03: calls $0.06
*** FLOP *** [2h 3c Ts]
4860fc97: checks
525afd03: checks
d0693aa: checks
Hero: bets $0.22
4860fc97: folds
525afd03: folds
d0693aa: folds
Uncalled bet ($0.22) returned to Hero
*** SHOWDOWN ***
Hero collected $0.42 from pot
*** SUMMARY ***
Total pot $0.44 | Rake $0.02 | Jackpot $0 | Bingo $0 | Fortune $0 | Tax $0
Board [2h 3c Ts]
Seat 1: Hero (button) won ($0.42)
Seat 2: 4860fc97 (small blind) folded on the Flop
Seat 3: 525afd03 (big blind) folded on the Flop
Seat 4: c365d633 folded before Flop (didn't bet)
Seat 5: 9166e4c6 folded before Flop (didn't bet)
Seat 6: d0693aa folded on the Flop


Poker Hand #RC3812543176: Hold'em No Limit ($0.02/$0.05) - 2025/08/17 00:11:05
Table 'RushAndCash1098436' 6-max Seat #1 is the button
Seat 1: cb2fdb7e ($16.87 in chips)
Seat 2: Hero ($6.18 in chips)
Seat 3: 49fcfa7d ($7.11 in chips)
Seat 4: 2eef6371 ($5 in chips)
Seat 5: 9166e4c6 ($5.07 in chips)
Seat 6: 8df3078 ($4.29 in chips)
Hero: posts small blind $0.02
49fcfa7d: posts big blind $0.05
*** HOLE CARDS ***
Dealt to cb2fdb7e 
Dealt to Hero [3d Th]
Dealt to 49fcfa7d 
Dealt to 2eef6371 
Dealt to 9166e4c6 
Dealt to 8df3078 
2eef6371: folds
9166e4c6: folds
8df3078: folds
cb2fdb7e: folds
Hero: folds
Uncalled bet ($0.03) returned to 49fcfa7d
*** SHOWDOWN ***
49fcfa7d collected $0.04 from pot
*** SUMMARY ***
Total pot $0.04 | Rake $0 | Jackpot $0 | Bingo $0 | Fortune $0 | Tax $0
Seat 1: cb2fdb7e (button) folded before Flop (didn't bet)
Seat 2: Hero (small blind) folded before Flop
Seat 3: 49fcfa7d (big blind) collected ($0.04)
Seat 4: 2eef6371 folded before Flop (didn't bet)
Seat 5: 9166e4c6 folded before Flop (didn't bet)
Seat 6: 8df3078 folded before Flop (didn't bet)


Poker Hand #RC3812543152: Hold'em No Limit ($0.02/$0.05) - 2025/08/17 00:11:01
Table 'RushAndCash1098412' 6-max Seat #1 is the button
Seat 1: 49fcfa7d ($7.11 in chips)
Seat 2: 370bf11f ($6.08 in chips)
Seat 3: db3f59ad ($5.46 in chips)
Seat 4: 9166e4c6 ($5.07 in chips)
Seat 5: Hero ($6.18 in chips)
Seat 6: b06c4eff ($5.64 in chips)
370bf11f: posts small blind $0.02
db3f59ad: posts big blind $0.05
*** HOLE CARDS ***
Dealt to 49fcfa7d 
Dealt to 370bf11f 
Dealt to db3f59ad 
Dealt to 9166e4c6 
Dealt to Hero [Qs 8d]
Dealt to b06c4eff 
9166e4c6: folds
Hero: folds
b06c4eff: folds
49fcfa7d: folds
370bf11f: folds
Uncalled bet ($0.03) returned to db3f59ad
*** SHOWDOWN ***
db3f59ad collected $0.04 from pot
*** SUMMARY ***
Total pot $0.04 | Rake $0 | Jackpot $0 | Bingo $0 | Fortune $0 | Tax $0
Seat 1: 49fcfa7d (button) folded before Flop (didn't bet)
Seat 2: 370bf11f (small blind) folded before Flop
Seat 3: db3f59ad (big blind) collected ($0.04)
Seat 4: 9166e4c6 folded before Flop (didn't bet)
Seat 5: Hero folded before Flop (didn't bet)
Seat 6: b06c4eff folded before Flop (didn't bet)


Poker Hand #RC3812543128: Hold'em No Limit ($0.02/$0.05) - 2025/08/17 00:10:57
Table 'RushAndCash1098388' 6-max Seat #1 is the button
Seat 1: 8cfdd388 ($5.32 in chips)
Seat 2: 5c8e0ee9 ($30.97 in chips)
Seat 3: a4b7c741 ($6.77 in chips)
Seat 4: a3ad240e ($17.2 in chips)
Seat 5: c48bc6c2 ($8.72 in chips)
Seat 6: Hero ($6.18 in chips)
5c8e0ee9: posts small blind $0.02
a4b7c741: posts big blind $0.05
*** HOLE CARDS ***
Dealt to 8cfdd388 
Dealt to 5c8e0ee9 
Dealt to a4b7c741 
Dealt to a3ad240e 
Dealt to c48bc6c2 
Dealt to Hero [Qc 5c]
a3ad240e: folds
c48bc6c2: folds
Hero: folds
8cfdd388: folds
5c8e0ee9: raises $0.07 to $0.12
a4b7c741: folds
Uncalled bet ($0.07) returned to 5c8e0ee9
*** SHOWDOWN ***
5c8e0ee9 collected $0.1 from pot
*** SUMMARY ***
Total pot $0.1 | Rake $0 | Jackpot $0 | Bingo $0 | Fortune $0 | Tax $0
Seat 1: 8cfdd388 (button) folded before Flop (didn't bet)
Seat 2: 5c8e0ee9 (small blind) collected ($0.1)
Seat 3: a4b7c741 (big blind) folded before Flop
Seat 4: a3ad240e folded before Flop (didn't bet)
Seat 5: c48bc6c2 folded before Flop (didn't bet)
Seat 6: Hero folded before Flop (didn't bet)


Poker Hand #RC3812542973: Hold'em No Limit ($0.02/$0.05) - 2025/08/17 00:10:34
Table 'RushAndCash1098233' 6-max Seat #1 is the button
Seat 1: 746aae0a ($5.85 in chips)
Seat 2: Hero ($6.2 in chips)
Seat 3: d3d9e1af ($8.46 in chips)
Seat 4: d140874d ($15.53 in chips)
Seat 5: 3dc9b1ad ($13.01 in chips)
Seat 6: d38af7cf ($6.09 in chips)
Hero: posts small blind $0.02
d3d9e1af: posts big blind $0.05
*** HOLE CARDS ***
Dealt to 746aae0a 
Dealt to Hero [Qh 9c]
Dealt to d3d9e1af 
Dealt to d140874d 
Dealt to 3dc9b1ad 
Dealt to d38af7cf 
d140874d: folds
3dc9b1ad: folds
d38af7cf: raises $0.05 to $0.1
746aae0a: folds
Hero: folds
d3d9e1af: calls $0.05
*** FLOP *** [3h Jh 9h]
d3d9e1af: checks
d38af7cf: bets $0.11
d3d9e1af: folds
Uncalled bet ($0.11) returned to d38af7cf
*** SHOWDOWN ***
d38af7cf collected $0.21 from pot
*** SUMMARY ***
Total pot $0.22 | Rake $0.01 | Jackpot $0 | Bingo $0 | Fortune $0 | Tax $0
Board [3h Jh 9h]
Seat 1: 746aae0a (button) folded before Flop (didn't bet)
Seat 2: Hero (small blind) folded before Flop
Seat 3: d3d9e1af (big blind) folded on the Flop
Seat 4: d140874d folded before Flop (didn't bet)
Seat 5: 3dc9b1ad folded before Flop (didn't bet)
Seat 6: d38af7cf won ($0.21)


Poker Hand #RC3812542907: Hold'em No Limit ($0.02/$0.05) - 2025/08/17 00:10:25
Table 'RushAndCash1098167' 6-max Seat #1 is the button
Seat 1: b6c3e0d1 ($4.55 in chips)
Seat 2: 3101bb8a ($5.35 in chips)
Seat 3: Hero ($6.18 in chips)
Seat 4: 32c3183b ($5.24 in chips)
Seat 5: 1a6a9f96 ($6.47 in chips)
Seat 6: 33fafa6a ($5 in chips)
3101bb8a: posts small blind $0.02
Hero: posts big blind $0.05
*** HOLE CARDS ***
Dealt to b6c3e0d1 
Dealt to 3101bb8a 
Dealt to Hero [Td 9s]
Dealt to 32c3183b 
Dealt to 1a6a9f96 
Dealt to 33fafa6a 
32c3183b: folds
1a6a9f96: folds
33fafa6a: folds
b6c3e0d1: folds
3101bb8a: folds
Uncalled bet ($0.03) returned to Hero
*** SHOWDOWN ***
Hero collected $0.04 from pot
*** SUMMARY ***
Total pot $0.04 | Rake $0 | Jackpot $0 | Bingo $0 | Fortune $0 | Tax $0
Seat 1: b6c3e0d1 (button) folded before Flop (didn't bet)
Seat 2: 3101bb8a (small blind) folded before Flop
Seat 3: Hero (big blind) collected ($0.04)
Seat 4: 32c3183b folded before Flop (didn't bet)
Seat 5: 1a6a9f96 folded before Flop (didn't bet)
Seat 6: 33fafa6a folded before Flop (didn't bet)


Poker Hand #RC3812542731: Hold'em No Limit ($0.02/$0.05) - 2025/08/17 00:10:01
Table 'RushAndCash1097991' 6-max Seat #1 is the button
Seat 1: Hero ($6.02 in chips)
Seat 2: b9846e09 ($4.58 in chips)
Seat 3: e497ef0d ($6.63 in chips)
Seat 4: 32c3183b ($5.34 in chips)
Seat 5: 57835ed1 ($5 in chips)
Seat 6: 8ac9b24c ($8.7 in chips)
b9846e09: posts small blind $0.02
e497ef0d: posts big blind $0.05
*** HOLE CARDS ***
Dealt to Hero [Kc Kd]
Dealt to b9846e09 
Dealt to e497ef0d 
Dealt to 32c3183b 
Dealt to 57835ed1 
Dealt to 8ac9b24c 
32c3183b: raises $0.05 to $0.1
57835ed1: folds
8ac9b24c: folds
Hero: raises $0.26 to $0.36
b9846e09: folds
e497ef0d: folds
32c3183b: folds
Uncalled bet ($0.26) returned to Hero
*** SHOWDOWN ***
Hero collected $0.26 from pot
*** SUMMARY ***
Total pot $0.27 | Rake $0.01 | Jackpot $0 | Bingo $0 | Fortune $0 | Tax $0
Seat 1: Hero (button) collected ($0.26)
Seat 2: b9846e09 (small blind) folded before Flop
Seat 3: e497ef0d (big blind) folded before Flop
Seat 4: 32c3183b folded before Flop
Seat 5: 57835ed1 folded before Flop (didn't bet)
Seat 6: 8ac9b24c folded before Flop (didn't bet)


Poker Hand #RC3812542705: Hold'em No Limit ($0.02/$0.05) - 2025/08/17 00:09:57
Table 'RushAndCash1097965' 6-max Seat #1 is the button
Seat 1: fbfae31e ($5 in chips)
Seat 2: b2d82934 ($5.34 in chips)
Seat 3: b76cb406 ($20.11 in chips)
Seat 4: c7d2aa99 ($10.2 in chips)
Seat 5: Hero ($6.02 in chips)
Seat 6: 525afd03 ($5 in chips)
b2d82934: posts small blind $0.02
b76cb406: posts big blind $0.05
*** HOLE CARDS ***
Dealt to fbfae31e 
Dealt to b2d82934 
Dealt to b76cb406 
Dealt to c7d2aa99 
Dealt to Hero [Kh 7c]
Dealt to 525afd03 
c7d2aa99: folds
Hero: folds
525afd03: raises $0.06 to $0.11
fbfae31e: folds
b2d82934: folds
b76cb406: calls $0.06
*** FLOP *** [Jh 2h Ah]
b76cb406: bets $0.18
525afd03: folds
Uncalled bet ($0.18) returned to b76cb406
*** SHOWDOWN ***
b76cb406 collected $0.23 from pot
*** SUMMARY ***
Total pot $0.24 | Rake $0.01 | Jackpot $0 | Bingo $0 | Fortune $0 | Tax $0
Board [Jh 2h Ah]
Seat 1: fbfae31e (button) folded before Flop (didn't bet)
Seat 2: b2d82934 (small blind) folded before Flop
Seat 3: b76cb406 (big blind) won ($0.23)
Seat 4: c7d2aa99 folded before Flop (didn't bet)
Seat 5: Hero folded before Flop (didn't bet)
Seat 6: 525afd03 folded on the Flop


Poker Hand #RC3812542106: Hold'em No Limit ($0.02/$0.05) - 2025/08/17 00:08:27
Table 'RushAndCash1097366' 6-max Seat #1 is the button
Seat 1: efd7987b ($5.87 in chips)
Seat 2: 3470865e ($1.9 in chips)
Seat 3: 7c5cd480 ($5.02 in chips)
Seat 4: Hero ($4.64 in chips)
Seat 5: 6ec47996 ($8.45 in chips)
Seat 6: b76cb406 ($20.21 in chips)
3470865e: posts small blind $0.02
7c5cd480: posts big blind $0.05
*** HOLE CARDS ***
Dealt to efd7987b 
Dealt to 3470865e 
Dealt to 7c5cd480 
Dealt to Hero [Kc Ks]
Dealt to 6ec47996 
Dealt to b76cb406 
Hero: raises $0.05 to $0.1
6ec47996: folds
b76cb406: calls $0.1
efd7987b: raises $0.56 to $0.66
3470865e: folds
7c5cd480: folds
Hero: calls $0.56
b76cb406: folds
*** FLOP *** [9c 5h 9h]
Hero: checks
efd7987b: checks
*** TURN *** [9c 5h 9h] [7d]
Hero: bets $0.76
efd7987b: calls $0.76
*** RIVER *** [9c 5h 9h 7d] [5s]
Hero: bets $3.22 and is all-in
efd7987b: folds
Uncalled bet ($3.22) returned to Hero
*** SHOWDOWN ***
Hero collected $2.8 from pot
*** SUMMARY ***
Total pot $3.01 | Rake $0.14 | Jackpot $0.07 | Bingo $0 | Fortune $0 | Tax $0
Board [9c 5h 9h 7d 5s]
Seat 1: efd7987b (button) folded on the River
Seat 2: 3470865e (small blind) folded before Flop
Seat 3: 7c5cd480 (big blind) folded before Flop
Seat 4: Hero won ($2.8)
Seat 5: 6ec47996 folded before Flop (didn't bet)
Seat 6: b76cb406 folded before Flop


Poker Hand #RC3812541958: Hold'em No Limit ($0.02/$0.05) - 2025/08/17 00:08:06
Table 'RushAndCash1097218' 6-max Seat #1 is the button
Seat 1: eee72bde ($3.49 in chips)
Seat 2: Hero ($4.66 in chips)
Seat 3: 746aae0a ($5.71 in chips)
Seat 4: 5b5c342c ($6.25 in chips)
Seat 5: d140874d ($10.71 in chips)
Seat 6: 940fc210 ($5.61 in chips)
Hero: posts small blind $0.02
746aae0a: posts big blind $0.05
*** HOLE CARDS ***
Dealt to eee72bde 
Dealt to Hero [8s Qs]
Dealt to 746aae0a 
Dealt to 5b5c342c 
Dealt to d140874d 
Dealt to 940fc210 
5b5c342c: folds
d140874d: folds
940fc210: folds
eee72bde: raises $0.05 to $0.1
Hero: folds
746aae0a: folds
Uncalled bet ($0.05) returned to eee72bde
*** SHOWDOWN ***
eee72bde collected $0.12 from pot
*** SUMMARY ***
Total pot $0.12 | Rake $0 | Jackpot $0 | Bingo $0 | Fortune $0 | Tax $0
Seat 1: eee72bde (button) collected ($0.12)
Seat 2: Hero (small blind) folded before Flop
Seat 3: 746aae0a (big blind) folded before Flop
Seat 4: 5b5c342c folded before Flop (didn't bet)
Seat 5: d140874d folded before Flop (didn't bet)
Seat 6: 940fc210 folded before Flop (didn't bet)


Poker Hand #RC3812541873: Hold'em No Limit ($0.02/$0.05) - 2025/08/17 00:07:53
Table 'RushAndCash1097133' 6-max Seat #1 is the button
Seat 1: Hero ($4.66 in chips)
Seat 2: d721bb2e ($11.02 in chips)
Seat 3: 8c0270a7 ($5.73 in chips)
Seat 4: 59e853e7 ($8.93 in chips)
Seat 5: afde2e4 ($6.32 in chips)
Seat 6: 19ee4bf8 ($5.65 in chips)
d721bb2e: posts small blind $0.02
8c0270a7: posts big blind $0.05
*** HOLE CARDS ***
Dealt to Hero [6h Td]
Dealt to d721bb2e 
Dealt to 8c0270a7 
Dealt to 59e853e7 
Dealt to afde2e4 
Dealt to 19ee4bf8 
59e853e7: raises $0.05 to $0.1
afde2e4: folds
19ee4bf8: folds
Hero: folds
d721bb2e: folds
8c0270a7: folds
Uncalled bet ($0.05) returned to 59e853e7
*** SHOWDOWN ***
59e853e7 collected $0.12 from pot
*** SUMMARY ***
Total pot $0.12 | Rake $0 | Jackpot $0 | Bingo $0 | Fortune $0 | Tax $0
Seat 1: Hero (button) folded before Flop (didn't bet)
Seat 2: d721bb2e (small blind) folded before Flop
Seat 3: 8c0270a7 (big blind) folded before Flop
Seat 4: 59e853e7 collected ($0.12)
Seat 5: afde2e4 folded before Flop (didn't bet)
Seat 6: 19ee4bf8 folded before Flop (didn't bet)


Poker Hand #RC3812541763: Hold'em No Limit ($0.02/$0.05) - 2025/08/17 00:07:39
Table 'RushAndCash1097023' 6-max Seat #1 is the button
Seat 1: 58cd81fd ($5.44 in chips)
Seat 2: b5be416 ($4.95 in chips)
Seat 3: Hero ($4.71 in chips)
Seat 4: a4c0e017 ($15.53 in chips)
Seat 5: d8dfe106 ($4.17 in chips)
Seat 6: f2b30c1a ($5 in chips)
b5be416: posts small blind $0.02
Hero: posts big blind $0.05
*** HOLE CARDS ***
Dealt to 58cd81fd 
Dealt to b5be416 
Dealt to Hero [6s Jc]
Dealt to a4c0e017 
Dealt to d8dfe106 
Dealt to f2b30c1a 
a4c0e017: raises $0.05 to $0.1
d8dfe106: folds
f2b30c1a: folds
58cd81fd: folds
b5be416: folds
Hero: folds
Uncalled bet ($0.05) returned to a4c0e017
*** SHOWDOWN ***
a4c0e017 collected $0.12 from pot
*** SUMMARY ***
Total pot $0.12 | Rake $0 | Jackpot $0 | Bingo $0 | Fortune $0 | Tax $0
Seat 1: 58cd81fd (button) folded before Flop (didn't bet)
Seat 2: b5be416 (small blind) folded before Flop
Seat 3: Hero (big blind) folded before Flop
Seat 4: a4c0e017 collected ($0.12)
Seat 5: d8dfe106 folded before Flop (didn't bet)
Seat 6: f2b30c1a folded before Flop (didn't bet)


Poker Hand #RC3812541734: Hold'em No Limit ($0.02/$0.05) - 2025/08/17 00:07:35
Table 'RushAndCash1096994' 6-max Seat #1 is the button
Seat 1: acc3e15d ($1.67 in chips)
Seat 2: 1a6a9f96 ($6.5 in chips)
Seat 3: 1240d557 ($5.3 in chips)
Seat 4: a4c0e017 ($15.53 in chips)
Seat 5: Hero ($4.71 in chips)
Seat 6: d9dc034f ($5.49 in chips)
1a6a9f96: posts small blind $0.02
1240d557: posts big blind $0.05
*** HOLE CARDS ***
Dealt to acc3e15d 
Dealt to 1a6a9f96 
Dealt to 1240d557 
Dealt to a4c0e017 
Dealt to Hero [3d 2h]
Dealt to d9dc034f 
a4c0e017: folds
Hero: folds
d9dc034f: raises $0.05 to $0.1
acc3e15d: folds
1a6a9f96: folds
1240d557: folds
Uncalled bet ($0.05) returned to d9dc034f
*** SHOWDOWN ***
d9dc034f collected $0.12 from pot
*** SUMMARY ***
Total pot $0.12 | Rake $0 | Jackpot $0 | Bingo $0 | Fortune $0 | Tax $0
Seat 1: acc3e15d (button) folded before Flop (didn't bet)
Seat 2: 1a6a9f96 (small blind) folded before Flop
Seat 3: 1240d557 (big blind) folded before Flop
Seat 4: a4c0e017 folded before Flop (didn't bet)
Seat 5: Hero folded before Flop (didn't bet)
Seat 6: d9dc034f collected ($0.12)


Poker Hand #RC3812541697: Hold'em No Limit ($0.02/$0.05) - 2025/08/17 00:07:30
Table 'RushAndCash1096957' 6-max Seat #1 is the button
Seat 1: c46c7d3e ($13.88 in chips)
Seat 2: aa0823b6 ($5.18 in chips)
Seat 3: 7141d44a ($5 in chips)
Seat 4: 45cd7959 ($8.75 in chips)
Seat 5: 6c196a1f ($35.03 in chips)
Seat 6: Hero ($4.71 in chips)
aa0823b6: posts small blind $0.02
7141d44a: posts big blind $0.05
*** HOLE CARDS ***
Dealt to c46c7d3e 
Dealt to aa0823b6 
Dealt to 7141d44a 
Dealt to 45cd7959 
Dealt to 6c196a1f 
Dealt to Hero [6s 3s]
45cd7959: folds
6c196a1f: folds
Hero: folds
c46c7d3e: folds
aa0823b6: folds
Uncalled bet ($0.03) returned to 7141d44a
*** SHOWDOWN ***
7141d44a collected $0.04 from pot
*** SUMMARY ***
Total pot $0.04 | Rake $0 | Jackpot $0 | Bingo $0 | Fortune $0 | Tax $0
Seat 1: c46c7d3e (button) folded before Flop (didn't bet)
Seat 2: aa0823b6 (small blind) folded before Flop
Seat 3: 7141d44a (big blind) collected ($0.04)
Seat 4: 45cd7959 folded before Flop (didn't bet)
Seat 5: 6c196a1f folded before Flop (didn't bet)
Seat 6: Hero folded before Flop (didn't bet)


Poker Hand #RC3812541538: Hold'em No Limit ($0.02/$0.05) - 2025/08/17 00:07:06
Table 'RushAndCash1096798' 6-max Seat #1 is the button
Seat 1: 28a77572 ($3.25 in chips)
Seat 2: d6a18d8f ($5.89 in chips)
Seat 3: Hero ($4.76 in chips)
Seat 4: 598c3f22 ($7.51 in chips)
Seat 5: c2818c57 ($4.96 in chips)
Seat 6: 33236916 ($17.45 in chips)
d6a18d8f: posts small blind $0.02
Hero: posts big blind $0.05
*** HOLE CARDS ***
Dealt to 28a77572 
Dealt to d6a18d8f 
Dealt to Hero [Js 7d]
Dealt to 598c3f22 
Dealt to c2818c57 
Dealt to 33236916 
598c3f22: folds
c2818c57: folds
33236916: folds
28a77572: raises $0.05 to $0.1
d6a18d8f: folds
Hero: folds
Uncalled bet ($0.05) returned to 28a77572
*** SHOWDOWN ***
28a77572 collected $0.12 from pot
*** SUMMARY ***
Total pot $0.12 | Rake $0 | Jackpot $0 | Bingo $0 | Fortune $0 | Tax $0
Seat 1: 28a77572 (button) collected ($0.12)
Seat 2: d6a18d8f (small blind) folded before Flop
Seat 3: Hero (big blind) folded before Flop
Seat 4: 598c3f22 folded before Flop (didn't bet)
Seat 5: c2818c57 folded before Flop (didn't bet)
Seat 6: 33236916 folded before Flop (didn't bet)


Poker Hand #RC3812541462: Hold'em No Limit ($0.02/$0.05) - 2025/08/17 00:06:56
Table 'RushAndCash1096722' 6-max Seat #1 is the button
Seat 1: 9ced515b ($2.23 in chips)
Seat 2: 6c196a1f ($34.96 in chips)
Seat 3: 57b00f3d ($15.23 in chips)
Seat 4: db9abd16 ($5.07 in chips)
Seat 5: 1d487da4 ($5.45 in chips)
Seat 6: Hero ($4.76 in chips)
6c196a1f: posts small blind $0.02
57b00f3d: posts big blind $0.05
*** HOLE CARDS ***
Dealt to 9ced515b 
Dealt to 6c196a1f 
Dealt to 57b00f3d 
Dealt to db9abd16 
Dealt to 1d487da4 
Dealt to Hero [Td Ah]
db9abd16: folds
1d487da4: raises $0.07 to $0.12
Hero: folds
9ced515b: raises $0.47 to $0.59
6c196a1f: folds
57b00f3d: folds
1d487da4: folds
Uncalled bet ($0.47) returned to 9ced515b
*** SHOWDOWN ***
9ced515b collected $0.3 from pot
*** SUMMARY ***
Total pot $0.31 | Rake $0.01 | Jackpot $0 | Bingo $0 | Fortune $0 | Tax $0
Seat 1: 9ced515b (button) collected ($0.3)
Seat 2: 6c196a1f (small blind) folded before Flop
Seat 3: 57b00f3d (big blind) folded before Flop
Seat 4: db9abd16 folded before Flop (didn't bet)
Seat 5: 1d487da4 folded before Flop
Seat 6: Hero folded before Flop (didn't bet)


Poker Hand #RC3812541437: Hold'em No Limit ($0.02/$0.05) - 2025/08/17 00:06:52
Table 'RushAndCash1096697' 6-max Seat #1 is the button
Seat 1: aa0823b6 ($5 in chips)
Seat 2: 90a48ef1 ($7.38 in chips)
Seat 3: 817b1ca8 ($3.87 in chips)
Seat 4: 476c7cfc ($12.63 in chips)
Seat 5: Hero ($4.76 in chips)
Seat 6: d26eadab ($5.7 in chips)
90a48ef1: posts small blind $0.02
817b1ca8: posts big blind $0.05
*** HOLE CARDS ***
Dealt to aa0823b6 
Dealt to 90a48ef1 
Dealt to 817b1ca8 
Dealt to 476c7cfc 
Dealt to Hero [2s Jh]
Dealt to d26eadab 
476c7cfc: folds
Hero: folds
d26eadab: folds
aa0823b6: folds
90a48ef1: calls $0.03
817b1ca8: checks
*** FLOP *** [Jd 4c 5c]
90a48ef1: checks
817b1ca8: checks
*** TURN *** [Jd 4c 5c] [5s]
90a48ef1: checks
817b1ca8: checks
*** RIVER *** [Jd 4c 5c 5s] [4d]
90a48ef1: bets $0.08
817b1ca8: folds
Uncalled bet ($0.08) returned to 90a48ef1
*** SHOWDOWN ***
90a48ef1 collected $0.1 from pot
*** SUMMARY ***
Total pot $0.1 | Rake $0 | Jackpot $0 | Bingo $0 | Fortune $0 | Tax $0
Board [Jd 4c 5c 5s 4d]
Seat 1: aa0823b6 (button) folded before Flop (didn't bet)
Seat 2: 90a48ef1 (small blind) won ($0.1)
Seat 3: 817b1ca8 (big blind) folded on the River
Seat 4: 476c7cfc folded before Flop (didn't bet)
Seat 5: Hero folded before Flop (didn't bet)
Seat 6: d26eadab folded before Flop (didn't bet)


Poker Hand #RC3812541403: Hold'em No Limit ($0.02/$0.05) - 2025/08/17 00:06:48
Table 'RushAndCash1096663' 6-max Seat #1 is the button
Seat 1: 67015b98 ($14.39 in chips)
Seat 2: d140874d ($10.96 in chips)
Seat 3: d65a05e9 ($7.01 in chips)
Seat 4: ff883c83 ($5.07 in chips)
Seat 5: Hero ($4.76 in chips)
Seat 6: 36d1802a ($4.75 in chips)
d140874d: posts small blind $0.02
d65a05e9: posts big blind $0.05
*** HOLE CARDS ***
Dealt to 67015b98 
Dealt to d140874d 
Dealt to d65a05e9 
Dealt to ff883c83 
Dealt to Hero [9d 6d]
Dealt to 36d1802a 
ff883c83: folds
Hero: folds
36d1802a: folds
67015b98: folds
d140874d: raises $0.06 to $0.11
d65a05e9: folds
Uncalled bet ($0.06) returned to d140874d
*** SHOWDOWN ***
d140874d collected $0.1 from pot
*** SUMMARY ***
Total pot $0.1 | Rake $0 | Jackpot $0 | Bingo $0 | Fortune $0 | Tax $0
Seat 1: 67015b98 (button) folded before Flop (didn't bet)
Seat 2: d140874d (small blind) collected ($0.1)
Seat 3: d65a05e9 (big blind) folded before Flop
Seat 4: ff883c83 folded before Flop (didn't bet)
Seat 5: Hero folded before Flop (didn't bet)
Seat 6: 36d1802a folded before Flop (didn't bet)


Poker Hand #RC3812541290: Hold'em No Limit ($0.02/$0.05) - 2025/08/17 00:06:31
Table 'RushAndCash1096550' 6-max Seat #1 is the button
Seat 1: Hero ($4.76 in chips)
Seat 2: 2a621fc3 ($6.72 in chips)
Seat 3: 5c230b2 ($2.49 in chips)
Seat 4: efd7987b ($5.41 in chips)
Seat 5: ea0e3ba9 ($5.33 in chips)
Seat 6: 29017380 ($5.46 in chips)
2a621fc3: posts small blind $0.02
5c230b2: posts big blind $0.05
*** HOLE CARDS ***
Dealt to Hero [4s Jc]
Dealt to 2a621fc3 
Dealt to 5c230b2 
Dealt to efd7987b 
Dealt to ea0e3ba9 
Dealt to 29017380 
efd7987b: raises $0.05 to $0.1
ea0e3ba9: folds
29017380: folds
Hero: folds
2a621fc3: folds
5c230b2: folds
Uncalled bet ($0.05) returned to efd7987b
*** SHOWDOWN ***
efd7987b collected $0.12 from pot
*** SUMMARY ***
Total pot $0.12 | Rake $0 | Jackpot $0 | Bingo $0 | Fortune $0 | Tax $0
Seat 1: Hero (button) folded before Flop (didn't bet)
Seat 2: 2a621fc3 (small blind) folded before Flop
Seat 3: 5c230b2 (big blind) folded before Flop
Seat 4: efd7987b collected ($0.12)
Seat 5: ea0e3ba9 folded before Flop (didn't bet)
Seat 6: 29017380 folded before Flop (didn't bet)


Poker Hand #RC3812540809: Hold'em No Limit ($0.02/$0.05) - 2025/08/17 00:05:21
Table 'RushAndCash1096069' 6-max Seat #1 is the button
Seat 1: c7d2aa99 ($9.55 in chips)
Seat 2: Hero ($4.87 in chips)
Seat 3: ea0e3ba9 ($5.44 in chips)
Seat 4: b5c4e057 ($6.48 in chips)
Seat 5: f3333abb ($5.11 in chips)
Seat 6: 5c230b2 ($2.18 in chips)
Hero: posts small blind $0.02
ea0e3ba9: posts big blind $0.05
*** HOLE CARDS ***
Dealt to c7d2aa99 
Dealt to Hero [Ts 8s]
Dealt to ea0e3ba9 
Dealt to b5c4e057 
Dealt to f3333abb 
Dealt to 5c230b2 
b5c4e057: raises $0.06 to $0.11
f3333abb: folds
5c230b2: calls $0.11
c7d2aa99: folds
Hero: calls $0.09
ea0e3ba9: calls $0.06
*** FLOP *** [Jc Jd Qc]
Hero: checks
ea0e3ba9: checks
b5c4e057: checks
5c230b2: checks
*** TURN *** [Jc Jd Qc] [Kh]
Hero: checks
ea0e3ba9: checks
b5c4e057: checks
5c230b2: checks
*** RIVER *** [Jc Jd Qc Kh] [2c]
Hero: checks
ea0e3ba9: checks
b5c4e057: checks
5c230b2: checks
Hero: shows [Ts 8s] (a pair of Jacks)
ea0e3ba9: shows [8d 8h] (two pair, Jacks and Eights)
b5c4e057: shows [3c 3s] (two pair, Jacks and Threes)
5c230b2: shows [9c 9d] (two pair, Jacks and Nines)
*** SHOWDOWN ***
5c230b2 collected $0.42 from pot
*** SUMMARY ***
Total pot $0.44 | Rake $0.02 | Jackpot $0 | Bingo $0 | Fortune $0 | Tax $0
Board [Jc Jd Qc Kh 2c]
Seat 1: c7d2aa99 (button) folded before Flop (didn't bet)
Seat 2: Hero (small blind) showed [Ts 8s] and lost with a pair of Jacks
Seat 3: ea0e3ba9 (big blind) showed [8d 8h] and lost with two pair, Jacks and Eights
Seat 4: b5c4e057 showed [3c 3s] and lost with two pair, Jacks and Threes
Seat 5: f3333abb folded before Flop (didn't bet)
Seat 6: 5c230b2 showed [9c 9d] and won ($0.42) with two pair, Jacks and Nines


Poker Hand #RC3812540785: Hold'em No Limit ($0.02/$0.05) - 2025/08/17 00:05:17
Table 'RushAndCash1096045' 6-max Seat #1 is the button
Seat 1: f7cd282c ($10.01 in chips)
Seat 2: 281a8acb ($3.48 in chips)
Seat 3: 36d9e9c ($9.86 in chips)
Seat 4: Hero ($4.87 in chips)
Seat 5: 206a879e ($5.32 in chips)
Seat 6: 5f5bcd82 ($7.33 in chips)
281a8acb: posts small blind $0.02
36d9e9c: posts big blind $0.05
*** HOLE CARDS ***
Dealt to f7cd282c 
Dealt to 281a8acb 
Dealt to 36d9e9c 
Dealt to Hero [4d 2d]
Dealt to 206a879e 
Dealt to 5f5bcd82 
Hero: folds
206a879e: folds
5f5bcd82: folds
f7cd282c: raises $0.07 to $0.12
281a8acb: calls $0.1
36d9e9c: calls $0.07
*** FLOP *** [8d 9s Ac]
281a8acb: checks
36d9e9c: checks
f7cd282c: checks
*** TURN *** [8d 9s Ac] [5c]
281a8acb: checks
36d9e9c: bets $0.1
f7cd282c: raises $0.28 to $0.38
281a8acb: folds
36d9e9c: folds
Uncalled bet ($0.28) returned to f7cd282c
*** SHOWDOWN ***
f7cd282c collected $0.54 from pot
*** SUMMARY ***
Total pot $0.56 | Rake $0.02 | Jackpot $0 | Bingo $0 | Fortune $0 | Tax $0
Board [8d 9s Ac 5c]
Seat 1: f7cd282c (button) won ($0.54)
Seat 2: 281a8acb (small blind) folded on the Turn
Seat 3: 36d9e9c (big blind) folded on the Turn
Seat 4: Hero folded before Flop (didn't bet)
Seat 5: 206a879e folded before Flop (didn't bet)
Seat 6: 5f5bcd82 folded before Flop (didn't bet)


Poker Hand #RC3812540760: Hold'em No Limit ($0.02/$0.05) - 2025/08/17 00:05:14
Table 'RushAndCash1096020' 6-max Seat #1 is the button
Seat 1: 778a16a1 ($7.96 in chips)
Seat 2: 3fc228ba ($5 in chips)
Seat 3: f7cd282c ($10.06 in chips)
Seat 4: Hero ($4.87 in chips)
Seat 5: fc2ad8be ($10.02 in chips)
Seat 6: f371662d ($4.58 in chips)
3fc228ba: posts small blind $0.02
f7cd282c: posts big blind $0.05
*** HOLE CARDS ***
Dealt to 778a16a1 
Dealt to 3fc228ba 
Dealt to f7cd282c 
Dealt to Hero [8c 5s]
Dealt to fc2ad8be 
Dealt to f371662d 
Hero: folds
fc2ad8be: folds
f371662d: folds
778a16a1: folds
3fc228ba: raises $0.1 to $0.15
f7cd282c: folds
Uncalled bet ($0.1) returned to 3fc228ba
*** SHOWDOWN ***
3fc228ba collected $0.1 from pot
*** SUMMARY ***
Total pot $0.1 | Rake $0 | Jackpot $0 | Bingo $0 | Fortune $0 | Tax $0
Seat 1: 778a16a1 (button) folded before Flop (didn't bet)
Seat 2: 3fc228ba (small blind) collected ($0.1)
Seat 3: f7cd282c (big blind) folded before Flop
Seat 4: Hero folded before Flop (didn't bet)
Seat 5: fc2ad8be folded before Flop (didn't bet)
Seat 6: f371662d folded before Flop (didn't bet)


Poker Hand #RC3812540194: Hold'em No Limit ($0.02/$0.05) - 2025/08/17 00:03:53
Table 'RushAndCash1095454' 6-max Seat #1 is the button
Seat 1: a54fad6e ($6.78 in chips)
Seat 2: Hero ($5.2 in chips)
Seat 3: e98aefc7 ($2.83 in chips)
Seat 4: 778a16a1 ($7.3 in chips)
Seat 5: 198a273d ($5.47 in chips)
Seat 6: b5b5ed2d ($2.5 in chips)
Hero: posts small blind $0.02
e98aefc7: posts big blind $0.05
*** HOLE CARDS ***
Dealt to a54fad6e 
Dealt to Hero [9c 7c]
Dealt to e98aefc7 
Dealt to 778a16a1 
Dealt to 198a273d 
Dealt to b5b5ed2d 
778a16a1: raises $0.06 to $0.11
198a273d: raises $0.22 to $0.33
b5b5ed2d: folds
a54fad6e: folds
Hero: calls $0.31
e98aefc7: folds
778a16a1: calls $0.22
*** FLOP *** [3d As 7s]
Hero: checks
778a16a1: checks
198a273d: checks
*** TURN *** [3d As 7s] [5c]
Hero: checks
778a16a1: bets $0.78
198a273d: folds
Hero: folds
Uncalled bet ($0.78) returned to 778a16a1
*** SHOWDOWN ***
778a16a1 collected $0.99 from pot
*** SUMMARY ***
Total pot $1.04 | Rake $0.05 | Jackpot $0 | Bingo $0 | Fortune $0 | Tax $0
Board [3d As 7s 5c]
Seat 1: a54fad6e (button) folded before Flop (didn't bet)
Seat 2: Hero (small blind) folded on the Turn
Seat 3: e98aefc7 (big blind) folded before Flop
Seat 4: 778a16a1 won ($0.99)
Seat 5: 198a273d folded on the Turn
Seat 6: b5b5ed2d folded before Flop (didn't bet)


Poker Hand #RC3812540029: Hold'em No Limit ($0.02/$0.05) - 2025/08/17 00:03:29
Table 'RushAndCash1095289' 6-max Seat #1 is the button
Seat 1: Hero ($5.2 in chips)
Seat 2: d6a18d8f ($6.69 in chips)
Seat 3: 82170b33 ($7.79 in chips)
Seat 4: 43f46220 ($4.63 in chips)
Seat 5: 72a16ce1 ($4.8 in chips)
Seat 6: 198a273d ($5.49 in chips)
d6a18d8f: posts small blind $0.02
82170b33: posts big blind $0.05
*** HOLE CARDS ***
Dealt to Hero [2d Jd]
Dealt to d6a18d8f 
Dealt to 82170b33 
Dealt to 43f46220 
Dealt to 72a16ce1 
Dealt to 198a273d 
43f46220: raises $0.05 to $0.1
72a16ce1: folds
198a273d: folds
Hero: folds
d6a18d8f: folds
82170b33: folds
Uncalled bet ($0.05) returned to 43f46220
*** SHOWDOWN ***
43f46220 collected $0.12 from pot
*** SUMMARY ***
Total pot $0.12 | Rake $0 | Jackpot $0 | Bingo $0 | Fortune $0 | Tax $0
Seat 1: Hero (button) folded before Flop (didn't bet)
Seat 2: d6a18d8f (small blind) folded before Flop
Seat 3: 82170b33 (big blind) folded before Flop
Seat 4: 43f46220 collected ($0.12)
Seat 5: 72a16ce1 folded before Flop (didn't bet)
Seat 6: 198a273d folded before Flop (didn't bet)


Poker Hand #RC3812540004: Hold'em No Limit ($0.02/$0.05) - 2025/08/17 00:03:25
Table 'RushAndCash1095264' 6-max Seat #1 is the button
Seat 1: a296c73a ($7.55 in chips)
Seat 2: 746aae0a ($5.81 in chips)
Seat 3: 82a1a41b ($2.42 in chips)
Seat 4: d6a18d8f ($6.69 in chips)
Seat 5: e4d5b39b ($7.26 in chips)
Seat 6: Hero ($5.2 in chips)
746aae0a: posts small blind $0.02
82a1a41b: posts big blind $0.05
*** HOLE CARDS ***
Dealt to a296c73a 
Dealt to 746aae0a 
Dealt to 82a1a41b 
Dealt to d6a18d8f 
Dealt to e4d5b39b 
Dealt to Hero [4h 4c]
d6a18d8f: folds
e4d5b39b: raises $0.07 to $0.12
Hero: folds
a296c73a: calls $0.12
746aae0a: folds
82a1a41b: calls $0.07
*** FLOP *** [Qs 6d 7d]
82a1a41b: checks
e4d5b39b: bets $0.19
a296c73a: calls $0.19
82a1a41b: raises $0.26 to $0.45
e4d5b39b: folds
a296c73a: calls $0.26
*** TURN *** [Qs 6d 7d] [Tc]
82a1a41b: bets $1.85 and is all-in
a296c73a: calls $1.85
82a1a41b: shows [9d 8s] (a straight, Ten to Six)
a296c73a: shows [7c 9c] (a pair of Sevens)
82a1a41b: Chooses to EV Cashout
*** RIVER *** [Qs 6d 7d Tc] [4s]
82a1a41b: Pays Cashout Risk ($0.22)
e4d5b39b: shows [Kh] (King high)
*** SHOWDOWN ***
82a1a41b collected $4.95 from pot
*** SUMMARY ***
Total pot $5.17 | Rake $0.15 | Jackpot $0.07 | Bingo $0 | Fortune $0 | Tax $0
Board [Qs 6d 7d Tc 4s]
Seat 1: a296c73a (button) showed [7c 9c] and lost with a pair of Sevens
Seat 2: 746aae0a (small blind) folded before Flop
Seat 3: 82a1a41b (big blind) showed [9d 8s] and won ($4.95) with a straight, Ten to Six, Cashout Risk ($0.22)
Seat 4: d6a18d8f folded before Flop (didn't bet)
Seat 5: e4d5b39b folded on the Flop
Seat 6: Hero folded before Flop (didn't bet)


Poker Hand #RC3812539937: Hold'em No Limit ($0.02/$0.05) - 2025/08/17 00:03:15
Table 'RushAndCash1095197' 6-max Seat #1 is the button
Seat 1: 57835ed1 ($6.89 in chips)
Seat 2: 289d756a ($7.12 in chips)
Seat 3: Hero ($5.18 in chips)
Seat 4: cf396bf7 ($6.25 in chips)
Seat 5: 56b3ed74 ($4.85 in chips)
Seat 6: b8a1bc13 ($7.32 in chips)
289d756a: posts small blind $0.02
Hero: posts big blind $0.05
*** HOLE CARDS ***
Dealt to 57835ed1 
Dealt to 289d756a 
Dealt to Hero [5h Jd]
Dealt to cf396bf7 
Dealt to 56b3ed74 
Dealt to b8a1bc13 
cf396bf7: folds
56b3ed74: folds
b8a1bc13: folds
57835ed1: folds
289d756a: folds
Uncalled bet ($0.03) returned to Hero
*** SHOWDOWN ***
Hero collected $0.04 from pot
*** SUMMARY ***
Total pot $0.04 | Rake $0 | Jackpot $0 | Bingo $0 | Fortune $0 | Tax $0
Seat 1: 57835ed1 (button) folded before Flop (didn't bet)
Seat 2: 289d756a (small blind) folded before Flop
Seat 3: Hero (big blind) collected ($0.04)
Seat 4: cf396bf7 folded before Flop (didn't bet)
Seat 5: 56b3ed74 folded before Flop (didn't bet)
Seat 6: b8a1bc13 folded before Flop (didn't bet)


Poker Hand #RC3812539902: Hold'em No Limit ($0.02/$0.05) - 2025/08/17 00:03:11
Table 'RushAndCash1095162' 6-max Seat #1 is the button
Seat 1: 40970e63 ($3.63 in chips)
Seat 2: c524cca ($6.48 in chips)
Seat 3: 19f27bb3 ($5.34 in chips)
Seat 4: Hero ($5.18 in chips)
Seat 5: 3dd3abca ($18.01 in chips)
Seat 6: 15497d8b ($4.83 in chips)
c524cca: posts small blind $0.02
19f27bb3: posts big blind $0.05
*** HOLE CARDS ***
Dealt to 40970e63 
Dealt to c524cca 
Dealt to 19f27bb3 
Dealt to Hero [4d Th]
Dealt to 3dd3abca 
Dealt to 15497d8b 
Hero: folds
3dd3abca: raises $0.08 to $0.13
15497d8b: calls $0.13
40970e63: folds
c524cca: folds
19f27bb3: folds
*** FLOP *** [Jc 7c 5c]
3dd3abca: checks
15497d8b: bets $0.25
3dd3abca: folds
Uncalled bet ($0.25) returned to 15497d8b
*** SHOWDOWN ***
15497d8b collected $0.32 from pot
*** SUMMARY ***
Total pot $0.33 | Rake $0.01 | Jackpot $0 | Bingo $0 | Fortune $0 | Tax $0
Board [Jc 7c 5c]
Seat 1: 40970e63 (button) folded before Flop (didn't bet)
Seat 2: c524cca (small blind) folded before Flop
Seat 3: 19f27bb3 (big blind) folded before Flop
Seat 4: Hero folded before Flop (didn't bet)
Seat 5: 3dd3abca folded on the Flop
Seat 6: 15497d8b won ($0.32)


Poker Hand #RC3812539553: Hold'em No Limit ($0.02/$0.05) - 2025/08/17 00:02:20
Table 'RushAndCash1094813' 6-max Seat #1 is the button
Seat 1: 365254c2 ($5.62 in chips)
Seat 2: 6a783797 ($9.99 in chips)
Seat 3: 23bf44f5 ($18.53 in chips)
Seat 4: Hero ($5.18 in chips)
Seat 5: 3dc9b1ad ($8.28 in chips)
Seat 6: 7125b88f ($5.17 in chips)
6a783797: posts small blind $0.02
23bf44f5: posts big blind $0.05
*** HOLE CARDS ***
Dealt to 365254c2 
Dealt to 6a783797 
Dealt to 23bf44f5 
Dealt to Hero [4h 9d]
Dealt to 3dc9b1ad 
Dealt to 7125b88f 
Hero: folds
3dc9b1ad: folds
7125b88f: folds
365254c2: raises $0.06 to $0.11
6a783797: calls $0.09
23bf44f5: folds
*** FLOP *** [Qh 3h Tc]
6a783797: checks
365254c2: checks
*** TURN *** [Qh 3h Tc] [Qs]
6a783797: bets $0.14
365254c2: folds
Uncalled bet ($0.14) returned to 6a783797
*** SHOWDOWN ***
6a783797 collected $0.26 from pot
*** SUMMARY ***
Total pot $0.27 | Rake $0.01 | Jackpot $0 | Bingo $0 | Fortune $0 | Tax $0
Board [Qh 3h Tc Qs]
Seat 1: 365254c2 (button) folded on the Turn
Seat 2: 6a783797 (small blind) won ($0.26)
Seat 3: 23bf44f5 (big blind) folded before Flop
Seat 4: Hero folded before Flop (didn't bet)
Seat 5: 3dc9b1ad folded before Flop (didn't bet)
Seat 6: 7125b88f folded before Flop (didn't bet)


Poker Hand #RC3812539442: Hold'em No Limit ($0.02/$0.05) - 2025/08/17 00:02:03
Table 'RushAndCash1094702' 6-max Seat #1 is the button
Seat 1: 7913c205 ($7.7 in chips)
Seat 2: 4860fc97 ($5.55 in chips)
Seat 3: b586bcc1 ($9.65 in chips)
Seat 4: d4835f13 ($5.31 in chips)
Seat 5: d38af7cf ($5.78 in chips)
Seat 6: Hero ($5.18 in chips)
4860fc97: posts small blind $0.02
b586bcc1: posts big blind $0.05
*** HOLE CARDS ***
Dealt to 7913c205 
Dealt to 4860fc97 
Dealt to b586bcc1 
Dealt to d4835f13 
Dealt to d38af7cf 
Dealt to Hero [Kd Tc]
d4835f13: folds
d38af7cf: raises $0.05 to $0.1
Hero: folds
7913c205: folds
4860fc97: folds
b586bcc1: folds
Uncalled bet ($0.05) returned to d38af7cf
*** SHOWDOWN ***
d38af7cf collected $0.12 from pot
*** SUMMARY ***
Total pot $0.12 | Rake $0 | Jackpot $0 | Bingo $0 | Fortune $0 | Tax $0
Seat 1: 7913c205 (button) folded before Flop (didn't bet)
Seat 2: 4860fc97 (small blind) folded before Flop
Seat 3: b586bcc1 (big blind) folded before Flop
Seat 4: d4835f13 folded before Flop (didn't bet)
Seat 5: d38af7cf collected ($0.12)
Seat 6: Hero folded before Flop (didn't bet)


Poker Hand #RC3812539417: Hold'em No Limit ($0.02/$0.05) - 2025/08/17 00:02:00
Table 'RushAndCash1094677' 6-max Seat #1 is the button
Seat 1: 2f2d0946 ($5.05 in chips)
Seat 2: 76dec9c1 ($6.09 in chips)
Seat 3: 4d8a0ea9 ($5.24 in chips)
Seat 4: Hero ($5.18 in chips)
Seat 5: 817b1ca8 ($4.29 in chips)
Seat 6: 617766ca ($22.37 in chips)
76dec9c1: posts small blind $0.02
4d8a0ea9: posts big blind $0.05
*** HOLE CARDS ***
Dealt to 2f2d0946 
Dealt to 76dec9c1 
Dealt to 4d8a0ea9 
Dealt to Hero [2h Qc]
Dealt to 817b1ca8 
Dealt to 617766ca 
Hero: folds
817b1ca8: folds
617766ca: folds
2f2d0946: raises $0.08 to $0.13
76dec9c1: folds
4d8a0ea9: calls $0.08
*** FLOP *** [5d Ks 3c]
4d8a0ea9: checks
2f2d0946: bets $0.1
4d8a0ea9: folds
Uncalled bet ($0.1) returned to 2f2d0946
*** SHOWDOWN ***
2f2d0946 collected $0.27 from pot
*** SUMMARY ***
Total pot $0.28 | Rake $0.01 | Jackpot $0 | Bingo $0 | Fortune $0 | Tax $0
Board [5d Ks 3c]
Seat 1: 2f2d0946 (button) won ($0.27)
Seat 2: 76dec9c1 (small blind) folded before Flop
Seat 3: 4d8a0ea9 (big blind) folded on the Flop
Seat 4: Hero folded before Flop (didn't bet)
Seat 5: 817b1ca8 folded before Flop (didn't bet)
Seat 6: 617766ca folded before Flop (didn't bet)


Poker Hand #RC3812539292: Hold'em No Limit ($0.02/$0.05) - 2025/08/17 00:01:42
Table 'RushAndCash1094552' 6-max Seat #1 is the button
Seat 1: 8de62ac3 ($7.09 in chips)
Seat 2: 282df3bf ($25.66 in chips)
Seat 3: Hero ($5.16 in chips)
Seat 4: 6a4f4d32 ($12.52 in chips)
Seat 5: b12df020 ($5.37 in chips)
Seat 6: cc3e68a0 ($5 in chips)
282df3bf: posts small blind $0.02
Hero: posts big blind $0.05
*** HOLE CARDS ***
Dealt to 8de62ac3 
Dealt to 282df3bf 
Dealt to Hero [Ad As]
Dealt to 6a4f4d32 
Dealt to b12df020 
Dealt to cc3e68a0 
6a4f4d32: folds
b12df020: folds
cc3e68a0: folds
8de62ac3: folds
282df3bf: folds
Uncalled bet ($0.03) returned to Hero
*** SHOWDOWN ***
Hero collected $0.04 from pot
*** SUMMARY ***
Total pot $0.04 | Rake $0 | Jackpot $0 | Bingo $0 | Fortune $0 | Tax $0
Seat 1: 8de62ac3 (button) folded before Flop (didn't bet)
Seat 2: 282df3bf (small blind) folded before Flop
Seat 3: Hero (big blind) collected ($0.04)
Seat 4: 6a4f4d32 folded before Flop (didn't bet)
Seat 5: b12df020 folded before Flop (didn't bet)
Seat 6: cc3e68a0 folded before Flop (didn't bet)


Poker Hand #RC3812539267: Hold'em No Limit ($0.02/$0.05) - 2025/08/17 00:01:39
Table 'RushAndCash1094527' 6-max Seat #1 is the button
Seat 1: 8df3078 ($4.94 in chips)
Seat 2: 5d3f68c1 ($5.54 in chips)
Seat 3: a836c161 ($7.33 in chips)
Seat 4: 3713ea1d ($5.25 in chips)
Seat 5: Hero ($5.16 in chips)
Seat 6: a4b7c741 ($6.45 in chips)
5d3f68c1: posts small blind $0.02
a836c161: posts big blind $0.05
*** HOLE CARDS ***
Dealt to 8df3078 
Dealt to 5d3f68c1 
Dealt to a836c161 
Dealt to 3713ea1d 
Dealt to Hero [9s 7s]
Dealt to a4b7c741 
3713ea1d: folds
Hero: folds
a4b7c741: calls $0.05
8df3078: folds
5d3f68c1: folds
a836c161: raises $0.15 to $0.2
a4b7c741: calls $0.15
*** FLOP *** [3c 8d 6d]
a836c161: checks
a4b7c741: checks
*** TURN *** [3c 8d 6d] [Qs]
a836c161: checks
a4b7c741: checks
*** RIVER *** [3c 8d 6d Qs] [3h]
a836c161: checks
a4b7c741: bets $0.42
a836c161: folds
Uncalled bet ($0.42) returned to a4b7c741
*** SHOWDOWN ***
a4b7c741 collected $0.4 from pot
*** SUMMARY ***
Total pot $0.42 | Rake $0.02 | Jackpot $0 | Bingo $0 | Fortune $0 | Tax $0
Board [3c 8d 6d Qs 3h]
Seat 1: 8df3078 (button) folded before Flop (didn't bet)
Seat 2: 5d3f68c1 (small blind) folded before Flop
Seat 3: a836c161 (big blind) folded on the River
Seat 4: 3713ea1d folded before Flop (didn't bet)
Seat 5: Hero folded before Flop (didn't bet)
Seat 6: a4b7c741 won ($0.4)


Poker Hand #RC3812539241: Hold'em No Limit ($0.02/$0.05) - 2025/08/17 00:01:35
Table 'RushAndCash1094501' 6-max Seat #1 is the button
Seat 1: 3812131a ($20.64 in chips)
Seat 2: af0142ec ($5.3 in chips)
Seat 3: e07eff7a ($8.11 in chips)
Seat 4: 3301720c ($5.97 in chips)
Seat 5: Hero ($5.16 in chips)
Seat 6: b12df020 ($5.37 in chips)
af0142ec: posts small blind $0.02
e07eff7a: posts big blind $0.05
*** HOLE CARDS ***
Dealt to 3812131a 
Dealt to af0142ec 
Dealt to e07eff7a 
Dealt to 3301720c 
Dealt to Hero [Js 5c]
Dealt to b12df020 
3301720c: raises $0.05 to $0.1
Hero: folds
b12df020: folds
3812131a: raises $0.3 to $0.4
af0142ec: folds
e07eff7a: folds
3301720c: calls $0.3
*** FLOP *** [6c 3d Kc]
3301720c: checks
3812131a: bets $0.29
3301720c: calls $0.29
*** TURN *** [6c 3d Kc] [9h]
3301720c: checks
3812131a: bets $1.35
3301720c: folds
Uncalled bet ($1.35) returned to 3812131a
*** SHOWDOWN ***
3812131a collected $1.38 from pot
*** SUMMARY ***
Total pot $1.45 | Rake $0.07 | Jackpot $0 | Bingo $0 | Fortune $0 | Tax $0
Board [6c 3d Kc 9h]
Seat 1: 3812131a (button) won ($1.38)
Seat 2: af0142ec (small blind) folded before Flop
Seat 3: e07eff7a (big blind) folded before Flop
Seat 4: 3301720c folded on the Turn
Seat 5: Hero folded before Flop (didn't bet)
Seat 6: b12df020 folded before Flop (didn't bet)


Poker Hand #RC3812539210: Hold'em No Limit ($0.02/$0.05) - 2025/08/17 00:01:30
Table 'RushAndCash1094470' 6-max Seat #1 is the button
Seat 1: fe7b6407 ($13.05 in chips)
Seat 2: 55f6b164 ($5.73 in chips)
Seat 3: 2bd8297a ($5.3 in chips)
Seat 4: Hero ($5.16 in chips)
Seat 5: e058cf29 ($6.72 in chips)
Seat 6: 2faeddae ($6.08 in chips)
55f6b164: posts small blind $0.02
2bd8297a: posts big blind $0.05
*** HOLE CARDS ***
Dealt to fe7b6407 
Dealt to 55f6b164 
Dealt to 2bd8297a 
Dealt to Hero [6h 4d]
Dealt to e058cf29 
Dealt to 2faeddae 
Hero: folds
e058cf29: folds
2faeddae: folds
fe7b6407: raises $0.07 to $0.12
55f6b164: folds
2bd8297a: folds
Uncalled bet ($0.07) returned to fe7b6407
*** SHOWDOWN ***
fe7b6407 collected $0.12 from pot
*** SUMMARY ***
Total pot $0.12 | Rake $0 | Jackpot $0 | Bingo $0 | Fortune $0 | Tax $0
Seat 1: fe7b6407 (button) collected ($0.12)
Seat 2: 55f6b164 (small blind) folded before Flop
Seat 3: 2bd8297a (big blind) folded before Flop
Seat 4: Hero folded before Flop (didn't bet)
Seat 5: e058cf29 folded before Flop (didn't bet)
Seat 6: 2faeddae folded before Flop (didn't bet)


Poker Hand #RC3812539116: Hold'em No Limit ($0.02/$0.05) - 2025/08/17 00:01:14
Table 'RushAndCash1094376' 6-max Seat #1 is the button
Seat 1: Hero ($5.16 in chips)
Seat 2: 1670565c ($5.03 in chips)
Seat 3: b9846e09 ($3.49 in chips)
Seat 4: 5bb2ddf5 ($3.86 in chips)
Seat 5: 206a879e ($5.01 in chips)
Seat 6: 58a9ed38 ($9.97 in chips)
1670565c: posts small blind $0.02
b9846e09: posts big blind $0.05
*** HOLE CARDS ***
Dealt to Hero [Jc 3s]
Dealt to 1670565c 
Dealt to b9846e09 
Dealt to 5bb2ddf5 
Dealt to 206a879e 
Dealt to 58a9ed38 
5bb2ddf5: folds
206a879e: folds
58a9ed38: folds
Hero: folds
1670565c: folds
Uncalled bet ($0.03) returned to b9846e09
*** SHOWDOWN ***
b9846e09 collected $0.04 from pot
*** SUMMARY ***
Total pot $0.04 | Rake $0 | Jackpot $0 | Bingo $0 | Fortune $0 | Tax $0
Seat 1: Hero (button) folded before Flop (didn't bet)
Seat 2: 1670565c (small blind) folded before Flop
Seat 3: b9846e09 (big blind) collected ($0.04)
Seat 4: 5bb2ddf5 folded before Flop (didn't bet)
Seat 5: 206a879e folded before Flop (didn't bet)
Seat 6: 58a9ed38 folded before Flop (didn't bet)


Poker Hand #RC3812538838: Hold'em No Limit ($0.02/$0.05) - 2025/08/17 00:00:34
Table 'RushAndCash1094098' 6-max Seat #1 is the button
Seat 1: 58a9ed38 ($10.16 in chips)
Seat 2: Hero ($4.94 in chips)
Seat 3: 58d59aff ($8.73 in chips)
Seat 4: d52559e1 ($7.63 in chips)
Seat 5: c60cf0e5 ($5 in chips)
Seat 6: 2a621fc3 ($6.65 in chips)
Hero: posts small blind $0.02
58d59aff: posts big blind $0.05
*** HOLE CARDS ***
Dealt to 58a9ed38 
Dealt to Hero [6d 6c]
Dealt to 58d59aff 
Dealt to d52559e1 
Dealt to c60cf0e5 
Dealt to 2a621fc3 
d52559e1: folds
c60cf0e5: folds
2a621fc3: folds
58a9ed38: raises $0.05 to $0.1
Hero: calls $0.08
58d59aff: folds
*** FLOP *** [8c 5d 8d]
Hero: checks
58a9ed38: bets $0.09
Hero: raises $0.25 to $0.34
58a9ed38: folds
Uncalled bet ($0.25) returned to Hero
*** SHOWDOWN ***
Hero collected $0.41 from pot
*** SUMMARY ***
Total pot $0.43 | Rake $0.02 | Jackpot $0 | Bingo $0 | Fortune $0 | Tax $0
Board [8c 5d 8d]
Seat 1: 58a9ed38 (button) folded on the Flop
Seat 2: Hero (small blind) won ($0.41)
Seat 3: 58d59aff (big blind) folded before Flop
Seat 4: d52559e1 folded before Flop (didn't bet)
Seat 5: c60cf0e5 folded before Flop (didn't bet)
Seat 6: 2a621fc3 folded before Flop (didn't bet)


Poker Hand #RC3812538713: Hold'em No Limit ($0.02/$0.05) - 2025/08/17 00:00:16
Table 'RushAndCash1093973' 6-max Seat #1 is the button
Seat 1: 4dee626c ($5.07 in chips)
Seat 2: Hero ($4.96 in chips)
Seat 3: f091de86 ($5 in chips)
Seat 4: 32c3183b ($5.74 in chips)
Seat 5: 5bca817b ($5.45 in chips)
Seat 6: 35d680ac ($5.92 in chips)
Hero: posts small blind $0.02
f091de86: posts big blind $0.05
*** HOLE CARDS ***
Dealt to 4dee626c 
Dealt to Hero [3c Jd]
Dealt to f091de86 
Dealt to 32c3183b 
Dealt to 5bca817b 
Dealt to 35d680ac 
32c3183b: folds
5bca817b: folds
35d680ac: folds
4dee626c: folds
Hero: folds
Uncalled bet ($0.03) returned to f091de86
*** SHOWDOWN ***
f091de86 collected $0.04 from pot
*** SUMMARY ***
Total pot $0.04 | Rake $0 | Jackpot $0 | Bingo $0 | Fortune $0 | Tax $0
Seat 1: 4dee626c (button) folded before Flop (didn't bet)
Seat 2: Hero (small blind) folded before Flop
Seat 3: f091de86 (big blind) collected ($0.04)
Seat 4: 32c3183b folded before Flop (didn't bet)
Seat 5: 5bca817b folded before Flop (didn't bet)
Seat 6: 35d680ac folded before Flop (didn't bet)


Poker Hand #RC3812538481: Hold'em No Limit ($0.02/$0.05) - 2025/08/16 23:59:45
Table 'RushAndCash1093741' 6-max Seat #1 is the button
Seat 1: 436b8683 ($5.06 in chips)
Seat 2: 24c89a8b ($12.82 in chips)
Seat 3: Hero ($5.01 in chips)
Seat 4: 9236d969 ($4.52 in chips)
Seat 5: e347d4ad ($8.32 in chips)
Seat 6: 5e8597fe ($5.23 in chips)
24c89a8b: posts small blind $0.02
Hero: posts big blind $0.05
*** HOLE CARDS ***
Dealt to 436b8683 
Dealt to 24c89a8b 
Dealt to Hero [4d Kc]
Dealt to 9236d969 
Dealt to e347d4ad 
Dealt to 5e8597fe 
9236d969: folds
e347d4ad: folds
5e8597fe: raises $0.05 to $0.1
436b8683: folds
24c89a8b: raises $0.13 to $0.23
Hero: folds
5e8597fe: folds
Uncalled bet ($0.13) returned to 24c89a8b
*** SHOWDOWN ***
24c89a8b collected $0.24 from pot
*** SUMMARY ***
Total pot $0.25 | Rake $0.01 | Jackpot $0 | Bingo $0 | Fortune $0 | Tax $0
Seat 1: 436b8683 (button) folded before Flop (didn't bet)
Seat 2: 24c89a8b (small blind) collected ($0.24)
Seat 3: Hero (big blind) folded before Flop
Seat 4: 9236d969 folded before Flop (didn't bet)
Seat 5: e347d4ad folded before Flop (didn't bet)
Seat 6: 5e8597fe folded before Flop


Poker Hand #RC3812538422: Hold'em No Limit ($0.02/$0.05) - 2025/08/16 23:59:37
Table 'RushAndCash1093682' 6-max Seat #1 is the button
Seat 1: Hero ($5.01 in chips)
Seat 2: a836c161 ($7.48 in chips)
Seat 3: 598c3f22 ($8.73 in chips)
Seat 4: 34f352b6 ($4.47 in chips)
Seat 5: 3fc228ba ($5.05 in chips)
Seat 6: 1bb4c5ea ($5 in chips)
a836c161: posts small blind $0.02
598c3f22: posts big blind $0.05
*** HOLE CARDS ***
Dealt to Hero [Qs 6h]
Dealt to a836c161 
Dealt to 598c3f22 
Dealt to 34f352b6 
Dealt to 3fc228ba 
Dealt to 1bb4c5ea 
34f352b6: folds
3fc228ba: folds
1bb4c5ea: folds
Hero: folds
a836c161: raises $0.09 to $0.14
598c3f22: folds
Uncalled bet ($0.09) returned to a836c161
*** SHOWDOWN ***
a836c161 collected $0.1 from pot
*** SUMMARY ***
Total pot $0.1 | Rake $0 | Jackpot $0 | Bingo $0 | Fortune $0 | Tax $0
Seat 1: Hero (button) folded before Flop (didn't bet)
Seat 2: a836c161 (small blind) collected ($0.1)
Seat 3: 598c3f22 (big blind) folded before Flop
Seat 4: 34f352b6 folded before Flop (didn't bet)
Seat 5: 3fc228ba folded before Flop (didn't bet)
Seat 6: 1bb4c5ea folded before Flop (didn't bet)


Poker Hand #RC3812538397: Hold'em No Limit ($0.02/$0.05) - 2025/08/16 23:59:34
Table 'RushAndCash1093657' 6-max Seat #1 is the button
Seat 1: ea0e3ba9 ($5 in chips)
Seat 2: ad6cb65b ($5.26 in chips)
Seat 3: a27c05aa ($12.34 in chips)
Seat 4: 49631ede ($4.12 in chips)
Seat 5: c64eac73 ($1.76 in chips)
Seat 6: Hero ($5.01 in chips)
ad6cb65b: posts small blind $0.02
a27c05aa: posts big blind $0.05
*** HOLE CARDS ***
Dealt to ea0e3ba9 
Dealt to ad6cb65b 
Dealt to a27c05aa 
Dealt to 49631ede 
Dealt to c64eac73 
Dealt to Hero [Js 6c]
49631ede: folds
c64eac73: folds
Hero: folds
ea0e3ba9: folds
ad6cb65b: raises $0.1 to $0.15
a27c05aa: folds
Uncalled bet ($0.1) returned to ad6cb65b
*** SHOWDOWN ***
ad6cb65b collected $0.1 from pot
*** SUMMARY ***
Total pot $0.1 | Rake $0 | Jackpot $0 | Bingo $0 | Fortune $0 | Tax $0
Seat 1: ea0e3ba9 (button) folded before Flop (didn't bet)
Seat 2: ad6cb65b (small blind) collected ($0.1)
Seat 3: a27c05aa (big blind) folded before Flop
Seat 4: 49631ede folded before Flop (didn't bet)
Seat 5: c64eac73 folded before Flop (didn't bet)
Seat 6: Hero folded before Flop (didn't bet)


Poker Hand #RC3812538305: Hold'em No Limit ($0.02/$0.05) - 2025/08/16 23:59:21
Table 'RushAndCash1093565' 6-max Seat #1 is the button
Seat 1: 42d1b03a ($6.77 in chips)
Seat 2: 617766ca ($21.69 in chips)
Seat 3: 9ba6a511 ($5.19 in chips)
Seat 4: Hero ($5.01 in chips)
Seat 5: d57b353c ($5.1 in chips)
Seat 6: a4f04bf ($7.1 in chips)
617766ca: posts small blind $0.02
9ba6a511: posts big blind $0.05
*** HOLE CARDS ***
Dealt to 42d1b03a 
Dealt to 617766ca 
Dealt to 9ba6a511 
Dealt to Hero [Jh Tc]
Dealt to d57b353c 
Dealt to a4f04bf 
Hero: folds
d57b353c: folds
a4f04bf: folds
42d1b03a: folds
617766ca: folds
Uncalled bet ($0.03) returned to 9ba6a511
*** SHOWDOWN ***
9ba6a511 collected $0.04 from pot
*** SUMMARY ***
Total pot $0.04 | Rake $0 | Jackpot $0 | Bingo $0 | Fortune $0 | Tax $0
Seat 1: 42d1b03a (button) folded before Flop (didn't bet)
Seat 2: 617766ca (small blind) folded before Flop
Seat 3: 9ba6a511 (big blind) collected ($0.04)
Seat 4: Hero folded before Flop (didn't bet)
Seat 5: d57b353c folded before Flop (didn't bet)
Seat 6: a4f04bf folded before Flop (didn't bet)


Poker Hand #RC3812538167: Hold'em No Limit ($0.02/$0.05) - 2025/08/16 23:59:02
Table 'RushAndCash1093427' 6-max Seat #1 is the button
Seat 1: Hero ($4.85 in chips)
Seat 2: a1bea61b ($7.77 in chips)
Seat 3: 84412c1e ($13.7 in chips)
Seat 4: 6a783797 ($10.35 in chips)
Seat 5: 5c230b2 ($2.56 in chips)
Seat 6: ae996f4f ($5.71 in chips)
a1bea61b: posts small blind $0.02
84412c1e: posts big blind $0.05
*** HOLE CARDS ***
Dealt to Hero [6s 3s]
Dealt to a1bea61b 
Dealt to 84412c1e 
Dealt to 6a783797 
Dealt to 5c230b2 
Dealt to ae996f4f 
6a783797: folds
5c230b2: folds
ae996f4f: raises $0.05 to $0.1
Hero: raises $0.32 to $0.42
a1bea61b: folds
84412c1e: folds
ae996f4f: folds
Uncalled bet ($0.32) returned to Hero
*** SHOWDOWN ***
Hero collected $0.26 from pot
*** SUMMARY ***
Total pot $0.27 | Rake $0.01 | Jackpot $0 | Bingo $0 | Fortune $0 | Tax $0
Seat 1: Hero (button) collected ($0.26)
Seat 2: a1bea61b (small blind) folded before Flop
Seat 3: 84412c1e (big blind) folded before Flop
Seat 4: 6a783797 folded before Flop (didn't bet)
Seat 5: 5c230b2 folded before Flop (didn't bet)
Seat 6: ae996f4f folded before Flop


Poker Hand #RC3812538142: Hold'em No Limit ($0.02/$0.05) - 2025/08/16 23:58:58
Table 'RushAndCash1093402' 6-max Seat #1 is the button
Seat 1: 371ab838 ($16.67 in chips)
Seat 2: bab6154f ($34.26 in chips)
Seat 3: 45bc7423 ($7.11 in chips)
Seat 4: 84412c1e ($13.7 in chips)
Seat 5: Hero ($4.85 in chips)
Seat 6: ea0e3ba9 ($5 in chips)
bab6154f: posts small blind $0.02
45bc7423: posts big blind $0.05
*** HOLE CARDS ***
Dealt to 371ab838 
Dealt to bab6154f 
Dealt to 45bc7423 
Dealt to 84412c1e 
Dealt to Hero [7s 5h]
Dealt to ea0e3ba9 
84412c1e: folds
Hero: folds
ea0e3ba9: folds
371ab838: raises $0.07 to $0.12
bab6154f: raises $0.29 to $0.41
45bc7423: folds
371ab838: calls $0.29
*** FLOP *** [6d 4s 6h]
bab6154f: bets $0.23
371ab838: calls $0.23
*** TURN *** [6d 4s 6h] [7h]
bab6154f: checks
371ab838: bets $0.5
bab6154f: folds
Uncalled bet ($0.5) returned to 371ab838
*** SHOWDOWN ***
371ab838 collected $1.27 from pot
*** SUMMARY ***
Total pot $1.33 | Rake $0.06 | Jackpot $0 | Bingo $0 | Fortune $0 | Tax $0
Board [6d 4s 6h 7h]
Seat 1: 371ab838 (button) won ($1.27)
Seat 2: bab6154f (small blind) folded on the Turn
Seat 3: 45bc7423 (big blind) folded before Flop
Seat 4: 84412c1e folded before Flop (didn't bet)
Seat 5: Hero folded before Flop (didn't bet)
Seat 6: ea0e3ba9 folded before Flop (didn't bet)


Poker Hand #RC3812537835: Hold'em No Limit ($0.02/$0.05) - 2025/08/16 23:58:17
Table 'RushAndCash1093095' 6-max Seat #1 is the button
Seat 1: b1ae24c8 ($5.68 in chips)
Seat 2: 84412c1e ($13.57 in chips)
Seat 3: Hero ($4.99 in chips)
Seat 4: 638c272a ($6.48 in chips)
Seat 5: 2230098c ($9.59 in chips)
Seat 6: 58cd81fd ($6.24 in chips)
84412c1e: posts small blind $0.02
Hero: posts big blind $0.05
*** HOLE CARDS ***
Dealt to b1ae24c8 
Dealt to 84412c1e 
Dealt to Hero [7d As]
Dealt to 638c272a 
Dealt to 2230098c 
Dealt to 58cd81fd 
638c272a: folds
2230098c: folds
58cd81fd: folds
b1ae24c8: folds
84412c1e: raises $0.09 to $0.14
Hero: calls $0.09
*** FLOP *** [Td 9c 2d]
84412c1e: bets $0.21
Hero: folds
Uncalled bet ($0.21) returned to 84412c1e
*** SHOWDOWN ***
84412c1e collected $0.27 from pot
*** SUMMARY ***
Total pot $0.28 | Rake $0.01 | Jackpot $0 | Bingo $0 | Fortune $0 | Tax $0
Board [Td 9c 2d]
Seat 1: b1ae24c8 (button) folded before Flop (didn't bet)
Seat 2: 84412c1e (small blind) won ($0.27)
Seat 3: Hero (big blind) folded on the Flop
Seat 4: 638c272a folded before Flop (didn't bet)
Seat 5: 2230098c folded before Flop (didn't bet)
Seat 6: 58cd81fd folded before Flop (didn't bet)


Poker Hand #RC3812537588: Hold'em No Limit ($0.02/$0.05) - 2025/08/16 23:57:44
Table 'RushAndCash1092848' 6-max Seat #1 is the button
Seat 1: 38232278 ($10.43 in chips)
Seat 2: Hero ($5.09 in chips)
Seat 3: 84412c1e ($13.48 in chips)
Seat 4: 43f46220 ($4.74 in chips)
Seat 5: e6a23f71 ($6.64 in chips)
Seat 6: 49f5ab89 ($5.09 in chips)
Hero: posts small blind $0.02
84412c1e: posts big blind $0.05
*** HOLE CARDS ***
Dealt to 38232278 
Dealt to Hero [6c 8d]
Dealt to 84412c1e 
Dealt to 43f46220 
Dealt to e6a23f71 
Dealt to 49f5ab89 
43f46220: folds
e6a23f71: folds
49f5ab89: folds
38232278: folds
Hero: raises $0.05 to $0.1
84412c1e: calls $0.05
*** FLOP *** [Qd 3d 5h]
Hero: checks
84412c1e: bets $0.15
Hero: folds
Uncalled bet ($0.15) returned to 84412c1e
*** SHOWDOWN ***
84412c1e collected $0.19 from pot
*** SUMMARY ***
Total pot $0.2 | Rake $0.01 | Jackpot $0 | Bingo $0 | Fortune $0 | Tax $0
Board [Qd 3d 5h]
Seat 1: 38232278 (button) folded before Flop (didn't bet)
Seat 2: Hero (small blind) folded on the Flop
Seat 3: 84412c1e (big blind) won ($0.19)
Seat 4: 43f46220 folded before Flop (didn't bet)
Seat 5: e6a23f71 folded before Flop (didn't bet)
Seat 6: 49f5ab89 folded before Flop (didn't bet)


Poker Hand #RC3812537560: Hold'em No Limit ($0.02/$0.05) - 2025/08/16 23:57:41
Table 'RushAndCash1092820' 6-max Seat #1 is the button
Seat 1: c0856e98 ($8.47 in chips)
Seat 2: 38b3dce8 ($10.03 in chips)
Seat 3: 2c2a09c0 ($9.77 in chips)
Seat 4: Hero ($5.09 in chips)
Seat 5: 84340a2d ($5.39 in chips)
Seat 6: c8f14884 ($8.87 in chips)
38b3dce8: posts small blind $0.02
2c2a09c0: posts big blind $0.05
*** HOLE CARDS ***
Dealt to c0856e98 
Dealt to 38b3dce8 
Dealt to 2c2a09c0 
Dealt to Hero [5c Js]
Dealt to 84340a2d 
Dealt to c8f14884 
Hero: folds
84340a2d: folds
c8f14884: folds
c0856e98: folds
38b3dce8: raises $0.1 to $0.15
2c2a09c0: folds
Uncalled bet ($0.1) returned to 38b3dce8
*** SHOWDOWN ***
38b3dce8 collected $0.1 from pot
*** SUMMARY ***
Total pot $0.1 | Rake $0 | Jackpot $0 | Bingo $0 | Fortune $0 | Tax $0
Seat 1: c0856e98 (button) folded before Flop (didn't bet)
Seat 2: 38b3dce8 (small blind) collected ($0.1)
Seat 3: 2c2a09c0 (big blind) folded before Flop
Seat 4: Hero folded before Flop (didn't bet)
Seat 5: 84340a2d folded before Flop (didn't bet)
Seat 6: c8f14884 folded before Flop (didn't bet)


Poker Hand #RC3812537530: Hold'em No Limit ($0.02/$0.05) - 2025/08/16 23:57:37
Table 'RushAndCash1092790' 6-max Seat #1 is the button
Seat 1: eba83d5b ($6.12 in chips)
Seat 2: 3ae952fa ($5 in chips)
Seat 3: 46068b1c ($16.9 in chips)
Seat 4: 3dd3abca ($12.59 in chips)
Seat 5: 61ca9973 ($5.26 in chips)
Seat 6: Hero ($5.09 in chips)
3ae952fa: posts small blind $0.02
46068b1c: posts big blind $0.05
*** HOLE CARDS ***
Dealt to eba83d5b 
Dealt to 3ae952fa 
Dealt to 46068b1c 
Dealt to 3dd3abca 
Dealt to 61ca9973 
Dealt to Hero [6h 3c]
3dd3abca: folds
61ca9973: folds
Hero: folds
eba83d5b: raises $0.05 to $0.1
3ae952fa: folds
46068b1c: folds
Uncalled bet ($0.05) returned to eba83d5b
*** SHOWDOWN ***
eba83d5b collected $0.12 from pot
*** SUMMARY ***
Total pot $0.12 | Rake $0 | Jackpot $0 | Bingo $0 | Fortune $0 | Tax $0
Seat 1: eba83d5b (button) collected ($0.12)
Seat 2: 3ae952fa (small blind) folded before Flop
Seat 3: 46068b1c (big blind) folded before Flop
Seat 4: 3dd3abca folded before Flop (didn't bet)
Seat 5: 61ca9973 folded before Flop (didn't bet)
Seat 6: Hero folded before Flop (didn't bet)


Poker Hand #RC3812537504: Hold'em No Limit ($0.02/$0.05) - 2025/08/16 23:57:34
Table 'RushAndCash1092764' 6-max Seat #1 is the button
Seat 1: 6e9127e0 ($6.07 in chips)
Seat 2: b2d82934 ($4.73 in chips)
Seat 3: 29651f45 ($5 in chips)
Seat 4: Hero ($5.09 in chips)
Seat 5: 46068b1c ($16.9 in chips)
Seat 6: 940fc210 ($5.53 in chips)
b2d82934: posts small blind $0.02
29651f45: posts big blind $0.05
*** HOLE CARDS ***
Dealt to 6e9127e0 
Dealt to b2d82934 
Dealt to 29651f45 
Dealt to Hero [3d As]
Dealt to 46068b1c 
Dealt to 940fc210 
Hero: folds
46068b1c: folds
940fc210: folds
6e9127e0: folds
b2d82934: folds
Uncalled bet ($0.03) returned to 29651f45
*** SHOWDOWN ***
29651f45 collected $0.04 from pot
*** SUMMARY ***
Total pot $0.04 | Rake $0 | Jackpot $0 | Bingo $0 | Fortune $0 | Tax $0
Seat 1: 6e9127e0 (button) folded before Flop (didn't bet)
Seat 2: b2d82934 (small blind) folded before Flop
Seat 3: 29651f45 (big blind) collected ($0.04)
Seat 4: Hero folded before Flop (didn't bet)
Seat 5: 46068b1c folded before Flop (didn't bet)
Seat 6: 940fc210 folded before Flop (didn't bet)


Poker Hand #RC3812537437: Hold'em No Limit ($0.02/$0.05) - 2025/08/16 23:57:24
Table 'RushAndCash1092697' 6-max Seat #1 is the button
Seat 1: 98d0a8ed ($5 in chips)
Seat 2: 38232278 ($10.5 in chips)
Seat 3: Hero ($5.07 in chips)
Seat 4: 49631ede ($4.19 in chips)
Seat 5: 9779cfec ($3.26 in chips)
Seat 6: d3ee9b0a ($6.03 in chips)
38232278: posts small blind $0.02
Hero: posts big blind $0.05
*** HOLE CARDS ***
Dealt to 98d0a8ed 
Dealt to 38232278 
Dealt to Hero [Js 2h]
Dealt to 49631ede 
Dealt to 9779cfec 
Dealt to d3ee9b0a 
49631ede: folds
9779cfec: folds
d3ee9b0a: folds
98d0a8ed: folds
38232278: folds
Uncalled bet ($0.03) returned to Hero
*** SHOWDOWN ***
Hero collected $0.04 from pot
*** SUMMARY ***
Total pot $0.04 | Rake $0 | Jackpot $0 | Bingo $0 | Fortune $0 | Tax $0
Seat 1: 98d0a8ed (button) folded before Flop (didn't bet)
Seat 2: 38232278 (small blind) folded before Flop
Seat 3: Hero (big blind) collected ($0.04)
Seat 4: 49631ede folded before Flop (didn't bet)
Seat 5: 9779cfec folded before Flop (didn't bet)
Seat 6: d3ee9b0a folded before Flop (didn't bet)


Poker Hand #RC3812537333: Hold'em No Limit ($0.02/$0.05) - 2025/08/16 23:57:11
Table 'RushAndCash1092593' 6-max Seat #1 is the button
Seat 1: d3c7d081 ($18.24 in chips)
Seat 2: Hero ($5.09 in chips)
Seat 3: 362a084c ($4.19 in chips)
Seat 4: 24d280ec ($10.11 in chips)
Seat 5: e058cf29 ($6.89 in chips)
Seat 6: 58d59aff ($10.78 in chips)
Hero: posts small blind $0.02
362a084c: posts big blind $0.05
*** HOLE CARDS ***
Dealt to d3c7d081 
Dealt to Hero [3s As]
Dealt to 362a084c 
Dealt to 24d280ec 
Dealt to e058cf29 
Dealt to 58d59aff 
24d280ec: folds
e058cf29: folds
58d59aff: raises $0.05 to $0.1
d3c7d081: folds
Hero: folds
362a084c: calls $0.05
*** FLOP *** [3c 5c Td]
362a084c: checks
58d59aff: bets $0.08
362a084c: calls $0.08
*** TURN *** [3c 5c Td] [5d]
362a084c: checks
58d59aff: checks
*** RIVER *** [3c 5c Td 5d] [4d]
362a084c: bets $0.13
58d59aff: folds
Uncalled bet ($0.13) returned to 362a084c
*** SHOWDOWN ***
362a084c collected $0.37 from pot
*** SUMMARY ***
Total pot $0.38 | Rake $0.01 | Jackpot $0 | Bingo $0 | Fortune $0 | Tax $0
Board [3c 5c Td 5d 4d]
Seat 1: d3c7d081 (button) folded before Flop (didn't bet)
Seat 2: Hero (small blind) folded before Flop
Seat 3: 362a084c (big blind) won ($0.37)
Seat 4: 24d280ec folded before Flop (didn't bet)
Seat 5: e058cf29 folded before Flop (didn't bet)
Seat 6: 58d59aff folded on the River


Poker Hand #RC3812537206: Hold'em No Limit ($0.02/$0.05) - 2025/08/16 23:56:52
Table 'RushAndCash1092466' 6-max Seat #1 is the button
Seat 1: Hero ($5.09 in chips)
Seat 2: 24d280ec ($10.13 in chips)
Seat 3: 67015b98 ($5.1 in chips)
Seat 4: a7fbcaa5 ($5.07 in chips)
Seat 5: c0c7320e ($6.57 in chips)
Seat 6: 2fcab16b ($5 in chips)
24d280ec: posts small blind $0.02
67015b98: posts big blind $0.05
*** HOLE CARDS ***
Dealt to Hero [9s 7h]
Dealt to 24d280ec 
Dealt to 67015b98 
Dealt to a7fbcaa5 
Dealt to c0c7320e 
Dealt to 2fcab16b 
a7fbcaa5: raises $0.07 to $0.12
c0c7320e: folds
2fcab16b: folds
Hero: folds
24d280ec: folds
67015b98: folds
Uncalled bet ($0.07) returned to a7fbcaa5
*** SHOWDOWN ***
a7fbcaa5 collected $0.12 from pot
*** SUMMARY ***
Total pot $0.12 | Rake $0 | Jackpot $0 | Bingo $0 | Fortune $0 | Tax $0
Seat 1: Hero (button) folded before Flop (didn't bet)
Seat 2: 24d280ec (small blind) folded before Flop
Seat 3: 67015b98 (big blind) folded before Flop
Seat 4: a7fbcaa5 collected ($0.12)
Seat 5: c0c7320e folded before Flop (didn't bet)
Seat 6: 2fcab16b folded before Flop (didn't bet)


Poker Hand #RC3812537184: Hold'em No Limit ($0.02/$0.05) - 2025/08/16 23:56:48
Table 'RushAndCash1092444' 6-max Seat #1 is the button
Seat 1: 24ccb1c2 ($5.84 in chips)
Seat 2: fbfae31e ($4.65 in chips)
Seat 3: f3333abb ($5.54 in chips)
Seat 4: 9ced515b ($3.67 in chips)
Seat 5: 2ba075f4 ($2.92 in chips)
Seat 6: Hero ($5.09 in chips)
fbfae31e: posts small blind $0.02
f3333abb: posts big blind $0.05
*** HOLE CARDS ***
Dealt to 24ccb1c2 
Dealt to fbfae31e 
Dealt to f3333abb 
Dealt to 9ced515b 
Dealt to 2ba075f4 
Dealt to Hero [Jd 8h]
9ced515b: raises $0.06 to $0.11
2ba075f4: calls $0.11
Hero: folds
24ccb1c2: raises $0.4 to $0.51
fbfae31e: folds
f3333abb: folds
9ced515b: calls $0.4
2ba075f4: raises $1.6 to $2.11
24ccb1c2: folds
9ced515b: folds
Uncalled bet ($1.6) returned to 2ba075f4
*** SHOWDOWN ***
2ba075f4 collected $1.46 from pot
*** SUMMARY ***
Total pot $1.6 | Rake $0.07 | Jackpot $0.07 | Bingo $0 | Fortune $0 | Tax $0
Seat 1: 24ccb1c2 (button) folded before Flop
Seat 2: fbfae31e (small blind) folded before Flop
Seat 3: f3333abb (big blind) folded before Flop
Seat 4: 9ced515b folded before Flop
Seat 5: 2ba075f4 collected ($1.46)
Seat 6: Hero folded before Flop (didn't bet)


Poker Hand #RC3812536927: Hold'em No Limit ($0.02/$0.05) - 2025/08/16 23:56:12
Table 'RushAndCash1092187' 6-max Seat #1 is the button
Seat 1: e14f293 ($5.19 in chips)
Seat 2: 1cc531b8 ($11.02 in chips)
Seat 3: 2ba075f4 ($3.11 in chips)
Seat 4: 4f535453 ($5.84 in chips)
Seat 5: Hero ($5.19 in chips)
Seat 6: a7fbcaa5 ($5.37 in chips)
1cc531b8: posts small blind $0.02
2ba075f4: posts big blind $0.05
*** HOLE CARDS ***
Dealt to e14f293 
Dealt to 1cc531b8 
Dealt to 2ba075f4 
Dealt to 4f535453 
Dealt to Hero [Kc Qh]
Dealt to a7fbcaa5 
4f535453: raises $0.05 to $0.1
Hero: calls $0.1
a7fbcaa5: calls $0.1
e14f293: folds
1cc531b8: raises $0.6 to $0.7
2ba075f4: folds
4f535453: folds
Hero: folds
a7fbcaa5: calls $0.6
*** FLOP *** [Kh 2h 9d]
1cc531b8: bets $1.24
a7fbcaa5: folds
Uncalled bet ($1.24) returned to 1cc531b8
*** SHOWDOWN ***
1cc531b8 collected $1.51 from pot
*** SUMMARY ***
Total pot $1.65 | Rake $0.07 | Jackpot $0.07 | Bingo $0 | Fortune $0 | Tax $0
Board [Kh 2h 9d]
Seat 1: e14f293 (button) folded before Flop (didn't bet)
Seat 2: 1cc531b8 (small blind) won ($1.51)
Seat 3: 2ba075f4 (big blind) folded before Flop
Seat 4: 4f535453 folded before Flop
Seat 5: Hero folded before Flop
Seat 6: a7fbcaa5 folded on the Flop


Poker Hand #RC3812536599: Hold'em No Limit ($0.02/$0.05) - 2025/08/16 23:55:27
Table 'RushAndCash1091859' 6-max Seat #1 is the button
Seat 1: 657ae2a ($5 in chips)
Seat 2: d3d9e1af ($7.17 in chips)
Seat 3: Hero ($4.89 in chips)
Seat 4: cda26e4a ($11.63 in chips)
Seat 5: 65b53c53 ($6.45 in chips)
Seat 6: 1cc531b8 ($11.33 in chips)
d3d9e1af: posts small blind $0.02
Hero: posts big blind $0.05
*** HOLE CARDS ***
Dealt to 657ae2a 
Dealt to d3d9e1af 
Dealt to Hero [Qc Tc]
Dealt to cda26e4a 
Dealt to 65b53c53 
Dealt to 1cc531b8 
cda26e4a: folds
65b53c53: folds
1cc531b8: raises $0.1 to $0.15
657ae2a: folds
d3d9e1af: folds
Hero: calls $0.1
*** FLOP *** [4h 5s 3d]
Hero: checks
1cc531b8: bets $0.16
Hero: raises $0.6 to $0.76
1cc531b8: folds
Uncalled bet ($0.6) returned to Hero
*** SHOWDOWN ***
Hero collected $0.61 from pot
*** SUMMARY ***
Total pot $0.64 | Rake $0.03 | Jackpot $0 | Bingo $0 | Fortune $0 | Tax $0
Board [4h 5s 3d]
Seat 1: 657ae2a (button) folded before Flop (didn't bet)
Seat 2: d3d9e1af (small blind) folded before Flop
Seat 3: Hero (big blind) won ($0.61)
Seat 4: cda26e4a folded before Flop (didn't bet)
Seat 5: 65b53c53 folded before Flop (didn't bet)
Seat 6: 1cc531b8 folded on the Flop


Poker Hand #RC3812536572: Hold'em No Limit ($0.02/$0.05) - 2025/08/16 23:55:24
Table 'RushAndCash1091832' 6-max Seat #1 is the button
Seat 1: 5917f0c8 ($11.36 in chips)
Seat 2: 820d1154 ($5.11 in chips)
Seat 3: 2a385857 ($15.3 in chips)
Seat 4: 55f6b164 ($5.86 in chips)
Seat 5: Hero ($4.89 in chips)
Seat 6: b3f88d3 ($3.71 in chips)
820d1154: posts small blind $0.02
2a385857: posts big blind $0.05
*** HOLE CARDS ***
Dealt to 5917f0c8 
Dealt to 820d1154 
Dealt to 2a385857 
Dealt to 55f6b164 
Dealt to Hero [3d 8h]
Dealt to b3f88d3 
55f6b164: folds
Hero: folds
b3f88d3: folds
5917f0c8: raises $0.05 to $0.1
820d1154: folds
2a385857: folds
Uncalled bet ($0.05) returned to 5917f0c8
*** SHOWDOWN ***
5917f0c8 collected $0.12 from pot
*** SUMMARY ***
Total pot $0.12 | Rake $0 | Jackpot $0 | Bingo $0 | Fortune $0 | Tax $0
Seat 1: 5917f0c8 (button) collected ($0.12)
Seat 2: 820d1154 (small blind) folded before Flop
Seat 3: 2a385857 (big blind) folded before Flop
Seat 4: 55f6b164 folded before Flop (didn't bet)
Seat 5: Hero folded before Flop (didn't bet)
Seat 6: b3f88d3 folded before Flop (didn't bet)


Poker Hand #RC3812536439: Hold'em No Limit ($0.02/$0.05) - 2025/08/16 23:55:05
Table 'RushAndCash1091699' 6-max Seat #1 is the button
Seat 1: 50782f9f ($5.42 in chips)
Seat 2: Hero ($4.75 in chips)
Seat 3: c9a8ed59 ($14.81 in chips)
Seat 4: a23e593c ($10.11 in chips)
Seat 5: 91b20d07 ($8.96 in chips)
Seat 6: b3f88d3 ($3.81 in chips)
Hero: posts small blind $0.02
c9a8ed59: posts big blind $0.05
*** HOLE CARDS ***
Dealt to 50782f9f 
Dealt to Hero [As Kd]
Dealt to c9a8ed59 
Dealt to a23e593c 
Dealt to 91b20d07 
Dealt to b3f88d3 
a23e593c: folds
91b20d07: folds
b3f88d3: raises $0.05 to $0.1
50782f9f: folds
Hero: raises $0.3 to $0.4
c9a8ed59: folds
b3f88d3: folds
Uncalled bet ($0.3) returned to Hero
*** SHOWDOWN ***
Hero collected $0.24 from pot
*** SUMMARY ***
Total pot $0.25 | Rake $0.01 | Jackpot $0 | Bingo $0 | Fortune $0 | Tax $0
Seat 1: 50782f9f (button) folded before Flop (didn't bet)
Seat 2: Hero (small blind) collected ($0.24)
Seat 3: c9a8ed59 (big blind) folded before Flop
Seat 4: a23e593c folded before Flop (didn't bet)
Seat 5: 91b20d07 folded before Flop (didn't bet)
Seat 6: b3f88d3 folded before Flop


Poker Hand #RC3812536404: Hold'em No Limit ($0.02/$0.05) - 2025/08/16 23:55:01
Table 'RushAndCash1091664' 6-max Seat #1 is the button
Seat 1: Hero ($4.75 in chips)
Seat 2: b2d82934 ($4.42 in chips)
Seat 3: beafddcf ($7.36 in chips)
Seat 4: 28a77572 ($4.65 in chips)
Seat 5: e1bc954d ($5 in chips)
Seat 6: ce835e9f ($3.61 in chips)
b2d82934: posts small blind $0.02
beafddcf: posts big blind $0.05
*** HOLE CARDS ***
Dealt to Hero [2h 7d]
Dealt to b2d82934 
Dealt to beafddcf 
Dealt to 28a77572 
Dealt to e1bc954d 
Dealt to ce835e9f 
28a77572: folds
e1bc954d: folds
ce835e9f: folds
Hero: folds
b2d82934: raises $0.05 to $0.1
beafddcf: folds
Uncalled bet ($0.05) returned to b2d82934
*** SHOWDOWN ***
b2d82934 collected $0.1 from pot
*** SUMMARY ***
Total pot $0.1 | Rake $0 | Jackpot $0 | Bingo $0 | Fortune $0 | Tax $0
Seat 1: Hero (button) folded before Flop (didn't bet)
Seat 2: b2d82934 (small blind) collected ($0.1)
Seat 3: beafddcf (big blind) folded before Flop
Seat 4: 28a77572 folded before Flop (didn't bet)
Seat 5: e1bc954d folded before Flop (didn't bet)
Seat 6: ce835e9f folded before Flop (didn't bet)


Poker Hand #RC3812536376: Hold'em No Limit ($0.02/$0.05) - 2025/08/16 23:54:57
Table 'RushAndCash1091636' 6-max Seat #1 is the button
Seat 1: 5434db53 ($3.99 in chips)
Seat 2: fc2ad8be ($6.13 in chips)
Seat 3: dcc428e3 ($7.27 in chips)
Seat 4: 76dec9c1 ($5.36 in chips)
Seat 5: Hero ($4.75 in chips)
Seat 6: b2d82934 ($4.42 in chips)
fc2ad8be: posts small blind $0.02
dcc428e3: posts big blind $0.05
*** HOLE CARDS ***
Dealt to 5434db53 
Dealt to fc2ad8be 
Dealt to dcc428e3 
Dealt to 76dec9c1 
Dealt to Hero [Kd 5d]
Dealt to b2d82934 
76dec9c1: folds
Hero: folds
b2d82934: folds
5434db53: folds
fc2ad8be: folds
Uncalled bet ($0.03) returned to dcc428e3
*** SHOWDOWN ***
dcc428e3 collected $0.04 from pot
*** SUMMARY ***
Total pot $0.04 | Rake $0 | Jackpot $0 | Bingo $0 | Fortune $0 | Tax $0
Seat 1: 5434db53 (button) folded before Flop (didn't bet)
Seat 2: fc2ad8be (small blind) folded before Flop
Seat 3: dcc428e3 (big blind) collected ($0.04)
Seat 4: 76dec9c1 folded before Flop (didn't bet)
Seat 5: Hero folded before Flop (didn't bet)
Seat 6: b2d82934 folded before Flop (didn't bet)


Poker Hand #RC3812536116: Hold'em No Limit ($0.02/$0.05) - 2025/08/16 23:54:22
Table 'RushAndCash1091376' 6-max Seat #1 is the button
Seat 1: b5b5ed2d ($4.19 in chips)
Seat 2: 34825fcc ($3.06 in chips)
Seat 3: Hero ($4.47 in chips)
Seat 4: b6ad6a5 ($5.58 in chips)
Seat 5: dcc428e3 ($7.42 in chips)
Seat 6: 36d1802a ($4.93 in chips)
34825fcc: posts small blind $0.02
Hero: posts big blind $0.05
*** HOLE CARDS ***
Dealt to b5b5ed2d 
Dealt to 34825fcc 
Dealt to Hero [8d Td]
Dealt to b6ad6a5 
Dealt to dcc428e3 
Dealt to 36d1802a 
b6ad6a5: folds
dcc428e3: raises $0.1 to $0.15
36d1802a: folds
b5b5ed2d: folds
34825fcc: calls $0.13
Hero: calls $0.1
*** FLOP *** [5d 9h 2h]
34825fcc: checks
Hero: bets $0.22
dcc428e3: folds
34825fcc: folds
Uncalled bet ($0.22) returned to Hero
*** SHOWDOWN ***
Hero collected $0.43 from pot
*** SUMMARY ***
Total pot $0.45 | Rake $0.02 | Jackpot $0 | Bingo $0 | Fortune $0 | Tax $0
Board [5d 9h 2h]
Seat 1: b5b5ed2d (button) folded before Flop (didn't bet)
Seat 2: 34825fcc (small blind) folded on the Flop
Seat 3: Hero (big blind) won ($0.43)
Seat 4: b6ad6a5 folded before Flop (didn't bet)
Seat 5: dcc428e3 folded on the Flop
Seat 6: 36d1802a folded before Flop (didn't bet)


Poker Hand #RC3812535877: Hold'em No Limit ($0.02/$0.05) - 2025/08/16 23:53:51
Table 'RushAndCash1091137' 6-max Seat #1 is the button
Seat 1: a23e593c ($10.07 in chips)
Seat 2: Hero ($4.52 in chips)
Seat 3: b5b5ed2d ($4.14 in chips)
Seat 4: b9846e09 ($4.99 in chips)
Seat 5: 9485470c ($5.37 in chips)
Seat 6: 58d59aff ($11.9 in chips)
Hero: posts small blind $0.02
b5b5ed2d: posts big blind $0.05
*** HOLE CARDS ***
Dealt to a23e593c 
Dealt to Hero [Kc 9h]
Dealt to b5b5ed2d 
Dealt to b9846e09 
Dealt to 9485470c 
Dealt to 58d59aff 
b9846e09: folds
9485470c: folds
58d59aff: folds
a23e593c: folds
Hero: calls $0.03
b5b5ed2d: checks
*** FLOP *** [5s Td 8c]
Hero: checks
b5b5ed2d: checks
*** TURN *** [5s Td 8c] [Qs]
Hero: checks
b5b5ed2d: bets $0.05
Hero: folds
Uncalled bet ($0.05) returned to b5b5ed2d
*** SHOWDOWN ***
b5b5ed2d collected $0.1 from pot
*** SUMMARY ***
Total pot $0.1 | Rake $0 | Jackpot $0 | Bingo $0 | Fortune $0 | Tax $0
Board [5s Td 8c Qs]
Seat 1: a23e593c (button) folded before Flop (didn't bet)
Seat 2: Hero (small blind) folded on the Turn
Seat 3: b5b5ed2d (big blind) won ($0.1)
Seat 4: b9846e09 folded before Flop (didn't bet)
Seat 5: 9485470c folded before Flop (didn't bet)
Seat 6: 58d59aff folded before Flop (didn't bet)


Poker Hand #RC3812535847: Hold'em No Limit ($0.02/$0.05) - 2025/08/16 23:53:47
Table 'RushAndCash1091107' 6-max Seat #1 is the button
Seat 1: d6b9968d ($7.28 in chips)
Seat 2: 6fc5f880 ($6.16 in chips)
Seat 3: aedb33d9 ($5.62 in chips)
Seat 4: 84412c1e ($12.96 in chips)
Seat 5: b9846e09 ($4.99 in chips)
Seat 6: Hero ($4.52 in chips)
6fc5f880: posts small blind $0.02
aedb33d9: posts big blind $0.05
*** HOLE CARDS ***
Dealt to d6b9968d 
Dealt to 6fc5f880 
Dealt to aedb33d9 
Dealt to 84412c1e 
Dealt to b9846e09 
Dealt to Hero [Td 4h]
84412c1e: folds
b9846e09: folds
Hero: folds
d6b9968d: folds
6fc5f880: folds
Uncalled bet ($0.03) returned to aedb33d9
*** SHOWDOWN ***
aedb33d9 collected $0.04 from pot
*** SUMMARY ***
Total pot $0.04 | Rake $0 | Jackpot $0 | Bingo $0 | Fortune $0 | Tax $0
Seat 1: d6b9968d (button) folded before Flop (didn't bet)
Seat 2: 6fc5f880 (small blind) folded before Flop
Seat 3: aedb33d9 (big blind) collected ($0.04)
Seat 4: 84412c1e folded before Flop (didn't bet)
Seat 5: b9846e09 folded before Flop (didn't bet)
Seat 6: Hero folded before Flop (didn't bet)


Poker Hand #RC3812535818: Hold'em No Limit ($0.02/$0.05) - 2025/08/16 23:53:43
Table 'RushAndCash1091078' 6-max Seat #1 is the button
Seat 1: c6a9145e ($5.14 in chips)
Seat 2: b59a8c8a ($9.44 in chips)
Seat 3: dd2d083a ($11.35 in chips)
Seat 4: 820d1154 ($5 in chips)
Seat 5: Hero ($4.52 in chips)
Seat 6: b9846e09 ($4.99 in chips)
b59a8c8a: posts small blind $0.02
dd2d083a: posts big blind $0.05
*** HOLE CARDS ***
Dealt to c6a9145e 
Dealt to b59a8c8a 
Dealt to dd2d083a 
Dealt to 820d1154 
Dealt to Hero [8d 6d]
Dealt to b9846e09 
820d1154: folds
Hero: folds
b9846e09: folds
c6a9145e: raises $0.05 to $0.1
b59a8c8a: folds
dd2d083a: calls $0.05
*** FLOP *** [9h 3s 7c]
dd2d083a: checks
c6a9145e: bets $0.11
dd2d083a: folds
Uncalled bet ($0.11) returned to c6a9145e
*** SHOWDOWN ***
c6a9145e collected $0.21 from pot
*** SUMMARY ***
Total pot $0.22 | Rake $0.01 | Jackpot $0 | Bingo $0 | Fortune $0 | Tax $0
Board [9h 3s 7c]
Seat 1: c6a9145e (button) won ($0.21)
Seat 2: b59a8c8a (small blind) folded before Flop
Seat 3: dd2d083a (big blind) folded on the Flop
Seat 4: 820d1154 folded before Flop (didn't bet)
Seat 5: Hero folded before Flop (didn't bet)
Seat 6: b9846e09 folded before Flop (didn't bet)


Poker Hand #RC3812535792: Hold'em No Limit ($0.02/$0.05) - 2025/08/16 23:53:40
Table 'RushAndCash1091052' 6-max Seat #1 is the button
Seat 1: 677d66f ($4.88 in chips)
Seat 2: 606c9f81 ($4.16 in chips)
Seat 3: db9abd16 ($5.52 in chips)
Seat 4: Hero ($4.52 in chips)
Seat 5: 42d1b03a ($5.8 in chips)
Seat 6: a27c05aa ($12.4 in chips)
606c9f81: posts small blind $0.02
db9abd16: posts big blind $0.05
*** HOLE CARDS ***
Dealt to 677d66f 
Dealt to 606c9f81 
Dealt to db9abd16 
Dealt to Hero [3c 9h]
Dealt to 42d1b03a 
Dealt to a27c05aa 
Hero: folds
42d1b03a: raises $0.05 to $0.1
a27c05aa: calls $0.1
677d66f: folds
606c9f81: folds
db9abd16: calls $0.05
*** FLOP *** [9d Ts 9s]
db9abd16: checks
42d1b03a: checks
a27c05aa: checks
*** TURN *** [9d Ts 9s] [3h]
db9abd16: checks
42d1b03a: bets $0.5
a27c05aa: folds
db9abd16: folds
Uncalled bet ($0.5) returned to 42d1b03a
*** SHOWDOWN ***
42d1b03a collected $0.31 from pot
*** SUMMARY ***
Total pot $0.32 | Rake $0.01 | Jackpot $0 | Bingo $0 | Fortune $0 | Tax $0
Board [9d Ts 9s 3h]
Seat 1: 677d66f (button) folded before Flop (didn't bet)
Seat 2: 606c9f81 (small blind) folded before Flop
Seat 3: db9abd16 (big blind) folded on the Turn
Seat 4: Hero folded before Flop (didn't bet)
Seat 5: 42d1b03a won ($0.31)
Seat 6: a27c05aa folded on the Turn


Poker Hand #RC3812535422: Hold'em No Limit ($0.02/$0.05) - 2025/08/16 23:52:48
Table 'RushAndCash1090682' 6-max Seat #1 is the button
Seat 1: fed1995e ($4.18 in chips)
Seat 2: fc2ad8be ($6.75 in chips)
Seat 3: 606c9f81 ($3.89 in chips)
Seat 4: Hero ($4.79 in chips)
Seat 5: 9166e4c6 ($5.15 in chips)
Seat 6: 2e6cb799 ($10.34 in chips)
fc2ad8be: posts small blind $0.02
606c9f81: posts big blind $0.05
*** HOLE CARDS ***
Dealt to fed1995e 
Dealt to fc2ad8be 
Dealt to 606c9f81 
Dealt to Hero [7h 7d]
Dealt to 9166e4c6 
Dealt to 2e6cb799 
Hero: raises $0.05 to $0.1
9166e4c6: folds
2e6cb799: folds
fed1995e: folds
fc2ad8be: folds
606c9f81: calls $0.05
*** FLOP *** [Jd 8d Ks]
606c9f81: checks
Hero: checks
*** TURN *** [Jd 8d Ks] [9d]
606c9f81: checks
Hero: checks
*** RIVER *** [Jd 8d Ks 9d] [2s]
606c9f81: bets $0.17
Hero: calls $0.17
606c9f81: shows [9c 8s] (two pair, Nines and Eights)
Hero: shows [7h 7d] (a pair of Sevens)
*** SHOWDOWN ***
606c9f81 collected $0.54 from pot
*** SUMMARY ***
Total pot $0.56 | Rake $0.02 | Jackpot $0 | Bingo $0 | Fortune $0 | Tax $0
Board [Jd 8d Ks 9d 2s]
Seat 1: fed1995e (button) folded before Flop (didn't bet)
Seat 2: fc2ad8be (small blind) folded before Flop
Seat 3: 606c9f81 (big blind) showed [9c 8s] and won ($0.54) with two pair, Nines and Eights
Seat 4: Hero showed [7h 7d] and lost with a pair of Sevens
Seat 5: 9166e4c6 folded before Flop (didn't bet)
Seat 6: 2e6cb799 folded before Flop (didn't bet)


Poker Hand #RC3812535397: Hold'em No Limit ($0.02/$0.05) - 2025/08/16 23:52:44
Table 'RushAndCash1090657' 6-max Seat #1 is the button
Seat 1: Hero ($4.79 in chips)
Seat 2: 84340a2d ($5.02 in chips)
Seat 3: c7d2aa99 ($5.37 in chips)
Seat 4: a7fbcaa5 ($5.79 in chips)
Seat 5: 564134e6 ($7.19 in chips)
Seat 6: 8672b474 ($6.54 in chips)
84340a2d: posts small blind $0.02
c7d2aa99: posts big blind $0.05
*** HOLE CARDS ***
Dealt to Hero [7d Jc]
Dealt to 84340a2d 
Dealt to c7d2aa99 
Dealt to a7fbcaa5 
Dealt to 564134e6 
Dealt to 8672b474 
a7fbcaa5: folds
564134e6: raises $0.07 to $0.12
8672b474: raises $0.24 to $0.36
Hero: folds
84340a2d: folds
c7d2aa99: folds
564134e6: calls $0.24
*** FLOP *** [8s Jd 6h]
564134e6: checks
8672b474: bets $0.27
564134e6: calls $0.27
*** TURN *** [8s Jd 6h] [Kc]
564134e6: checks
8672b474: bets $0.67
564134e6: folds
Uncalled bet ($0.67) returned to 8672b474
*** SHOWDOWN ***
8672b474 collected $1.27 from pot
*** SUMMARY ***
Total pot $1.33 | Rake $0.06 | Jackpot $0 | Bingo $0 | Fortune $0 | Tax $0
Board [8s Jd 6h Kc]
Seat 1: Hero (button) folded before Flop (didn't bet)
Seat 2: 84340a2d (small blind) folded before Flop
Seat 3: c7d2aa99 (big blind) folded before Flop
Seat 4: a7fbcaa5 folded before Flop (didn't bet)
Seat 5: 564134e6 folded on the Turn
Seat 6: 8672b474 won ($1.27)


Poker Hand #RC3812535338: Hold'em No Limit ($0.02/$0.05) - 2025/08/16 23:52:36
Table 'RushAndCash1090598' 6-max Seat #1 is the button
Seat 1: Hero ($4.79 in chips)
Seat 2: 771ca3f6 ($2.69 in chips)
Seat 3: 6e9127e0 ($5.82 in chips)
Seat 4: 6f2b1159 ($5.34 in chips)
Seat 5: a4c0e017 ($12.52 in chips)
Seat 6: bf5c869a ($12.14 in chips)
771ca3f6: posts small blind $0.02
6e9127e0: posts big blind $0.05
*** HOLE CARDS ***
Dealt to Hero [5s Qh]
Dealt to 771ca3f6 
Dealt to 6e9127e0 
Dealt to 6f2b1159 
Dealt to a4c0e017 
Dealt to bf5c869a 
6f2b1159: folds
a4c0e017: folds
bf5c869a: raises $0.06 to $0.11
Hero: folds
771ca3f6: folds
6e9127e0: folds
Uncalled bet ($0.06) returned to bf5c869a
*** SHOWDOWN ***
bf5c869a collected $0.12 from pot
*** SUMMARY ***
Total pot $0.12 | Rake $0 | Jackpot $0 | Bingo $0 | Fortune $0 | Tax $0
Seat 1: Hero (button) folded before Flop (didn't bet)
Seat 2: 771ca3f6 (small blind) folded before Flop
Seat 3: 6e9127e0 (big blind) folded before Flop
Seat 4: 6f2b1159 folded before Flop (didn't bet)
Seat 5: a4c0e017 folded before Flop (didn't bet)
Seat 6: bf5c869a collected ($0.12)


Poker Hand #RC3812535309: Hold'em No Limit ($0.02/$0.05) - 2025/08/16 23:52:32
Table 'RushAndCash1090569' 6-max Seat #1 is the button
Seat 1: 2d0fdbda ($5.62 in chips)
Seat 2: ea0e3ba9 ($4.92 in chips)
Seat 3: Hero ($4.84 in chips)
Seat 4: 582a39d0 ($5.09 in chips)
Seat 5: c588248b ($5.5 in chips)
Seat 6: ed63ffb0 ($5.16 in chips)
ea0e3ba9: posts small blind $0.02
Hero: posts big blind $0.05
*** HOLE CARDS ***
Dealt to 2d0fdbda 
Dealt to ea0e3ba9 
Dealt to Hero [5h Jd]
Dealt to 582a39d0 
Dealt to c588248b 
Dealt to ed63ffb0 
582a39d0: folds
c588248b: folds
ed63ffb0: folds
2d0fdbda: raises $0.06 to $0.11
ea0e3ba9: calls $0.09
Hero: folds
*** FLOP *** [6d 4s 5c]
ea0e3ba9: checks
2d0fdbda: checks
*** TURN *** [6d 4s 5c] [Kh]
ea0e3ba9: checks
2d0fdbda: bets $0.09
ea0e3ba9: calls $0.09
*** RIVER *** [6d 4s 5c Kh] [Td]
ea0e3ba9: checks
2d0fdbda: checks
ea0e3ba9: shows [2c 2d] (a pair of Twos)
2d0fdbda: shows [Qh Ad] (Ace high)
*** SHOWDOWN ***
ea0e3ba9 collected $0.43 from pot
*** SUMMARY ***
Total pot $0.45 | Rake $0.02 | Jackpot $0 | Bingo $0 | Fortune $0 | Tax $0
Board [6d 4s 5c Kh Td]
Seat 1: 2d0fdbda (button) showed [Qh Ad] and lost with Ace high
Seat 2: ea0e3ba9 (small blind) showed [2c 2d] and won ($0.43) with a pair of Twos
Seat 3: Hero (big blind) folded before Flop
Seat 4: 582a39d0 folded before Flop (didn't bet)
Seat 5: c588248b folded before Flop (didn't bet)
Seat 6: ed63ffb0 folded before Flop (didn't bet)


Poker Hand #RC3812535267: Hold'em No Limit ($0.02/$0.05) - 2025/08/16 23:52:27
Table 'RushAndCash1090527' 6-max Seat #1 is the button
Seat 1: c82cf0b1 ($5.35 in chips)
Seat 2: ca6a4ee8 ($12.62 in chips)
Seat 3: a80cc179 ($7.4 in chips)
Seat 4: cdb125d9 ($5.24 in chips)
Seat 5: Hero ($4.84 in chips)
Seat 6: af0142ec ($5 in chips)
ca6a4ee8: posts small blind $0.02
a80cc179: posts big blind $0.05
*** HOLE CARDS ***
Dealt to c82cf0b1 
Dealt to ca6a4ee8 
Dealt to a80cc179 
Dealt to cdb125d9 
Dealt to Hero [Kd 8d]
Dealt to af0142ec 
cdb125d9: folds
Hero: folds
af0142ec: folds
c82cf0b1: raises $0.08 to $0.13
ca6a4ee8: folds
a80cc179: calls $0.08
*** FLOP *** [6s 7d 5d]
a80cc179: checks
c82cf0b1: bets $0.1
a80cc179: calls $0.1
*** TURN *** [6s 7d 5d] [2c]
a80cc179: checks
c82cf0b1: checks
*** RIVER *** [6s 7d 5d 2c] [5c]
a80cc179: bets $0.16
c82cf0b1: calls $0.16
a80cc179: shows [3d 3s] (two pair, Fives and Threes)
c82cf0b1: shows [Ah 7s] (two pair, Sevens and Fives)
*** SHOWDOWN ***
c82cf0b1 collected $0.76 from pot
*** SUMMARY ***
Total pot $0.8 | Rake $0.04 | Jackpot $0 | Bingo $0 | Fortune $0 | Tax $0
Board [6s 7d 5d 2c 5c]
Seat 1: c82cf0b1 (button) showed [Ah 7s] and won ($0.76) with two pair, Sevens and Fives
Seat 2: ca6a4ee8 (small blind) folded before Flop
Seat 3: a80cc179 (big blind) showed [3d 3s] and lost with two pair, Fives and Threes
Seat 4: cdb125d9 folded before Flop (didn't bet)
Seat 5: Hero folded before Flop (didn't bet)
Seat 6: af0142ec folded before Flop (didn't bet)


Poker Hand #RC3812535103: Hold'em No Limit ($0.02/$0.05) - 2025/08/16 23:52:03
Table 'RushAndCash1090363' 6-max Seat #1 is the button
Seat 1: a5699d3d ($1.28 in chips)
Seat 2: Hero ($4.86 in chips)
Seat 3: 46068b1c ($16.49 in chips)
Seat 4: f3333abb ($5.53 in chips)
Seat 5: e465369f ($5.59 in chips)
Seat 6: 90083bbe ($7.05 in chips)
Hero: posts small blind $0.02
46068b1c: posts big blind $0.05
*** HOLE CARDS ***
Dealt to a5699d3d 
Dealt to Hero [9s 6h]
Dealt to 46068b1c 
Dealt to f3333abb 
Dealt to e465369f 
Dealt to 90083bbe 
f3333abb: folds
e465369f: folds
90083bbe: folds
a5699d3d: raises $1.23 to $1.28 and is all-in
Hero: folds
46068b1c: folds
Uncalled bet ($1.23) returned to a5699d3d
*** SHOWDOWN ***
a5699d3d collected $0.12 from pot
*** SUMMARY ***
Total pot $0.12 | Rake $0 | Jackpot $0 | Bingo $0 | Fortune $0 | Tax $0
Seat 1: a5699d3d (button) collected ($0.12)
Seat 2: Hero (small blind) folded before Flop
Seat 3: 46068b1c (big blind) folded before Flop
Seat 4: f3333abb folded before Flop (didn't bet)
Seat 5: e465369f folded before Flop (didn't bet)
Seat 6: 90083bbe folded before Flop (didn't bet)


Poker Hand #RC3812535075: Hold'em No Limit ($0.02/$0.05) - 2025/08/16 23:52:00
Table 'RushAndCash1090335' 6-max Seat #1 is the button
Seat 1: 45cd7959 ($6.11 in chips)
Seat 2: 8ca94ff2 ($18 in chips)
Seat 3: 657ae2a ($5.14 in chips)
Seat 4: Hero ($4.86 in chips)
Seat 5: 8dc01a90 ($7.65 in chips)
Seat 6: 36d9e9c ($5 in chips)
8ca94ff2: posts small blind $0.02
657ae2a: posts big blind $0.05
*** HOLE CARDS ***
Dealt to 45cd7959 
Dealt to 8ca94ff2 
Dealt to 657ae2a 
Dealt to Hero [Jh 6d]
Dealt to 8dc01a90 
Dealt to 36d9e9c 
Hero: folds
8dc01a90: raises $0.06 to $0.11
36d9e9c: folds
45cd7959: folds
8ca94ff2: folds
657ae2a: folds
Uncalled bet ($0.06) returned to 8dc01a90
*** SHOWDOWN ***
8dc01a90 collected $0.12 from pot
*** SUMMARY ***
Total pot $0.12 | Rake $0 | Jackpot $0 | Bingo $0 | Fortune $0 | Tax $0
Seat 1: 45cd7959 (button) folded before Flop (didn't bet)
Seat 2: 8ca94ff2 (small blind) folded before Flop
Seat 3: 657ae2a (big blind) folded before Flop
Seat 4: Hero folded before Flop (didn't bet)
Seat 5: 8dc01a90 collected ($0.12)
Seat 6: 36d9e9c folded before Flop (didn't bet)


Poker Hand #RC3812535031: Hold'em No Limit ($0.02/$0.05) - 2025/08/16 23:51:54
Table 'RushAndCash1090291' 6-max Seat #1 is the button
Seat 1: c610c0ae ($7.28 in chips)
Seat 2: Hero ($4.88 in chips)
Seat 3: 8ff382fa ($7.13 in chips)
Seat 4: dc9315ca ($6.08 in chips)
Seat 5: 4c48649e ($3.17 in chips)
Seat 6: 43f46220 ($3.97 in chips)
Hero: posts small blind $0.02
8ff382fa: posts big blind $0.05
*** HOLE CARDS ***
Dealt to c610c0ae 
Dealt to Hero [Js 2h]
Dealt to 8ff382fa 
Dealt to dc9315ca 
Dealt to 4c48649e 
Dealt to 43f46220 
dc9315ca: folds
4c48649e: raises $0.1 to $0.15
43f46220: raises $0.37 to $0.52
c610c0ae: folds
Hero: folds
8ff382fa: folds
4c48649e: folds
Uncalled bet ($0.37) returned to 43f46220
*** SHOWDOWN ***
43f46220 collected $0.36 from pot
*** SUMMARY ***
Total pot $0.37 | Rake $0.01 | Jackpot $0 | Bingo $0 | Fortune $0 | Tax $0
Seat 1: c610c0ae (button) folded before Flop (didn't bet)
Seat 2: Hero (small blind) folded before Flop
Seat 3: 8ff382fa (big blind) folded before Flop
Seat 4: dc9315ca folded before Flop (didn't bet)
Seat 5: 4c48649e folded before Flop
Seat 6: 43f46220 collected ($0.36)


Poker Hand #RC3812535003: Hold'em No Limit ($0.02/$0.05) - 2025/08/16 23:51:50
Table 'RushAndCash1090263' 6-max Seat #1 is the button
Seat 1: 5c8e0ee9 ($27.02 in chips)
Seat 2: 3c229011 ($3.26 in chips)
Seat 3: aa017242 ($11.22 in chips)
Seat 4: d5afdf2c ($19.06 in chips)
Seat 5: b3f9d067 ($21.83 in chips)
Seat 6: Hero ($4.88 in chips)
3c229011: posts small blind $0.02
aa017242: posts big blind $0.05
*** HOLE CARDS ***
Dealt to 5c8e0ee9 
Dealt to 3c229011 
Dealt to aa017242 
Dealt to d5afdf2c 
Dealt to b3f9d067 
Dealt to Hero [3h 7s]
d5afdf2c: folds
b3f9d067: folds
Hero: folds
5c8e0ee9: folds
3c229011: folds
Uncalled bet ($0.03) returned to aa017242
*** SHOWDOWN ***
aa017242 collected $0.04 from pot
*** SUMMARY ***
Total pot $0.04 | Rake $0 | Jackpot $0 | Bingo $0 | Fortune $0 | Tax $0
Seat 1: 5c8e0ee9 (button) folded before Flop (didn't bet)
Seat 2: 3c229011 (small blind) folded before Flop
Seat 3: aa017242 (big blind) collected ($0.04)
Seat 4: d5afdf2c folded before Flop (didn't bet)
Seat 5: b3f9d067 folded before Flop (didn't bet)
Seat 6: Hero folded before Flop (didn't bet)


Poker Hand #RC3812534945: Hold'em No Limit ($0.02/$0.05) - 2025/08/16 23:51:43
Table 'RushAndCash1090205' 6-max Seat #1 is the button
Seat 1: Hero ($4.88 in chips)
Seat 2: 6a4f4d32 ($14.07 in chips)
Seat 3: 313f90db ($5.07 in chips)
Seat 4: 35cab0e7 ($5.65 in chips)
Seat 5: 9eabef02 ($5.84 in chips)
Seat 6: cb2fdb7e ($16.17 in chips)
6a4f4d32: posts small blind $0.02
313f90db: posts big blind $0.05
*** HOLE CARDS ***
Dealt to Hero [Kh 5c]
Dealt to 6a4f4d32 
Dealt to 313f90db 
Dealt to 35cab0e7 
Dealt to 9eabef02 
Dealt to cb2fdb7e 
35cab0e7: folds
9eabef02: folds
cb2fdb7e: folds
Hero: folds
6a4f4d32: raises $0.09 to $0.14
313f90db: folds
Uncalled bet ($0.09) returned to 6a4f4d32
*** SHOWDOWN ***
6a4f4d32 collected $0.1 from pot
*** SUMMARY ***
Total pot $0.1 | Rake $0 | Jackpot $0 | Bingo $0 | Fortune $0 | Tax $0
Seat 1: Hero (button) folded before Flop (didn't bet)
Seat 2: 6a4f4d32 (small blind) collected ($0.1)
Seat 3: 313f90db (big blind) folded before Flop
Seat 4: 35cab0e7 folded before Flop (didn't bet)
Seat 5: 9eabef02 folded before Flop (didn't bet)
Seat 6: cb2fdb7e folded before Flop (didn't bet)


Poker Hand #RC3812484625: Hold'em No Limit ($0.02/$0.05) - 2025/08/16 23:50:59
Table 'RushAndCash1089885' 6-max Seat #1 is the button
Seat 1: 295f1f5d ($3.95 in chips)
Seat 2: 90140bf5 ($5 in chips)
Seat 3: Hero ($5 in chips)
Seat 4: 9eabef02 ($5.71 in chips)
Seat 5: 4d8a0ea9 ($5 in chips)
Seat 6: 72a16ce1 ($4.42 in chips)
90140bf5: posts small blind $0.02
Hero: posts big blind $0.05
*** HOLE CARDS ***
Dealt to 295f1f5d 
Dealt to 90140bf5 
Dealt to Hero [8h 9s]
Dealt to 9eabef02 
Dealt to 4d8a0ea9 
Dealt to 72a16ce1 
9eabef02: raises $0.07 to $0.12
4d8a0ea9: folds
72a16ce1: folds
295f1f5d: folds
90140bf5: folds
Hero: calls $0.07
*** FLOP *** [Kd 2c Ad]
Hero: checks
9eabef02: checks
*** TURN *** [Kd 2c Ad] [As]
Hero: checks
9eabef02: bets $0.11
Hero: folds
Uncalled bet ($0.11) returned to 9eabef02
*** SHOWDOWN ***
9eabef02 collected $0.25 from pot
*** SUMMARY ***
Total pot $0.26 | Rake $0.01 | Jackpot $0 | Bingo $0 | Fortune $0 | Tax $0
Board [Kd 2c Ad As]
Seat 1: 295f1f5d (button) folded before Flop (didn't bet)
Seat 2: 90140bf5 (small blind) folded before Flop
Seat 3: Hero (big blind) folded on the Turn
Seat 4: 9eabef02 won ($0.25)
Seat 5: 4d8a0ea9 folded before Flop (didn't bet)
Seat 6: 72a16ce1 folded before Flop (didn't bet)


Poker Hand #RC3812484601: Hold'em No Limit ($0.02/$0.05) - 2025/08/16 23:50:55
Table 'RushAndCash1089861' 6-max Seat #1 is the button
Seat 1: 940fc210 ($5.14 in chips)
Seat 2: cf8b8e7d ($4.16 in chips)
Seat 3: 90140bf5 ($5 in chips)
Seat 4: Hero ($5 in chips)
Seat 5: ca2c3937 ($8.02 in chips)
Seat 6: 7c40e4cb ($4.03 in chips)
cf8b8e7d: posts small blind $0.02
90140bf5: posts big blind $0.05
*** HOLE CARDS ***
Dealt to 940fc210 
Dealt to cf8b8e7d 
Dealt to 90140bf5 
Dealt to Hero [7d 8c]
Dealt to ca2c3937 
Dealt to 7c40e4cb 
Hero: folds
ca2c3937: folds
7c40e4cb: folds
940fc210: folds
cf8b8e7d: folds
Uncalled bet ($0.03) returned to 90140bf5
*** SHOWDOWN ***
90140bf5 collected $0.04 from pot
*** SUMMARY ***
Total pot $0.04 | Rake $0 | Jackpot $0 | Bingo $0 | Fortune $0 | Tax $0
Seat 1: 940fc210 (button) folded before Flop (didn't bet)
Seat 2: cf8b8e7d (small blind) folded before Flop
Seat 3: 90140bf5 (big blind) collected ($0.04)
Seat 4: Hero folded before Flop (didn't bet)
Seat 5: ca2c3937 folded before Flop (didn't bet)
Seat 6: 7c40e4cb folded before Flop (didn't bet)


Poker Hand #RC3812484525: Hold'em No Limit ($0.02/$0.05) - 2025/08/16 23:50:45
Table 'RushAndCash1089785' 6-max Seat #1 is the button
Seat 1: af0142ec ($5.12 in chips)
Seat 2: cc8eeda4 ($6.32 in chips)
Seat 3: Hero ($4.98 in chips)
Seat 4: 2e6cb799 ($9.81 in chips)
Seat 5: a4c0e017 ($12.7 in chips)
Seat 6: 24d280ec ($10.76 in chips)
cc8eeda4: posts small blind $0.02
Hero: posts big blind $0.05
*** HOLE CARDS ***
Dealt to af0142ec 
Dealt to cc8eeda4 
Dealt to Hero [6s 2s]
Dealt to 2e6cb799 
Dealt to a4c0e017 
Dealt to 24d280ec 
2e6cb799: folds
a4c0e017: folds
24d280ec: folds
af0142ec: folds
cc8eeda4: folds
Uncalled bet ($0.03) returned to Hero
*** SHOWDOWN ***
Hero collected $0.04 from pot
*** SUMMARY ***
Total pot $0.04 | Rake $0 | Jackpot $0 | Bingo $0 | Fortune $0 | Tax $0
Seat 1: af0142ec (button) folded before Flop (didn't bet)
Seat 2: cc8eeda4 (small blind) folded before Flop
Seat 3: Hero (big blind) collected ($0.04)
Seat 4: 2e6cb799 folded before Flop (didn't bet)
Seat 5: a4c0e017 folded before Flop (didn't bet)
Seat 6: 24d280ec folded before Flop (didn't bet)


Poker Hand #RC3812484499: Hold'em No Limit ($0.02/$0.05) - 2025/08/16 23:50:41
Table 'RushAndCash1089759' 6-max Seat #1 is the button
Seat 1: 91b20d07 ($9.54 in chips)
Seat 2: dbd8e180 ($5.02 in chips)
Seat 3: c48bc6c2 ($5.44 in chips)
Seat 4: 4bba4424 ($5.41 in chips)
Seat 5: b586bcc1 ($5 in chips)
Seat 6: Hero ($4.98 in chips)
dbd8e180: posts small blind $0.02
c48bc6c2: posts big blind $0.05
*** HOLE CARDS ***
Dealt to 91b20d07 
Dealt to dbd8e180 
Dealt to c48bc6c2 
Dealt to 4bba4424 
Dealt to b586bcc1 
Dealt to Hero [2s 2c]
4bba4424: folds
b586bcc1: folds
Hero: folds
91b20d07: folds
dbd8e180: raises $0.08 to $0.13
c48bc6c2: folds
Uncalled bet ($0.08) returned to dbd8e180
*** SHOWDOWN ***
dbd8e180 collected $0.1 from pot
*** SUMMARY ***
Total pot $0.1 | Rake $0 | Jackpot $0 | Bingo $0 | Fortune $0 | Tax $0
Seat 1: 91b20d07 (button) folded before Flop (didn't bet)
Seat 2: dbd8e180 (small blind) collected ($0.1)
Seat 3: c48bc6c2 (big blind) folded before Flop
Seat 4: 4bba4424 folded before Flop (didn't bet)
Seat 5: b586bcc1 folded before Flop (didn't bet)
Seat 6: Hero folded before Flop (didn't bet)


Poker Hand #RC3812484400: Hold'em No Limit ($0.02/$0.05) - 2025/08/16 23:50:27
Table 'RushAndCash1089660' 6-max Seat #1 is the button
Seat 1: bc28ebe8 ($9.88 in chips)
Seat 2: Hero ($5 in chips)
Seat 3: 2cb5ed63 ($7.58 in chips)
Seat 4: 61fde3d6 ($17.82 in chips)
Seat 5: e07eff7a ($4.93 in chips)
Seat 6: 55f6b164 ($5.42 in chips)
Hero: posts small blind $0.02
2cb5ed63: posts big blind $0.05
*** HOLE CARDS ***
Dealt to bc28ebe8 
Dealt to Hero [Qs 3d]
Dealt to 2cb5ed63 
Dealt to 61fde3d6 
Dealt to e07eff7a 
Dealt to 55f6b164 
61fde3d6: folds
e07eff7a: raises $0.05 to $0.1
55f6b164: folds
bc28ebe8: folds
Hero: folds
2cb5ed63: folds
Uncalled bet ($0.05) returned to e07eff7a
*** SHOWDOWN ***
e07eff7a collected $0.12 from pot
*** SUMMARY ***
Total pot $0.12 | Rake $0 | Jackpot $0 | Bingo $0 | Fortune $0 | Tax $0
Seat 1: bc28ebe8 (button) folded before Flop (didn't bet)
Seat 2: Hero (small blind) folded before Flop
Seat 3: 2cb5ed63 (big blind) folded before Flop
Seat 4: 61fde3d6 folded before Flop (didn't bet)
Seat 5: e07eff7a collected ($0.12)
Seat 6: 55f6b164 folded before Flop (didn't bet)


Poker Hand #RC3812484284: Hold'em No Limit ($0.02/$0.05) - 2025/08/16 23:50:11
Table 'RushAndCash1089544' 6-max Seat #1 is the button
Seat 1: Hero ($4.93 in chips)
Seat 2: 313f90db ($5 in chips)
Seat 3: f17584e2 ($10.06 in chips)
Seat 4: c82cf0b1 ($5.21 in chips)
Seat 5: e07eff7a ($5 in chips)
Seat 6: 6a4f4d32 ($14.02 in chips)
313f90db: posts small blind $0.02
f17584e2: posts big blind $0.05
*** HOLE CARDS ***
Dealt to Hero [Ad Js]
Dealt to 313f90db 
Dealt to f17584e2 
Dealt to c82cf0b1 
Dealt to e07eff7a 
Dealt to 6a4f4d32 
c82cf0b1: folds
e07eff7a: folds
6a4f4d32: folds
Hero: raises $0.05 to $0.1
313f90db: folds
f17584e2: folds
Uncalled bet ($0.05) returned to Hero
*** SHOWDOWN ***
Hero collected $0.12 from pot
*** SUMMARY ***
Total pot $0.12 | Rake $0 | Jackpot $0 | Bingo $0 | Fortune $0 | Tax $0
Seat 1: Hero (button) collected ($0.12)
Seat 2: 313f90db (small blind) folded before Flop
Seat 3: f17584e2 (big blind) folded before Flop
Seat 4: c82cf0b1 folded before Flop (didn't bet)
Seat 5: e07eff7a folded before Flop (didn't bet)
Seat 6: 6a4f4d32 folded before Flop (didn't bet)


Poker Hand #RC3812484257: Hold'em No Limit ($0.02/$0.05) - 2025/08/16 23:50:07
Table 'RushAndCash1089517' 6-max Seat #1 is the button
Seat 1: c8cb489c ($5.89 in chips)
Seat 2: 2333ebc5 ($5 in chips)
Seat 3: cd335107 ($17.7 in chips)
Seat 4: Hero ($4.93 in chips)
Seat 5: cdb125d9 ($5.69 in chips)
Seat 6: 761d22e0 ($4.4 in chips)
2333ebc5: posts small blind $0.02
cd335107: posts big blind $0.05
*** HOLE CARDS ***
Dealt to c8cb489c 
Dealt to 2333ebc5 
Dealt to cd335107 
Dealt to Hero [Tc 8s]
Dealt to cdb125d9 
Dealt to 761d22e0 
Hero: folds
cdb125d9: folds
761d22e0: folds
c8cb489c: folds
2333ebc5: folds
Uncalled bet ($0.03) returned to cd335107
*** SHOWDOWN ***
cd335107 collected $0.04 from pot
*** SUMMARY ***
Total pot $0.04 | Rake $0 | Jackpot $0 | Bingo $0 | Fortune $0 | Tax $0
Seat 1: c8cb489c (button) folded before Flop (didn't bet)
Seat 2: 2333ebc5 (small blind) folded before Flop
Seat 3: cd335107 (big blind) collected ($0.04)
Seat 4: Hero folded before Flop (didn't bet)
Seat 5: cdb125d9 folded before Flop (didn't bet)
Seat 6: 761d22e0 folded before Flop (didn't bet)


Poker Hand #RC3812484231: Hold'em No Limit ($0.02/$0.05) - 2025/08/16 23:50:04
Table 'RushAndCash1089491' 6-max Seat #1 is the button
Seat 1: fa9946db ($6.41 in chips)
Seat 2: c8cb489c ($5.91 in chips)
Seat 3: ea6a576c ($5.4 in chips)
Seat 4: 15497d8b ($5.19 in chips)
Seat 5: Hero ($4.93 in chips)
Seat 6: 761d22e0 ($4.4 in chips)
c8cb489c: posts small blind $0.02
ea6a576c: posts big blind $0.05
*** HOLE CARDS ***
Dealt to fa9946db 
Dealt to c8cb489c 
Dealt to ea6a576c 
Dealt to 15497d8b 
Dealt to Hero [4c Td]
Dealt to 761d22e0 
15497d8b: folds
Hero: folds
761d22e0: folds
fa9946db: raises $0.1 to $0.15
c8cb489c: folds
ea6a576c: folds
Uncalled bet ($0.1) returned to fa9946db
*** SHOWDOWN ***
fa9946db collected $0.12 from pot
*** SUMMARY ***
Total pot $0.12 | Rake $0 | Jackpot $0 | Bingo $0 | Fortune $0 | Tax $0
Seat 1: fa9946db (button) collected ($0.12)
Seat 2: c8cb489c (small blind) folded before Flop
Seat 3: ea6a576c (big blind) folded before Flop
Seat 4: 15497d8b folded before Flop (didn't bet)
Seat 5: Hero folded before Flop (didn't bet)
Seat 6: 761d22e0 folded before Flop (didn't bet)


Poker Hand #RC3812484031: Hold'em No Limit ($0.02/$0.05) - 2025/08/16 23:49:36
Table 'RushAndCash1089291' 6-max Seat #1 is the button
Seat 1: 2cbcbc97 ($5 in chips)
Seat 2: 81cb99ac ($5.67 in chips)
Seat 3: db3f59ad ($5 in chips)
Seat 4: b2a9244e ($6.16 in chips)
Seat 5: a5c52ba3 ($14.17 in chips)
Seat 6: Hero ($4.86 in chips)
81cb99ac: posts small blind $0.02
db3f59ad: posts big blind $0.05
*** HOLE CARDS ***
Dealt to 2cbcbc97 
Dealt to 81cb99ac 
Dealt to db3f59ad 
Dealt to b2a9244e 
Dealt to a5c52ba3 
Dealt to Hero [Ah 9h]
b2a9244e: folds
a5c52ba3: folds
Hero: raises $0.05 to $0.1
2cbcbc97: folds
81cb99ac: folds
db3f59ad: folds
Uncalled bet ($0.05) returned to Hero
*** SHOWDOWN ***
Hero collected $0.12 from pot
*** SUMMARY ***
Total pot $0.12 | Rake $0 | Jackpot $0 | Bingo $0 | Fortune $0 | Tax $0
Seat 1: 2cbcbc97 (button) folded before Flop (didn't bet)
Seat 2: 81cb99ac (small blind) folded before Flop
Seat 3: db3f59ad (big blind) folded before Flop
Seat 4: b2a9244e folded before Flop (didn't bet)
Seat 5: a5c52ba3 folded before Flop (didn't bet)
Seat 6: Hero collected ($0.12)


Poker Hand #RC3812484003: Hold'em No Limit ($0.02/$0.05) - 2025/08/16 23:49:32
Table 'RushAndCash1089263' 6-max Seat #1 is the button
Seat 1: 313f90db ($5 in chips)
Seat 2: 1d487da4 ($8.55 in chips)
Seat 3: cda26e4a ($12.06 in chips)
Seat 4: Hero ($4.86 in chips)
Seat 5: aa707f38 ($5.21 in chips)
Seat 6: 40970e63 ($5.01 in chips)
1d487da4: posts small blind $0.02
cda26e4a: posts big blind $0.05
*** HOLE CARDS ***
Dealt to 313f90db 
Dealt to 1d487da4 
Dealt to cda26e4a 
Dealt to Hero [Qs 7d]
Dealt to aa707f38 
Dealt to 40970e63 
Hero: folds
aa707f38: folds
40970e63: raises $0.05 to $0.1
313f90db: folds
1d487da4: folds
cda26e4a: folds
Uncalled bet ($0.05) returned to 40970e63
*** SHOWDOWN ***
40970e63 collected $0.12 from pot
*** SUMMARY ***
Total pot $0.12 | Rake $0 | Jackpot $0 | Bingo $0 | Fortune $0 | Tax $0
Seat 1: 313f90db (button) folded before Flop (didn't bet)
Seat 2: 1d487da4 (small blind) folded before Flop
Seat 3: cda26e4a (big blind) folded before Flop
Seat 4: Hero folded before Flop (didn't bet)
Seat 5: aa707f38 folded before Flop (didn't bet)
Seat 6: 40970e63 collected ($0.12)


Poker Hand #RC3812483864: Hold'em No Limit ($0.02/$0.05) - 2025/08/16 23:49:13
Table 'RushAndCash1089124' 6-max Seat #1 is the button
Seat 1: 198a273d ($5.12 in chips)
Seat 2: b7fa0280 ($6.49 in chips)
Seat 3: 8672b474 ($6.31 in chips)
Seat 4: d140874d ($12.08 in chips)
Seat 5: fed1995e ($4.93 in chips)
Seat 6: Hero ($4.79 in chips)
b7fa0280: posts small blind $0.02
8672b474: posts big blind $0.05
*** HOLE CARDS ***
Dealt to 198a273d 
Dealt to b7fa0280 
Dealt to 8672b474 
Dealt to d140874d 
Dealt to fed1995e 
Dealt to Hero [Ad Jd]
d140874d: folds
fed1995e: folds
Hero: raises $0.05 to $0.1
198a273d: folds
b7fa0280: folds
8672b474: folds
Uncalled bet ($0.05) returned to Hero
*** SHOWDOWN ***
Hero collected $0.12 from pot
*** SUMMARY ***
Total pot $0.12 | Rake $0 | Jackpot $0 | Bingo $0 | Fortune $0 | Tax $0
Seat 1: 198a273d (button) folded before Flop (didn't bet)
Seat 2: b7fa0280 (small blind) folded before Flop
Seat 3: 8672b474 (big blind) folded before Flop
Seat 4: d140874d folded before Flop (didn't bet)
Seat 5: fed1995e folded before Flop (didn't bet)
Seat 6: Hero collected ($0.12)


Poker Hand #RC3812483355: Hold'em No Limit ($0.02/$0.05) - 2025/08/16 23:48:05
Table 'RushAndCash1088615' 6-max Seat #1 is the button
Seat 1: 41556454 ($5.47 in chips)
Seat 2: Hero ($4.9 in chips)
Seat 3: 4070b64e ($1.93 in chips)
Seat 4: 677d66f ($3.96 in chips)
Seat 5: b7fa0280 ($6.34 in chips)
Seat 6: f371662d ($9.19 in chips)
Hero: posts small blind $0.02
4070b64e: posts big blind $0.05
*** HOLE CARDS ***
Dealt to 41556454 
Dealt to Hero [3h 3c]
Dealt to 4070b64e 
Dealt to 677d66f 
Dealt to b7fa0280 
Dealt to f371662d 
677d66f: folds
b7fa0280: raises $0.06 to $0.11
f371662d: folds
41556454: folds
Hero: calls $0.09
4070b64e: folds
*** FLOP *** [2c Ad 7h]
Hero: checks
b7fa0280: checks
*** TURN *** [2c Ad 7h] [8s]
Hero: checks
b7fa0280: bets $0.1
Hero: folds
Uncalled bet ($0.1) returned to b7fa0280
*** SHOWDOWN ***
b7fa0280 collected $0.26 from pot
*** SUMMARY ***
Total pot $0.27 | Rake $0.01 | Jackpot $0 | Bingo $0 | Fortune $0 | Tax $0
Board [2c Ad 7h 8s]
Seat 1: 41556454 (button) folded before Flop (didn't bet)
Seat 2: Hero (small blind) folded on the Turn
Seat 3: 4070b64e (big blind) folded before Flop
Seat 4: 677d66f folded before Flop (didn't bet)
Seat 5: b7fa0280 won ($0.26)
Seat 6: f371662d folded before Flop (didn't bet)


Poker Hand #RC3812482820: Hold'em No Limit ($0.02/$0.05) - 2025/08/16 23:46:58
Table 'RushAndCash1088080' 6-max Seat #1 is the button
Seat 1: 4c48649e ($2.05 in chips)
Seat 2: b8a1bc13 ($7.05 in chips)
Seat 3: Hero ($5.16 in chips)
Seat 4: 16cda9e5 ($5 in chips)
Seat 5: 455bcc0e ($5.81 in chips)
Seat 6: 3f39a0dc ($15.69 in chips)
b8a1bc13: posts small blind $0.02
Hero: posts big blind $0.05
*** HOLE CARDS ***
Dealt to 4c48649e 
Dealt to b8a1bc13 
Dealt to Hero [9c Ac]
Dealt to 16cda9e5 
Dealt to 455bcc0e 
Dealt to 3f39a0dc 
16cda9e5: folds
455bcc0e: folds
3f39a0dc: folds
4c48649e: raises $0.1 to $0.15
b8a1bc13: folds
Hero: calls $0.1
*** FLOP *** [Qh 6s Jc]
Hero: checks
4c48649e: bets $0.11
Hero: calls $0.11
*** TURN *** [Qh 6s Jc] [7h]
Hero: checks
4c48649e: checks
*** RIVER *** [Qh 6s Jc 7h] [6c]
Hero: checks
4c48649e: bets $0.54
Hero: folds
Uncalled bet ($0.54) returned to 4c48649e
*** SHOWDOWN ***
4c48649e collected $0.52 from pot
*** SUMMARY ***
Total pot $0.54 | Rake $0.02 | Jackpot $0 | Bingo $0 | Fortune $0 | Tax $0
Board [Qh 6s Jc 7h 6c]
Seat 1: 4c48649e (button) won ($0.52)
Seat 2: b8a1bc13 (small blind) folded before Flop
Seat 3: Hero (big blind) folded on the River
Seat 4: 16cda9e5 folded before Flop (didn't bet)
Seat 5: 455bcc0e folded before Flop (didn't bet)
Seat 6: 3f39a0dc folded before Flop (didn't bet)


Poker Hand #RC3812482725: Hold'em No Limit ($0.02/$0.05) - 2025/08/16 23:46:46
Table 'RushAndCash1087985' 6-max Seat #1 is the button
Seat 1: 2bd8297a ($3.91 in chips)
Seat 2: fe7b6407 ($13.25 in chips)
Seat 3: ed3d936d ($5 in chips)
Seat 4: Hero ($5.09 in chips)
Seat 5: 41556454 ($5.28 in chips)
Seat 6: 5cdf19ec ($10.86 in chips)
fe7b6407: posts small blind $0.02
ed3d936d: posts big blind $0.05
*** HOLE CARDS ***
Dealt to 2bd8297a 
Dealt to fe7b6407 
Dealt to ed3d936d 
Dealt to Hero [9h 9s]
Dealt to 41556454 
Dealt to 5cdf19ec 
Hero: raises $0.05 to $0.1
41556454: folds
5cdf19ec: folds
2bd8297a: folds
fe7b6407: folds
ed3d936d: folds
Uncalled bet ($0.05) returned to Hero
*** SHOWDOWN ***
Hero collected $0.12 from pot
*** SUMMARY ***
Total pot $0.12 | Rake $0 | Jackpot $0 | Bingo $0 | Fortune $0 | Tax $0
Seat 1: 2bd8297a (button) folded before Flop (didn't bet)
Seat 2: fe7b6407 (small blind) folded before Flop
Seat 3: ed3d936d (big blind) folded before Flop
Seat 4: Hero collected ($0.12)
Seat 5: 41556454 folded before Flop (didn't bet)
Seat 6: 5cdf19ec folded before Flop (didn't bet)


Poker Hand #RC3812482699: Hold'em No Limit ($0.02/$0.05) - 2025/08/16 23:46:43
Table 'RushAndCash1087959' 6-max Seat #1 is the button
Seat 1: 6ec47996 ($5.26 in chips)
Seat 2: cf48655c ($5.71 in chips)
Seat 3: 91b20d07 ($8.33 in chips)
Seat 4: 65a6162b ($10.62 in chips)
Seat 5: b765e623 ($5 in chips)
Seat 6: Hero ($5.09 in chips)
cf48655c: posts small blind $0.02
91b20d07: posts big blind $0.05
*** HOLE CARDS ***
Dealt to 6ec47996 
Dealt to cf48655c 
Dealt to 91b20d07 
Dealt to 65a6162b 
Dealt to b765e623 
Dealt to Hero [6d Jc]
65a6162b: folds
b765e623: folds
Hero: folds
6ec47996: folds
cf48655c: folds
Uncalled bet ($0.03) returned to 91b20d07
*** SHOWDOWN ***
91b20d07 collected $0.04 from pot
*** SUMMARY ***
Total pot $0.04 | Rake $0 | Jackpot $0 | Bingo $0 | Fortune $0 | Tax $0
Seat 1: 6ec47996 (button) folded before Flop (didn't bet)
Seat 2: cf48655c (small blind) folded before Flop
Seat 3: 91b20d07 (big blind) collected ($0.04)
Seat 4: 65a6162b folded before Flop (didn't bet)
Seat 5: b765e623 folded before Flop (didn't bet)
Seat 6: Hero folded before Flop (didn't bet)


Poker Hand #RC3812482616: Hold'em No Limit ($0.02/$0.05) - 2025/08/16 23:46:31
Table 'RushAndCash1087876' 6-max Seat #1 is the button
Seat 1: Hero ($5.09 in chips)
Seat 2: 20b73fab ($6.46 in chips)
Seat 3: 4c612f15 ($37.82 in chips)
Seat 4: 2faeddae ($5 in chips)
Seat 5: b12df020 ($5.3 in chips)
Seat 6: cb37c07c ($6.2 in chips)
20b73fab: posts small blind $0.02
4c612f15: posts big blind $0.05
*** HOLE CARDS ***
Dealt to Hero [8s Qh]
Dealt to 20b73fab 
Dealt to 4c612f15 
Dealt to 2faeddae 
Dealt to b12df020 
Dealt to cb37c07c 
2faeddae: folds
b12df020: folds
cb37c07c: folds
Hero: folds
20b73fab: folds
Uncalled bet ($0.03) returned to 4c612f15
*** SHOWDOWN ***
4c612f15 collected $0.04 from pot
*** SUMMARY ***
Total pot $0.04 | Rake $0 | Jackpot $0 | Bingo $0 | Fortune $0 | Tax $0
Seat 1: Hero (button) folded before Flop (didn't bet)
Seat 2: 20b73fab (small blind) folded before Flop
Seat 3: 4c612f15 (big blind) collected ($0.04)
Seat 4: 2faeddae folded before Flop (didn't bet)
Seat 5: b12df020 folded before Flop (didn't bet)
Seat 6: cb37c07c folded before Flop (didn't bet)


Poker Hand #RC3812482588: Hold'em No Limit ($0.02/$0.05) - 2025/08/16 23:46:28
Table 'RushAndCash1087848' 6-max Seat #1 is the button
Seat 1: 84afc5c7 ($6.71 in chips)
Seat 2: 3101bb8a ($10.25 in chips)
Seat 3: 45bc7423 ($5.01 in chips)
Seat 4: 1faf0c0f ($9.13 in chips)
Seat 5: Hero ($5.09 in chips)
Seat 6: 20b73fab ($6.46 in chips)
3101bb8a: posts small blind $0.02
45bc7423: posts big blind $0.05
*** HOLE CARDS ***
Dealt to 84afc5c7 
Dealt to 3101bb8a 
Dealt to 45bc7423 
Dealt to 1faf0c0f 
Dealt to Hero [Jd 2h]
Dealt to 20b73fab 
1faf0c0f: folds
Hero: folds
20b73fab: folds
84afc5c7: folds
3101bb8a: raises $0.08 to $0.13
45bc7423: calls $0.08
*** FLOP *** [5s 5h 4c]
3101bb8a: checks
45bc7423: checks
*** TURN *** [5s 5h 4c] [Tc]
3101bb8a: bets $0.13
45bc7423: folds
Uncalled bet ($0.13) returned to 3101bb8a
*** SHOWDOWN ***
3101bb8a collected $0.25 from pot
*** SUMMARY ***
Total pot $0.26 | Rake $0.01 | Jackpot $0 | Bingo $0 | Fortune $0 | Tax $0
Board [5s 5h 4c Tc]
Seat 1: 84afc5c7 (button) folded before Flop (didn't bet)
Seat 2: 3101bb8a (small blind) won ($0.25)
Seat 3: 45bc7423 (big blind) folded on the Turn
Seat 4: 1faf0c0f folded before Flop (didn't bet)
Seat 5: Hero folded before Flop (didn't bet)
Seat 6: 20b73fab folded before Flop (didn't bet)


Poker Hand #RC3812482444: Hold'em No Limit ($0.02/$0.05) - 2025/08/16 23:46:09
Table 'RushAndCash1087704' 6-max Seat #1 is the button
Seat 1: c6cd789b ($5.09 in chips)
Seat 2: Hero ($5.04 in chips)
Seat 3: 4b5dfc09 ($5.37 in chips)
Seat 4: 2e6cb799 ($5.07 in chips)
Seat 5: 8d9e764d ($5.45 in chips)
Seat 6: a3ad240e ($18.97 in chips)
Hero: posts small blind $0.02
4b5dfc09: posts big blind $0.05
*** HOLE CARDS ***
Dealt to c6cd789b 
Dealt to Hero [Js Ah]
Dealt to 4b5dfc09 
Dealt to 2e6cb799 
Dealt to 8d9e764d 
Dealt to a3ad240e 
2e6cb799: folds
8d9e764d: folds
a3ad240e: folds
c6cd789b: folds
Hero: raises $0.05 to $0.1
4b5dfc09: folds
Uncalled bet ($0.05) returned to Hero
*** SHOWDOWN ***
Hero collected $0.1 from pot
*** SUMMARY ***
Total pot $0.1 | Rake $0 | Jackpot $0 | Bingo $0 | Fortune $0 | Tax $0
Seat 1: c6cd789b (button) folded before Flop (didn't bet)
Seat 2: Hero (small blind) collected ($0.1)
Seat 3: 4b5dfc09 (big blind) folded before Flop
Seat 4: 2e6cb799 folded before Flop (didn't bet)
Seat 5: 8d9e764d folded before Flop (didn't bet)
Seat 6: a3ad240e folded before Flop (didn't bet)


Poker Hand #RC3812482417: Hold'em No Limit ($0.02/$0.05) - 2025/08/16 23:46:05
Table 'RushAndCash1087677' 6-max Seat #1 is the button
Seat 1: Hero ($5.04 in chips)
Seat 2: 3c11c1fd ($6.46 in chips)
Seat 3: e14f293 ($5.31 in chips)
Seat 4: ebea61cd ($5 in chips)
Seat 5: 4f15238c ($9.61 in chips)
Seat 6: d140874d ($12.57 in chips)
3c11c1fd: posts small blind $0.02
e14f293: posts big blind $0.05
*** HOLE CARDS ***
Dealt to Hero [2d 8c]
Dealt to 3c11c1fd 
Dealt to e14f293 
Dealt to ebea61cd 
Dealt to 4f15238c 
Dealt to d140874d 
ebea61cd: folds
4f15238c: raises $0.05 to $0.1
d140874d: folds
Hero: folds
3c11c1fd: folds
e14f293: raises $0.18 to $0.28
4f15238c: folds
Uncalled bet ($0.18) returned to e14f293
*** SHOWDOWN ***
e14f293 collected $0.21 from pot
*** SUMMARY ***
Total pot $0.22 | Rake $0.01 | Jackpot $0 | Bingo $0 | Fortune $0 | Tax $0
Seat 1: Hero (button) folded before Flop (didn't bet)
Seat 2: 3c11c1fd (small blind) folded before Flop
Seat 3: e14f293 (big blind) collected ($0.21)
Seat 4: ebea61cd folded before Flop (didn't bet)
Seat 5: 4f15238c folded before Flop
Seat 6: d140874d folded before Flop (didn't bet)


Poker Hand #RC3812482345: Hold'em No Limit ($0.02/$0.05) - 2025/08/16 23:45:56
Table 'RushAndCash1087605' 6-max Seat #1 is the button
Seat 1: 250af0bc ($1.86 in chips)
Seat 2: cca18c03 ($5.05 in chips)
Seat 3: Hero ($5.02 in chips)
Seat 4: 22546549 ($8.23 in chips)
Seat 5: 84412c1e ($9.29 in chips)
Seat 6: 617766ca ($22.94 in chips)
cca18c03: posts small blind $0.02
Hero: posts big blind $0.05
*** HOLE CARDS ***
Dealt to 250af0bc 
Dealt to cca18c03 
Dealt to Hero [4s Jc]
Dealt to 22546549 
Dealt to 84412c1e 
Dealt to 617766ca 
22546549: folds
84412c1e: folds
617766ca: folds
250af0bc: folds
cca18c03: folds
Uncalled bet ($0.03) returned to Hero
*** SHOWDOWN ***
Hero collected $0.04 from pot
*** SUMMARY ***
Total pot $0.04 | Rake $0 | Jackpot $0 | Bingo $0 | Fortune $0 | Tax $0
Seat 1: 250af0bc (button) folded before Flop (didn't bet)
Seat 2: cca18c03 (small blind) folded before Flop
Seat 3: Hero (big blind) collected ($0.04)
Seat 4: 22546549 folded before Flop (didn't bet)
Seat 5: 84412c1e folded before Flop (didn't bet)
Seat 6: 617766ca folded before Flop (didn't bet)


Poker Hand #RC3812482318: Hold'em No Limit ($0.02/$0.05) - 2025/08/16 23:45:52
Table 'RushAndCash1087578' 6-max Seat #1 is the button
Seat 1: af1959ee ($1.16 in chips)
Seat 2: 5682dfc7 ($8.12 in chips)
Seat 3: adc4285d ($8.89 in chips)
Seat 4: 5b5c342c ($4.92 in chips)
Seat 5: Hero ($5.02 in chips)
Seat 6: a575ad76 ($16.31 in chips)
5682dfc7: posts small blind $0.02
adc4285d: posts big blind $0.05
*** HOLE CARDS ***
Dealt to af1959ee 
Dealt to 5682dfc7 
Dealt to adc4285d 
Dealt to 5b5c342c 
Dealt to Hero [Jh 8c]
Dealt to a575ad76 
5b5c342c: folds
Hero: folds
a575ad76: folds
af1959ee: raises $0.1 to $0.15
5682dfc7: folds
adc4285d: calls $0.1
*** FLOP *** [4s 4c 9d]
adc4285d: checks
af1959ee: bets $0.16
adc4285d: calls $0.16
*** TURN *** [4s 4c 9d] [8h]
adc4285d: checks
af1959ee: bets $0.48
adc4285d: folds
Uncalled bet ($0.48) returned to af1959ee
*** SHOWDOWN ***
af1959ee collected $0.61 from pot
*** SUMMARY ***
Total pot $0.64 | Rake $0.03 | Jackpot $0 | Bingo $0 | Fortune $0 | Tax $0
Board [4s 4c 9d 8h]
Seat 1: af1959ee (button) won ($0.61)
Seat 2: 5682dfc7 (small blind) folded before Flop
Seat 3: adc4285d (big blind) folded on the Turn
Seat 4: 5b5c342c folded before Flop (didn't bet)
Seat 5: Hero folded before Flop (didn't bet)
Seat 6: a575ad76 folded before Flop (didn't bet)


Poker Hand #RC3812482290: Hold'em No Limit ($0.02/$0.05) - 2025/08/16 23:45:49
Table 'RushAndCash1087550' 6-max Seat #1 is the button
Seat 1: 2f31390d ($6.61 in chips)
Seat 2: 3dd3abca ($11.75 in chips)
Seat 3: b60268af ($6.4 in chips)
Seat 4: Hero ($5.02 in chips)
Seat 5: 58a9ed38 ($5.23 in chips)
Seat 6: fb054031 ($5.15 in chips)
3dd3abca: posts small blind $0.02
b60268af: posts big blind $0.05
*** HOLE CARDS ***
Dealt to 2f31390d 
Dealt to 3dd3abca 
Dealt to b60268af 
Dealt to Hero [6c Qh]
Dealt to 58a9ed38 
Dealt to fb054031 
Hero: folds
58a9ed38: folds
fb054031: raises $0.05 to $0.1
2f31390d: folds
3dd3abca: folds
b60268af: folds
Uncalled bet ($0.05) returned to fb054031
*** SHOWDOWN ***
fb054031 collected $0.12 from pot
*** SUMMARY ***
Total pot $0.12 | Rake $0 | Jackpot $0 | Bingo $0 | Fortune $0 | Tax $0
Seat 1: 2f31390d (button) folded before Flop (didn't bet)
Seat 2: 3dd3abca (small blind) folded before Flop
Seat 3: b60268af (big blind) folded before Flop
Seat 4: Hero folded before Flop (didn't bet)
Seat 5: 58a9ed38 folded before Flop (didn't bet)
Seat 6: fb054031 collected ($0.12)


Poker Hand #RC3812482221: Hold'em No Limit ($0.02/$0.05) - 2025/08/16 23:45:40
Table 'RushAndCash1087481' 6-max Seat #1 is the button
Seat 1: a4f04bf ($5.37 in chips)
Seat 2: 5a08e89d ($12.94 in chips)
Seat 3: Hero ($5 in chips)
Seat 4: 32bb44b5 ($2.97 in chips)
Seat 5: b8a1bc13 ($7.24 in chips)
Seat 6: c6cd789b ($5.16 in chips)
5a08e89d: posts small blind $0.02
Hero: posts big blind $0.05
*** HOLE CARDS ***
Dealt to a4f04bf 
Dealt to 5a08e89d 
Dealt to Hero [Kc 7d]
Dealt to 32bb44b5 
Dealt to b8a1bc13 
Dealt to c6cd789b 
32bb44b5: folds
b8a1bc13: folds
c6cd789b: folds
a4f04bf: folds
5a08e89d: folds
Uncalled bet ($0.03) returned to Hero
*** SHOWDOWN ***
Hero collected $0.04 from pot
*** SUMMARY ***
Total pot $0.04 | Rake $0 | Jackpot $0 | Bingo $0 | Fortune $0 | Tax $0
Seat 1: a4f04bf (button) folded before Flop (didn't bet)
Seat 2: 5a08e89d (small blind) folded before Flop
Seat 3: Hero (big blind) collected ($0.04)
Seat 4: 32bb44b5 folded before Flop (didn't bet)
Seat 5: b8a1bc13 folded before Flop (didn't bet)
Seat 6: c6cd789b folded before Flop (didn't bet)


Poker Hand #RC3812482176: Hold'em No Limit ($0.02/$0.05) - 2025/08/16 23:45:34
Table 'RushAndCash1087436' 6-max Seat #1 is the button
Seat 1: Hero ($3.72 in chips)
Seat 2: 72a16ce1 ($4.51 in chips)
Seat 3: 4b16f16b ($5.33 in chips)
Seat 4: ce835e9f ($5.6 in chips)
Seat 5: d26eadab ($5.23 in chips)
Seat 6: 2cd181a6 ($11.18 in chips)
72a16ce1: posts small blind $0.02
4b16f16b: posts big blind $0.05
*** HOLE CARDS ***
Dealt to Hero [Kd 2c]
Dealt to 72a16ce1 
Dealt to 4b16f16b 
Dealt to ce835e9f 
Dealt to d26eadab 
Dealt to 2cd181a6 
ce835e9f: folds
d26eadab: folds
2cd181a6: folds
Hero: folds
72a16ce1: raises $0.05 to $0.1
4b16f16b: folds
Uncalled bet ($0.05) returned to 72a16ce1
*** SHOWDOWN ***
72a16ce1 collected $0.1 from pot
*** SUMMARY ***
Total pot $0.1 | Rake $0 | Jackpot $0 | Bingo $0 | Fortune $0 | Tax $0
Seat 1: Hero (button) folded before Flop (didn't bet)
Seat 2: 72a16ce1 (small blind) collected ($0.1)
Seat 3: 4b16f16b (big blind) folded before Flop
Seat 4: ce835e9f folded before Flop (didn't bet)
Seat 5: d26eadab folded before Flop (didn't bet)
Seat 6: 2cd181a6 folded before Flop (didn't bet)


Poker Hand #RC3812482146: Hold'em No Limit ($0.02/$0.05) - 2025/08/16 23:45:31
Table 'RushAndCash1087406' 6-max Seat #1 is the button
Seat 1: ce835e9f ($5.6 in chips)
Seat 2: 8009f39b ($19.78 in chips)
Seat 3: dcc428e3 ($6.32 in chips)
Seat 4: Hero ($3.72 in chips)
Seat 5: d3b0f7d7 ($4.33 in chips)
Seat 6: 412d38da ($3.33 in chips)
8009f39b: posts small blind $0.02
dcc428e3: posts big blind $0.05
*** HOLE CARDS ***
Dealt to ce835e9f 
Dealt to 8009f39b 
Dealt to dcc428e3 
Dealt to Hero [8d Ah]
Dealt to d3b0f7d7 
Dealt to 412d38da 
Hero: folds
d3b0f7d7: calls $0.05
412d38da: folds
ce835e9f: folds
8009f39b: folds
dcc428e3: checks
*** FLOP *** [Tc Kh Qc]
dcc428e3: checks
d3b0f7d7: checks
*** TURN *** [Tc Kh Qc] [2s]
dcc428e3: checks
d3b0f7d7: bets $0.05
dcc428e3: folds
Uncalled bet ($0.05) returned to d3b0f7d7
*** SHOWDOWN ***
d3b0f7d7 collected $0.12 from pot
*** SUMMARY ***
Total pot $0.12 | Rake $0 | Jackpot $0 | Bingo $0 | Fortune $0 | Tax $0
Board [Tc Kh Qc 2s]
Seat 1: ce835e9f (button) folded before Flop (didn't bet)
Seat 2: 8009f39b (small blind) folded before Flop
Seat 3: dcc428e3 (big blind) folded on the Turn
Seat 4: Hero folded before Flop (didn't bet)
Seat 5: d3b0f7d7 won ($0.12)
Seat 6: 412d38da folded before Flop (didn't bet)


Poker Hand #RC3812481922: Hold'em No Limit ($0.02/$0.05) - 2025/08/16 23:45:00
Table 'RushAndCash1087182' 6-max Seat #1 is the button
Seat 1: 5bca817b ($5 in chips)
Seat 2: Hero ($3.57 in chips)
Seat 3: 64530568 ($5.67 in chips)
Seat 4: 5ca74562 ($5 in chips)
Seat 5: 91b20d07 ($7.91 in chips)
Seat 6: 98d0a8ed ($5.54 in chips)
Hero: posts small blind $0.02
64530568: posts big blind $0.05
*** HOLE CARDS ***
Dealt to 5bca817b 
Dealt to Hero [Ks Kd]
Dealt to 64530568 
Dealt to 5ca74562 
Dealt to 91b20d07 
Dealt to 98d0a8ed 
5ca74562: raises $0.06 to $0.11
91b20d07: folds
98d0a8ed: folds
5bca817b: folds
Hero: raises $0.27 to $0.38
64530568: folds
5ca74562: folds
Uncalled bet ($0.27) returned to Hero
*** SHOWDOWN ***
Hero collected $0.26 from pot
*** SUMMARY ***
Total pot $0.27 | Rake $0.01 | Jackpot $0 | Bingo $0 | Fortune $0 | Tax $0
Seat 1: 5bca817b (button) folded before Flop (didn't bet)
Seat 2: Hero (small blind) collected ($0.26)
Seat 3: 64530568 (big blind) folded before Flop
Seat 4: 5ca74562 folded before Flop
Seat 5: 91b20d07 folded before Flop (didn't bet)
Seat 6: 98d0a8ed folded before Flop (didn't bet)


Poker Hand #RC3812481833: Hold'em No Limit ($0.02/$0.05) - 2025/08/16 23:44:49
Table 'RushAndCash1087093' 6-max Seat #1 is the button
Seat 1: c2556596 ($4.62 in chips)
Seat 2: b5b5ed2d ($3.78 in chips)
Seat 3: d3ee9b0a ($5.79 in chips)
Seat 4: ff940cc8 ($6.63 in chips)
Seat 5: Hero ($3.5 in chips)
Seat 6: 436b8683 ($5.71 in chips)
b5b5ed2d: posts small blind $0.02
d3ee9b0a: posts big blind $0.05
*** HOLE CARDS ***
Dealt to c2556596 
Dealt to b5b5ed2d 
Dealt to d3ee9b0a 
Dealt to ff940cc8 
Dealt to Hero [5c As]
Dealt to 436b8683 
ff940cc8: folds
Hero: raises $0.05 to $0.1
436b8683: folds
c2556596: folds
b5b5ed2d: folds
d3ee9b0a: folds
Uncalled bet ($0.05) returned to Hero
*** SHOWDOWN ***
Hero collected $0.12 from pot
*** SUMMARY ***
Total pot $0.12 | Rake $0 | Jackpot $0 | Bingo $0 | Fortune $0 | Tax $0
Seat 1: c2556596 (button) folded before Flop (didn't bet)
Seat 2: b5b5ed2d (small blind) folded before Flop
Seat 3: d3ee9b0a (big blind) folded before Flop
Seat 4: ff940cc8 folded before Flop (didn't bet)
Seat 5: Hero collected ($0.12)
Seat 6: 436b8683 folded before Flop (didn't bet)


Poker Hand #RC3812481802: Hold'em No Limit ($0.02/$0.05) - 2025/08/16 23:44:45
Table 'RushAndCash1087062' 6-max Seat #1 is the button
Seat 1: 281a8acb ($1.9 in chips)
Seat 2: d591f7ac ($5 in chips)
Seat 3: cc98320 ($12.93 in chips)
Seat 4: 1fe02a24 ($6.96 in chips)
Seat 5: c2818c57 ($5 in chips)
Seat 6: Hero ($3.5 in chips)
d591f7ac: posts small blind $0.02
cc98320: posts big blind $0.05
*** HOLE CARDS ***
Dealt to 281a8acb 
Dealt to d591f7ac 
Dealt to cc98320 
Dealt to 1fe02a24 
Dealt to c2818c57 
Dealt to Hero [4s 8s]
1fe02a24: folds
c2818c57: folds
Hero: folds
281a8acb: raises $0.05 to $0.1
d591f7ac: folds
cc98320: folds
Uncalled bet ($0.05) returned to 281a8acb
*** SHOWDOWN ***
281a8acb collected $0.12 from pot
*** SUMMARY ***
Total pot $0.12 | Rake $0 | Jackpot $0 | Bingo $0 | Fortune $0 | Tax $0
Seat 1: 281a8acb (button) collected ($0.12)
Seat 2: d591f7ac (small blind) folded before Flop
Seat 3: cc98320 (big blind) folded before Flop
Seat 4: 1fe02a24 folded before Flop (didn't bet)
Seat 5: c2818c57 folded before Flop (didn't bet)
Seat 6: Hero folded before Flop (didn't bet)


Poker Hand #RC3812481770: Hold'em No Limit ($0.02/$0.05) - 2025/08/16 23:44:42
Table 'RushAndCash1087030' 6-max Seat #1 is the button
Seat 1: de87a73 ($8.81 in chips)
Seat 2: Hero ($3.52 in chips)
Seat 3: b765e623 ($5.04 in chips)
Seat 4: 66a75d6a ($6.98 in chips)
Seat 5: ba885c24 ($4.98 in chips)
Seat 6: 57b00f3d ($15.03 in chips)
Hero: posts small blind $0.02
b765e623: posts big blind $0.05
*** HOLE CARDS ***
Dealt to de87a73 
Dealt to Hero [9h Ks]
Dealt to b765e623 
Dealt to 66a75d6a 
Dealt to ba885c24 
Dealt to 57b00f3d 
66a75d6a: folds
ba885c24: folds
57b00f3d: folds
de87a73: folds
Hero: folds
Uncalled bet ($0.03) returned to b765e623
*** SHOWDOWN ***
b765e623 collected $0.04 from pot
*** SUMMARY ***
Total pot $0.04 | Rake $0 | Jackpot $0 | Bingo $0 | Fortune $0 | Tax $0
Seat 1: de87a73 (button) folded before Flop (didn't bet)
Seat 2: Hero (small blind) folded before Flop
Seat 3: b765e623 (big blind) collected ($0.04)
Seat 4: 66a75d6a folded before Flop (didn't bet)
Seat 5: ba885c24 folded before Flop (didn't bet)
Seat 6: 57b00f3d folded before Flop (didn't bet)


Poker Hand #RC3812481742: Hold'em No Limit ($0.02/$0.05) - 2025/08/16 23:44:38
Table 'RushAndCash1087002' 6-max Seat #1 is the button
Seat 1: d591f7ac ($5 in chips)
Seat 2: 5a14db07 ($5.45 in chips)
Seat 3: 5bb2ddf5 ($4.35 in chips)
Seat 4: 57b00f3d ($15.03 in chips)
Seat 5: d7913e2a ($5.26 in chips)
Seat 6: Hero ($3.52 in chips)
5a14db07: posts small blind $0.02
5bb2ddf5: posts big blind $0.05
*** HOLE CARDS ***
Dealt to d591f7ac 
Dealt to 5a14db07 
Dealt to 5bb2ddf5 
Dealt to 57b00f3d 
Dealt to d7913e2a 
Dealt to Hero [2d Kh]
57b00f3d: folds
d7913e2a: raises $0.05 to $0.1
Hero: folds
d591f7ac: folds
5a14db07: folds
5bb2ddf5: folds
Uncalled bet ($0.05) returned to d7913e2a
*** SHOWDOWN ***
d7913e2a collected $0.12 from pot
*** SUMMARY ***
Total pot $0.12 | Rake $0 | Jackpot $0 | Bingo $0 | Fortune $0 | Tax $0
Seat 1: d591f7ac (button) folded before Flop (didn't bet)
Seat 2: 5a14db07 (small blind) folded before Flop
Seat 3: 5bb2ddf5 (big blind) folded before Flop
Seat 4: 57b00f3d folded before Flop (didn't bet)
Seat 5: d7913e2a collected ($0.12)
Seat 6: Hero folded before Flop (didn't bet)


Poker Hand #RC3812481613: Hold'em No Limit ($0.02/$0.05) - 2025/08/16 23:44:23
Table 'RushAndCash1086873' 6-max Seat #1 is the button
Seat 1: Hero ($3.52 in chips)
Seat 2: c70f12ac ($5.11 in chips)
Seat 3: a72f2364 ($5.96 in chips)
Seat 4: f50a21c2 ($12.48 in chips)
Seat 5: 2a1312b9 ($5.03 in chips)
Seat 6: 282df3bf ($24.51 in chips)
c70f12ac: posts small blind $0.02
a72f2364: posts big blind $0.05
*** HOLE CARDS ***
Dealt to Hero [5s Qh]
Dealt to c70f12ac 
Dealt to a72f2364 
Dealt to f50a21c2 
Dealt to 2a1312b9 
Dealt to 282df3bf 
f50a21c2: folds
2a1312b9: folds
282df3bf: folds
Hero: folds
c70f12ac: folds
Uncalled bet ($0.03) returned to a72f2364
*** SHOWDOWN ***
a72f2364 collected $0.04 from pot
*** SUMMARY ***
Total pot $0.04 | Rake $0 | Jackpot $0 | Bingo $0 | Fortune $0 | Tax $0
Seat 1: Hero (button) folded before Flop (didn't bet)
Seat 2: c70f12ac (small blind) folded before Flop
Seat 3: a72f2364 (big blind) collected ($0.04)
Seat 4: f50a21c2 folded before Flop (didn't bet)
Seat 5: 2a1312b9 folded before Flop (didn't bet)
Seat 6: 282df3bf folded before Flop (didn't bet)


Poker Hand #RC3812481387: Hold'em No Limit ($0.02/$0.05) - 2025/08/16 23:43:55
Table 'RushAndCash1086647' 6-max Seat #1 is the button
Seat 1: 778a16a1 ($4.93 in chips)
Seat 2: 106207cb ($6.68 in chips)
Seat 3: Hero ($3.57 in chips)
Seat 4: a1c2d1dc ($4.6 in chips)
Seat 5: d6c5e14a ($5 in chips)
Seat 6: e01a93bf ($4.1 in chips)
106207cb: posts small blind $0.02
Hero: posts big blind $0.05
*** HOLE CARDS ***
Dealt to 778a16a1 
Dealt to 106207cb 
Dealt to Hero [Kc Td]
Dealt to a1c2d1dc 
Dealt to d6c5e14a 
Dealt to e01a93bf 
a1c2d1dc: raises $0.05 to $0.1
d6c5e14a: folds
e01a93bf: folds
778a16a1: folds
106207cb: raises $0.3 to $0.4
Hero: folds
a1c2d1dc: folds
Uncalled bet ($0.3) returned to 106207cb
*** SHOWDOWN ***
106207cb collected $0.24 from pot
*** SUMMARY ***
Total pot $0.25 | Rake $0.01 | Jackpot $0 | Bingo $0 | Fortune $0 | Tax $0
Seat 1: 778a16a1 (button) folded before Flop (didn't bet)
Seat 2: 106207cb (small blind) collected ($0.24)
Seat 3: Hero (big blind) folded before Flop
Seat 4: a1c2d1dc folded before Flop
Seat 5: d6c5e14a folded before Flop (didn't bet)
Seat 6: e01a93bf folded before Flop (didn't bet)


Poker Hand #RC3812481361: Hold'em No Limit ($0.02/$0.05) - 2025/08/16 23:43:51
Table 'RushAndCash1086621' 6-max Seat #1 is the button
Seat 1: dd2211d8 ($5.9 in chips)
Seat 2: 41556454 ($5.37 in chips)
Seat 3: fe6c66e7 ($5.82 in chips)
Seat 4: 31e603a7 ($11.02 in chips)
Seat 5: 80837687 ($6.44 in chips)
Seat 6: Hero ($3.57 in chips)
41556454: posts small blind $0.02
fe6c66e7: posts big blind $0.05
*** HOLE CARDS ***
Dealt to dd2211d8 
Dealt to 41556454 
Dealt to fe6c66e7 
Dealt to 31e603a7 
Dealt to 80837687 
Dealt to Hero [Jh 3s]
31e603a7: folds
80837687: raises $0.05 to $0.1
Hero: folds
dd2211d8: folds
41556454: folds
fe6c66e7: calls $0.05
*** FLOP *** [Qs 4c 9c]
fe6c66e7: checks
80837687: bets $0.06
fe6c66e7: calls $0.06
*** TURN *** [Qs 4c 9c] [2d]
fe6c66e7: checks
80837687: checks
*** RIVER *** [Qs 4c 9c 2d] [Td]
fe6c66e7: bets $0.26
80837687: calls $0.26
fe6c66e7: shows [9d As] (a pair of Nines)
80837687: shows [Tc Th] (three of a kind, Tens)
*** SHOWDOWN ***
80837687 collected $0.82 from pot
*** SUMMARY ***
Total pot $0.86 | Rake $0.04 | Jackpot $0 | Bingo $0 | Fortune $0 | Tax $0
Board [Qs 4c 9c 2d Td]
Seat 1: dd2211d8 (button) folded before Flop (didn't bet)
Seat 2: 41556454 (small blind) folded before Flop
Seat 3: fe6c66e7 (big blind) showed [9d As] and lost with a pair of Nines
Seat 4: 31e603a7 folded before Flop (didn't bet)
Seat 5: 80837687 showed [Tc Th] and won ($0.82) with three of a kind, Tens
Seat 6: Hero folded before Flop (didn't bet)


Poker Hand #RC3812481334: Hold'em No Limit ($0.02/$0.05) - 2025/08/16 23:43:48
Table 'RushAndCash1086594' 6-max Seat #1 is the button
Seat 1: 1d91ed09 ($9.23 in chips)
Seat 2: e5816f2a ($38.37 in chips)
Seat 3: b7825e0e ($5.05 in chips)
Seat 4: Hero ($3.57 in chips)
Seat 5: f0f5b243 ($1.63 in chips)
Seat 6: d63e692c ($17.73 in chips)
e5816f2a: posts small blind $0.02
b7825e0e: posts big blind $0.05
*** HOLE CARDS ***
Dealt to 1d91ed09 
Dealt to e5816f2a 
Dealt to b7825e0e 
Dealt to Hero [6d 3s]
Dealt to f0f5b243 
Dealt to d63e692c 
Hero: folds
f0f5b243: folds
d63e692c: raises $0.05 to $0.1
1d91ed09: calls $0.1
e5816f2a: folds
b7825e0e: folds
*** FLOP *** [Qd 3c Ad]
d63e692c: checks
1d91ed09: checks
*** TURN *** [Qd 3c Ad] [As]
d63e692c: bets $0.14
1d91ed09: folds
Uncalled bet ($0.14) returned to d63e692c
*** SHOWDOWN ***
d63e692c collected $0.26 from pot
*** SUMMARY ***
Total pot $0.27 | Rake $0.01 | Jackpot $0 | Bingo $0 | Fortune $0 | Tax $0
Board [Qd 3c Ad As]
Seat 1: 1d91ed09 (button) folded on the Turn
Seat 2: e5816f2a (small blind) folded before Flop
Seat 3: b7825e0e (big blind) folded before Flop
Seat 4: Hero folded before Flop (didn't bet)
Seat 5: f0f5b243 folded before Flop (didn't bet)
Seat 6: d63e692c won ($0.26)


Poker Hand #RC3812481275: Hold'em No Limit ($0.02/$0.05) - 2025/08/16 23:43:41
Table 'RushAndCash1086535' 6-max Seat #1 is the button
Seat 1: 3812131a ($12.76 in chips)
Seat 2: Hero ($3.59 in chips)
Seat 3: 1d9f957 ($5.52 in chips)
Seat 4: 677d66f ($6.21 in chips)
Seat 5: c46c7d3e ($7.02 in chips)
Seat 6: 5f1dba5d ($2.47 in chips)
Hero: posts small blind $0.02
1d9f957: posts big blind $0.05
*** HOLE CARDS ***
Dealt to 3812131a 
Dealt to Hero [2c Ks]
Dealt to 1d9f957 
Dealt to 677d66f 
Dealt to c46c7d3e 
Dealt to 5f1dba5d 
677d66f: folds
c46c7d3e: folds
5f1dba5d: raises $0.05 to $0.1
3812131a: folds
Hero: folds
1d9f957: calls $0.05
*** FLOP *** [7d Qd 9c]
1d9f957: checks
5f1dba5d: bets $0.11
1d9f957: calls $0.11
*** TURN *** [7d Qd 9c] [4c]
1d9f957: checks
5f1dba5d: checks
*** RIVER *** [7d Qd 9c 4c] [6h]
1d9f957: checks
5f1dba5d: checks
1d9f957: shows [Kd 9h] (a pair of Nines)
5f1dba5d: shows [3h 3s] (a pair of Threes)
*** SHOWDOWN ***
1d9f957 collected $0.42 from pot
*** SUMMARY ***
Total pot $0.44 | Rake $0.02 | Jackpot $0 | Bingo $0 | Fortune $0 | Tax $0
Board [7d Qd 9c 4c 6h]
Seat 1: 3812131a (button) folded before Flop (didn't bet)
Seat 2: Hero (small blind) folded before Flop
Seat 3: 1d9f957 (big blind) showed [Kd 9h] and won ($0.42) with a pair of Nines
Seat 4: 677d66f folded before Flop (didn't bet)
Seat 5: c46c7d3e folded before Flop (didn't bet)
Seat 6: 5f1dba5d showed [3h 3s] and lost with a pair of Threes


Poker Hand #RC3812481216: Hold'em No Limit ($0.02/$0.05) - 2025/08/16 23:43:34
Table 'RushAndCash1086476' 6-max Seat #1 is the button
Seat 1: b699a745 ($8.21 in chips)
Seat 2: 1efbd36f ($5.3 in chips)
Seat 3: 250af0bc ($1.77 in chips)
Seat 4: f6601c75 ($5 in chips)
Seat 5: 6c196a1f ($34.05 in chips)
Seat 6: Hero ($3.59 in chips)
1efbd36f: posts small blind $0.02
250af0bc: posts big blind $0.05
*** HOLE CARDS ***
Dealt to b699a745 
Dealt to 1efbd36f 
Dealt to 250af0bc 
Dealt to f6601c75 
Dealt to 6c196a1f 
Dealt to Hero [7d 2d]
f6601c75: folds
6c196a1f: folds
Hero: folds
b699a745: folds
1efbd36f: raises $0.05 to $0.1
250af0bc: calls $0.05
*** FLOP *** [8s Kd Ah]
1efbd36f: bets $0.15
250af0bc: folds
Uncalled bet ($0.15) returned to 1efbd36f
*** SHOWDOWN ***
1efbd36f collected $0.19 from pot
*** SUMMARY ***
Total pot $0.2 | Rake $0.01 | Jackpot $0 | Bingo $0 | Fortune $0 | Tax $0
Board [8s Kd Ah]
Seat 1: b699a745 (button) folded before Flop (didn't bet)
Seat 2: 1efbd36f (small blind) showed [4d Qd] and won ($0.19)
Seat 3: 250af0bc (big blind) folded on the Flop
Seat 4: f6601c75 folded before Flop (didn't bet)
Seat 5: 6c196a1f folded before Flop (didn't bet)
Seat 6: Hero folded before Flop (didn't bet)


Poker Hand #RC3812481067: Hold'em No Limit ($0.02/$0.05) - 2025/08/16 23:43:16
Table 'RushAndCash1086327' 6-max Seat #1 is the button
Seat 1: Hero ($3.59 in chips)
Seat 2: fed1995e ($4.12 in chips)
Seat 3: e14f293 ($5 in chips)
Seat 4: 483e904a ($5.34 in chips)
Seat 5: 65a6162b ($10.55 in chips)
Seat 6: 8fbca4d1 ($7.11 in chips)
fed1995e: posts small blind $0.02
e14f293: posts big blind $0.05
*** HOLE CARDS ***
Dealt to Hero [3d Js]
Dealt to fed1995e 
Dealt to e14f293 
Dealt to 483e904a 
Dealt to 65a6162b 
Dealt to 8fbca4d1 
483e904a: folds
65a6162b: folds
8fbca4d1: folds
Hero: folds
fed1995e: folds
Uncalled bet ($0.03) returned to e14f293
*** SHOWDOWN ***
e14f293 collected $0.04 from pot
*** SUMMARY ***
Total pot $0.04 | Rake $0 | Jackpot $0 | Bingo $0 | Fortune $0 | Tax $0
Seat 1: Hero (button) folded before Flop (didn't bet)
Seat 2: fed1995e (small blind) folded before Flop
Seat 3: e14f293 (big blind) collected ($0.04)
Seat 4: 483e904a folded before Flop (didn't bet)
Seat 5: 65a6162b folded before Flop (didn't bet)
Seat 6: 8fbca4d1 folded before Flop (didn't bet)


Poker Hand #RC3812480992: Hold'em No Limit ($0.02/$0.05) - 2025/08/16 23:43:06
Table 'RushAndCash1086252' 6-max Seat #1 is the button
Seat 1: 7dfad272 ($4.88 in chips)
Seat 2: 78d1a832 ($5.6 in chips)
Seat 3: Hero ($3.64 in chips)
Seat 4: 520dc02a ($5.01 in chips)
Seat 5: 80a546d4 ($4.68 in chips)
Seat 6: e01a93bf ($4.03 in chips)
78d1a832: posts small blind $0.02
Hero: posts big blind $0.05
*** HOLE CARDS ***
Dealt to 7dfad272 
Dealt to 78d1a832 
Dealt to Hero [5d 9h]
Dealt to 520dc02a 
Dealt to 80a546d4 
Dealt to e01a93bf 
520dc02a: folds
80a546d4: raises $0.07 to $0.12
e01a93bf: folds
7dfad272: folds
78d1a832: folds
Hero: folds
Uncalled bet ($0.07) returned to 80a546d4
*** SHOWDOWN ***
80a546d4 collected $0.12 from pot
*** SUMMARY ***
Total pot $0.12 | Rake $0 | Jackpot $0 | Bingo $0 | Fortune $0 | Tax $0
Seat 1: 7dfad272 (button) folded before Flop (didn't bet)
Seat 2: 78d1a832 (small blind) folded before Flop
Seat 3: Hero (big blind) folded before Flop
Seat 4: 520dc02a folded before Flop (didn't bet)
Seat 5: 80a546d4 collected ($0.12)
Seat 6: e01a93bf folded before Flop (didn't bet)


Poker Hand #RC3812480838: Hold'em No Limit ($0.02/$0.05) - 2025/08/16 23:42:48
Table 'RushAndCash1086098' 6-max Seat #1 is the button
Seat 1: 2b54e7a1 ($6.74 in chips)
Seat 2: d63e692c ($17.31 in chips)
Seat 3: 30a7bd78 ($9.56 in chips)
Seat 4: Hero ($3.57 in chips)
Seat 5: da58d721 ($2.8 in chips)
Seat 6: fbfae31e ($6.74 in chips)
d63e692c: posts small blind $0.02
30a7bd78: posts big blind $0.05
*** HOLE CARDS ***
Dealt to 2b54e7a1 
Dealt to d63e692c 
Dealt to 30a7bd78 
Dealt to Hero [Ah 3h]
Dealt to da58d721 
Dealt to fbfae31e 
Hero: raises $0.05 to $0.1
da58d721: folds
fbfae31e: folds
2b54e7a1: folds
d63e692c: folds
30a7bd78: folds
Uncalled bet ($0.05) returned to Hero
*** SHOWDOWN ***
Hero collected $0.12 from pot
*** SUMMARY ***
Total pot $0.12 | Rake $0 | Jackpot $0 | Bingo $0 | Fortune $0 | Tax $0
Seat 1: 2b54e7a1 (button) folded before Flop (didn't bet)
Seat 2: d63e692c (small blind) folded before Flop
Seat 3: 30a7bd78 (big blind) folded before Flop
Seat 4: Hero collected ($0.12)
Seat 5: da58d721 folded before Flop (didn't bet)
Seat 6: fbfae31e folded before Flop (didn't bet)


Poker Hand #RC3812480809: Hold'em No Limit ($0.02/$0.05) - 2025/08/16 23:42:44
Table 'RushAndCash1086069' 6-max Seat #1 is the button
Seat 1: d63e692c ($17.31 in chips)
Seat 2: 19ee4bf8 ($5.3 in chips)
Seat 3: a154648b ($8.87 in chips)
Seat 4: f313412f ($5 in chips)
Seat 5: Hero ($3.57 in chips)
Seat 6: c610c0ae ($5.89 in chips)
19ee4bf8: posts small blind $0.02
a154648b: posts big blind $0.05
*** HOLE CARDS ***
Dealt to d63e692c 
Dealt to 19ee4bf8 
Dealt to a154648b 
Dealt to f313412f 
Dealt to Hero [4s 9c]
Dealt to c610c0ae 
f313412f: raises $0.05 to $0.1
Hero: folds
c610c0ae: folds
d63e692c: folds
19ee4bf8: folds
a154648b: folds
Uncalled bet ($0.05) returned to f313412f
*** SHOWDOWN ***
f313412f collected $0.12 from pot
*** SUMMARY ***
Total pot $0.12 | Rake $0 | Jackpot $0 | Bingo $0 | Fortune $0 | Tax $0
Seat 1: d63e692c (button) folded before Flop (didn't bet)
Seat 2: 19ee4bf8 (small blind) folded before Flop
Seat 3: a154648b (big blind) folded before Flop
Seat 4: f313412f collected ($0.12)
Seat 5: Hero folded before Flop (didn't bet)
Seat 6: c610c0ae folded before Flop (didn't bet)


Poker Hand #RC3812480326: Hold'em No Limit ($0.02/$0.05) - 2025/08/16 23:41:46
Table 'RushAndCash1085586' 6-max Seat #1 is the button
Seat 1: a154648b ($9.22 in chips)
Seat 2: 8672b474 ($5.2 in chips)
Seat 3: d63e692c ($8.63 in chips)
Seat 4: 54913fe8 ($5.07 in chips)
Seat 5: 4bde28e1 ($6.64 in chips)
Seat 6: Hero ($12.2 in chips)
8672b474: posts small blind $0.02
d63e692c: posts big blind $0.05
*** HOLE CARDS ***
Dealt to a154648b 
Dealt to 8672b474 
Dealt to d63e692c 
Dealt to 54913fe8 
Dealt to 4bde28e1 
Dealt to Hero [Tc Js]
54913fe8: folds
4bde28e1: folds
Hero: raises $0.05 to $0.1
a154648b: calls $0.1
8672b474: folds
d63e692c: calls $0.05
*** FLOP *** [8c 7c 9d]
d63e692c: checks
Hero: bets $0.25
a154648b: calls $0.25
d63e692c: raises $1.07 to $1.32
Hero: calls $1.07
a154648b: folds
*** TURN *** [8c 7c 9d] [3c]
d63e692c: bets $7.21 and is all-in
Hero: calls $7.21
d63e692c: shows [Qc 6c] (a flush Queen high)
Hero: shows [Tc Js] (a straight, Jack to Seven)
*** RIVER *** [8c 7c 9d 3c] [Ks]
*** SHOWDOWN ***
d63e692c collected $17.31 from pot
*** SUMMARY ***
Total pot $17.63 | Rake $0.25 | Jackpot $0.07 | Bingo $0 | Fortune $0 | Tax $0
Board [8c 7c 9d 3c Ks]
Seat 1: a154648b (button) folded on the Flop
Seat 2: 8672b474 (small blind) folded before Flop
Seat 3: d63e692c (big blind) showed [Qc 6c] and won ($17.31) with a flush Queen high
Seat 4: 54913fe8 folded before Flop (didn't bet)
Seat 5: 4bde28e1 folded before Flop (didn't bet)
Seat 6: Hero showed [Tc Js] and lost with a straight, Jack to Seven


Poker Hand #RC3812480254: Hold'em No Limit ($0.02/$0.05) - 2025/08/16 23:41:36
Table 'RushAndCash1085514' 6-max Seat #1 is the button
Seat 1: a836c161 ($5.53 in chips)
Seat 2: cda26e4a ($11.56 in chips)
Seat 3: Hero ($12.25 in chips)
Seat 4: b6a78c14 ($5.94 in chips)
Seat 5: 45c428ad ($6.56 in chips)
Seat 6: 1bd0a92f ($5.51 in chips)
cda26e4a: posts small blind $0.02
Hero: posts big blind $0.05
*** HOLE CARDS ***
Dealt to a836c161 
Dealt to cda26e4a 
Dealt to Hero [9h 6s]
Dealt to b6a78c14 
Dealt to 45c428ad 
Dealt to 1bd0a92f 
b6a78c14: folds
45c428ad: folds
1bd0a92f: folds
a836c161: folds
cda26e4a: raises $0.1 to $0.15
Hero: folds
Uncalled bet ($0.1) returned to cda26e4a
*** SHOWDOWN ***
cda26e4a collected $0.1 from pot
*** SUMMARY ***
Total pot $0.1 | Rake $0 | Jackpot $0 | Bingo $0 | Fortune $0 | Tax $0
Seat 1: a836c161 (button) folded before Flop (didn't bet)
Seat 2: cda26e4a (small blind) collected ($0.1)
Seat 3: Hero (big blind) folded before Flop
Seat 4: b6a78c14 folded before Flop (didn't bet)
Seat 5: 45c428ad folded before Flop (didn't bet)
Seat 6: 1bd0a92f folded before Flop (didn't bet)


Poker Hand #RC3812479692: Hold'em No Limit ($0.02/$0.05) - 2025/08/16 23:40:27
Table 'RushAndCash1084952' 6-max Seat #1 is the button
Seat 1: b6a78c14 ($4.77 in chips)
Seat 2: Hero ($13.57 in chips)
Seat 3: ff779fac ($5 in chips)
Seat 4: 24d280ec ($8.19 in chips)
Seat 5: 436b8683 ($5.35 in chips)
Seat 6: d99e5fd9 ($5 in chips)
Hero: posts small blind $0.02
ff779fac: posts big blind $0.05
*** HOLE CARDS ***
Dealt to b6a78c14 
Dealt to Hero [Ah 5c]
Dealt to ff779fac 
Dealt to 24d280ec 
Dealt to 436b8683 
Dealt to d99e5fd9 
24d280ec: folds
436b8683: folds
d99e5fd9: folds
b6a78c14: raises $0.1 to $0.15
Hero: raises $0.45 to $0.6
ff779fac: folds
b6a78c14: calls $0.45
*** FLOP *** [As Tc 4d]
Hero: bets $0.36
b6a78c14: raises $0.36 to $0.72
Hero: calls $0.36
*** TURN *** [As Tc 4d] [Qc]
Hero: checks
b6a78c14: checks
*** RIVER *** [As Tc 4d Qc] [Jd]
Hero: checks
b6a78c14: checks
Hero: shows [Ah 5c] (a pair of Aces)
b6a78c14: shows [Qs Ac] (two pair, Aces and Queens)
*** SHOWDOWN ***
b6a78c14 collected $2.49 from pot
*** SUMMARY ***
Total pot $2.69 | Rake $0.13 | Jackpot $0.07 | Bingo $0 | Fortune $0 | Tax $0
Board [As Tc 4d Qc Jd]
Seat 1: b6a78c14 (button) showed [Qs Ac] and won ($2.49) with two pair, Aces and Queens
Seat 2: Hero (small blind) showed [Ah 5c] and lost with a pair of Aces
Seat 3: ff779fac (big blind) folded before Flop
Seat 4: 24d280ec folded before Flop (didn't bet)
Seat 5: 436b8683 folded before Flop (didn't bet)
Seat 6: d99e5fd9 folded before Flop (didn't bet)


Poker Hand #RC3812479663: Hold'em No Limit ($0.02/$0.05) - 2025/08/16 23:40:23
Table 'RushAndCash1084923' 6-max Seat #1 is the button
Seat 1: d65a05e9 ($5.76 in chips)
Seat 2: bdf29add ($5.11 in chips)
Seat 3: 24d280ec ($8.24 in chips)
Seat 4: Hero ($13.57 in chips)
Seat 5: a4b7c741 ($6.92 in chips)
Seat 6: 5f5bcd82 ($4.52 in chips)
bdf29add: posts small blind $0.02
24d280ec: posts big blind $0.05
*** HOLE CARDS ***
Dealt to d65a05e9 
Dealt to bdf29add 
Dealt to 24d280ec 
Dealt to Hero [9d Tc]
Dealt to a4b7c741 
Dealt to 5f5bcd82 
Hero: folds
a4b7c741: folds
5f5bcd82: folds
d65a05e9: folds
bdf29add: folds
Uncalled bet ($0.03) returned to 24d280ec
*** SHOWDOWN ***
24d280ec collected $0.04 from pot
*** SUMMARY ***
Total pot $0.04 | Rake $0 | Jackpot $0 | Bingo $0 | Fortune $0 | Tax $0
Seat 1: d65a05e9 (button) folded before Flop (didn't bet)
Seat 2: bdf29add (small blind) folded before Flop
Seat 3: 24d280ec (big blind) collected ($0.04)
Seat 4: Hero folded before Flop (didn't bet)
Seat 5: a4b7c741 folded before Flop (didn't bet)
Seat 6: 5f5bcd82 folded before Flop (didn't bet)


Poker Hand #RC3812479524: Hold'em No Limit ($0.02/$0.05) - 2025/08/16 23:40:05
Table 'RushAndCash1084784' 6-max Seat #1 is the button
Seat 1: d6bdbdc4 ($5.46 in chips)
Seat 2: dccd7917 ($6.07 in chips)
Seat 3: 96dfc91e ($6.68 in chips)
Seat 4: 362a084c ($5.1 in chips)
Seat 5: 6f2b1159 ($5 in chips)
Seat 6: Hero ($13.5 in chips)
dccd7917: posts small blind $0.02
96dfc91e: posts big blind $0.05
*** HOLE CARDS ***
Dealt to d6bdbdc4 
Dealt to dccd7917 
Dealt to 96dfc91e 
Dealt to 362a084c 
Dealt to 6f2b1159 
Dealt to Hero [Ah 5h]
362a084c: folds
6f2b1159: folds
Hero: raises $0.05 to $0.1
d6bdbdc4: folds
dccd7917: folds
96dfc91e: folds
Uncalled bet ($0.05) returned to Hero
*** SHOWDOWN ***
Hero collected $0.12 from pot
*** SUMMARY ***
Total pot $0.12 | Rake $0 | Jackpot $0 | Bingo $0 | Fortune $0 | Tax $0
Seat 1: d6bdbdc4 (button) folded before Flop (didn't bet)
Seat 2: dccd7917 (small blind) folded before Flop
Seat 3: 96dfc91e (big blind) folded before Flop
Seat 4: 362a084c folded before Flop (didn't bet)
Seat 5: 6f2b1159 folded before Flop (didn't bet)
Seat 6: Hero collected ($0.12)


Poker Hand #RC3812479370: Hold'em No Limit ($0.02/$0.05) - 2025/08/16 23:39:44
Table 'RushAndCash1084630' 6-max Seat #1 is the button
Seat 1: Hero ($13.5 in chips)
Seat 2: 5740b5f0 ($4.84 in chips)
Seat 3: b699a745 ($7.83 in chips)
Seat 4: 2bd1788e ($5.24 in chips)
Seat 5: 707167ef ($5.03 in chips)
Seat 6: 82d9f895 ($5 in chips)
5740b5f0: posts small blind $0.02
b699a745: posts big blind $0.05
*** HOLE CARDS ***
Dealt to Hero [5h Th]
Dealt to 5740b5f0 
Dealt to b699a745 
Dealt to 2bd1788e 
Dealt to 707167ef 
Dealt to 82d9f895 
2bd1788e: folds
707167ef: raises $0.07 to $0.12
82d9f895: folds
Hero: folds
5740b5f0: folds
b699a745: calls $0.07
*** FLOP *** [Jd Kh 5c]
b699a745: checks
707167ef: bets $0.07
b699a745: calls $0.07
*** TURN *** [Jd Kh 5c] [3s]
b699a745: bets $0.44
707167ef: calls $0.44
*** RIVER *** [Jd Kh 5c 3s] [5s]
b699a745: checks
707167ef: checks
b699a745: shows [Tc 9c] (a pair of Fives)
707167ef: shows [Jc Ac] (two pair, Jacks and Fives)
*** SHOWDOWN ***
707167ef collected $1.22 from pot
*** SUMMARY ***
Total pot $1.28 | Rake $0.06 | Jackpot $0 | Bingo $0 | Fortune $0 | Tax $0
Board [Jd Kh 5c 3s 5s]
Seat 1: Hero (button) folded before Flop (didn't bet)
Seat 2: 5740b5f0 (small blind) folded before Flop
Seat 3: b699a745 (big blind) showed [Tc 9c] and lost with a pair of Fives
Seat 4: 2bd1788e folded before Flop (didn't bet)
Seat 5: 707167ef showed [Jc Ac] and won ($1.22) with two pair, Jacks and Fives
Seat 6: 82d9f895 folded before Flop (didn't bet)


Poker Hand #RC3812479334: Hold'em No Limit ($0.02/$0.05) - 2025/08/16 23:39:39
Table 'RushAndCash1084594' 6-max Seat #1 is the button
Seat 1: Hero ($13.5 in chips)
Seat 2: e5a75ca8 ($5.07 in chips)
Seat 3: feb5f59b ($8.21 in chips)
Seat 4: 8fbca4d1 ($7.33 in chips)
Seat 5: d6d9d101 ($6.31 in chips)
Seat 6: c9a8ed59 ($8.45 in chips)
e5a75ca8: posts small blind $0.02
feb5f59b: posts big blind $0.05
*** HOLE CARDS ***
Dealt to Hero [9s 2c]
Dealt to e5a75ca8 
Dealt to feb5f59b 
Dealt to 8fbca4d1 
Dealt to d6d9d101 
Dealt to c9a8ed59 
8fbca4d1: folds
d6d9d101: folds
c9a8ed59: folds
Hero: folds
e5a75ca8: folds
Uncalled bet ($0.03) returned to feb5f59b
*** SHOWDOWN ***
feb5f59b collected $0.04 from pot
*** SUMMARY ***
Total pot $0.04 | Rake $0 | Jackpot $0 | Bingo $0 | Fortune $0 | Tax $0
Seat 1: Hero (button) folded before Flop (didn't bet)
Seat 2: e5a75ca8 (small blind) folded before Flop
Seat 3: feb5f59b (big blind) collected ($0.04)
Seat 4: 8fbca4d1 folded before Flop (didn't bet)
Seat 5: d6d9d101 folded before Flop (didn't bet)
Seat 6: c9a8ed59 folded before Flop (didn't bet)


Poker Hand #RC3812479204: Hold'em No Limit ($0.02/$0.05) - 2025/08/16 23:39:21
Table 'RushAndCash1084464' 6-max Seat #1 is the button
Seat 1: 23960f7e ($5 in chips)
Seat 2: Hero ($13.52 in chips)
Seat 3: 15f48232 ($5.19 in chips)
Seat 4: f5dec803 ($5.4 in chips)
Seat 5: 5c31f035 ($5 in chips)
Seat 6: cca18c03 ($5.27 in chips)
Hero: posts small blind $0.02
15f48232: posts big blind $0.05
*** HOLE CARDS ***
Dealt to 23960f7e 
Dealt to Hero [4h Kd]
Dealt to 15f48232 
Dealt to f5dec803 
Dealt to 5c31f035 
Dealt to cca18c03 
f5dec803: folds
5c31f035: folds
cca18c03: folds
23960f7e: folds
Hero: folds
Uncalled bet ($0.03) returned to 15f48232
*** SHOWDOWN ***
15f48232 collected $0.04 from pot
*** SUMMARY ***
Total pot $0.04 | Rake $0 | Jackpot $0 | Bingo $0 | Fortune $0 | Tax $0
Seat 1: 23960f7e (button) folded before Flop (didn't bet)
Seat 2: Hero (small blind) folded before Flop
Seat 3: 15f48232 (big blind) collected ($0.04)
Seat 4: f5dec803 folded before Flop (didn't bet)
Seat 5: 5c31f035 folded before Flop (didn't bet)
Seat 6: cca18c03 folded before Flop (didn't bet)


Poker Hand #RC3812478870: Hold'em No Limit ($0.02/$0.05) - 2025/08/16 23:38:36
Table 'RushAndCash1084130' 6-max Seat #1 is the button
Seat 1: 1cc531b8 ($7.88 in chips)
Seat 2: 214f5584 ($11.07 in chips)
Seat 3: Hero ($13.67 in chips)
Seat 4: 16cda9e5 ($5 in chips)
Seat 5: 94e12bc9 ($12.1 in chips)
Seat 6: e5816f2a ($38.14 in chips)
214f5584: posts small blind $0.02
Hero: posts big blind $0.05
*** HOLE CARDS ***
Dealt to 1cc531b8 
Dealt to 214f5584 
Dealt to Hero [Ts Th]
Dealt to 16cda9e5 
Dealt to 94e12bc9 
Dealt to e5816f2a 
16cda9e5: folds
94e12bc9: folds
e5816f2a: folds
1cc531b8: raises $0.1 to $0.15
214f5584: calls $0.13
Hero: calls $0.1
*** FLOP *** [2d 9h Ad]
214f5584: checks
Hero: checks
1cc531b8: bets $0.23
214f5584: folds
Hero: folds
Uncalled bet ($0.23) returned to 1cc531b8
*** SHOWDOWN ***
1cc531b8 collected $0.43 from pot
*** SUMMARY ***
Total pot $0.45 | Rake $0.02 | Jackpot $0 | Bingo $0 | Fortune $0 | Tax $0
Board [2d 9h Ad]
Seat 1: 1cc531b8 (button) won ($0.43)
Seat 2: 214f5584 (small blind) folded on the Flop
Seat 3: Hero (big blind) folded on the Flop
Seat 4: 16cda9e5 folded before Flop (didn't bet)
Seat 5: 94e12bc9 folded before Flop (didn't bet)
Seat 6: e5816f2a folded before Flop (didn't bet)


Poker Hand #RC3812478841: Hold'em No Limit ($0.02/$0.05) - 2025/08/16 23:38:32
Table 'RushAndCash1084101' 6-max Seat #1 is the button
Seat 1: dfdf1bff ($10.09 in chips)
Seat 2: b7fa0280 ($5.18 in chips)
Seat 3: 1cbd6d36 ($5 in chips)
Seat 4: Hero ($13.67 in chips)
Seat 5: b9846e09 ($7.79 in chips)
Seat 6: 940fc210 ($5.32 in chips)
b7fa0280: posts small blind $0.02
1cbd6d36: posts big blind $0.05
*** HOLE CARDS ***
Dealt to dfdf1bff 
Dealt to b7fa0280 
Dealt to 1cbd6d36 
Dealt to Hero [7s 9d]
Dealt to b9846e09 
Dealt to 940fc210 
Hero: folds
b9846e09: folds
940fc210: raises $0.08 to $0.13
dfdf1bff: raises $0.29 to $0.42
b7fa0280: folds
1cbd6d36: folds
940fc210: calls $0.29
*** FLOP *** [5h 7d 2c]
940fc210: checks
dfdf1bff: checks
*** TURN *** [5h 7d 2c] [2h]
940fc210: checks
dfdf1bff: checks
*** RIVER *** [5h 7d 2c 2h] [5d]
940fc210: checks
dfdf1bff: checks
940fc210: shows [Qs Ah] (two pair, Fives and Twos)
dfdf1bff: shows [Kc Js] (two pair, Fives and Twos)
*** SHOWDOWN ***
940fc210 collected $0.87 from pot
*** SUMMARY ***
Total pot $0.91 | Rake $0.04 | Jackpot $0 | Bingo $0 | Fortune $0 | Tax $0
Board [5h 7d 2c 2h 5d]
Seat 1: dfdf1bff (button) showed [Kc Js] and lost with two pair, Fives and Twos
Seat 2: b7fa0280 (small blind) folded before Flop
Seat 3: 1cbd6d36 (big blind) folded before Flop
Seat 4: Hero folded before Flop (didn't bet)
Seat 5: b9846e09 folded before Flop (didn't bet)
Seat 6: 940fc210 showed [Qs Ah] and won ($0.87) with two pair, Fives and Twos


Poker Hand #RC3812478761: Hold'em No Limit ($0.02/$0.05) - 2025/08/16 23:38:23
Table 'RushAndCash1084021' 6-max Seat #1 is the button
Seat 1: 7d828efc ($10.1 in chips)
Seat 2: Hero ($13.69 in chips)
Seat 3: df49ad79 ($8.59 in chips)
Seat 4: 2646fd58 ($6.49 in chips)
Seat 5: c8cb489c ($6.07 in chips)
Seat 6: 385464c5 ($10.76 in chips)
Hero: posts small blind $0.02
df49ad79: posts big blind $0.05
*** HOLE CARDS ***
Dealt to 7d828efc 
Dealt to Hero [Ks 8d]
Dealt to df49ad79 
Dealt to 2646fd58 
Dealt to c8cb489c 
Dealt to 385464c5 
2646fd58: folds
c8cb489c: folds
385464c5: folds
7d828efc: folds
Hero: folds
Uncalled bet ($0.03) returned to df49ad79
*** SHOWDOWN ***
df49ad79 collected $0.04 from pot
*** SUMMARY ***
Total pot $0.04 | Rake $0 | Jackpot $0 | Bingo $0 | Fortune $0 | Tax $0
Seat 1: 7d828efc (button) folded before Flop (didn't bet)
Seat 2: Hero (small blind) folded before Flop
Seat 3: df49ad79 (big blind) collected ($0.04)
Seat 4: 2646fd58 folded before Flop (didn't bet)
Seat 5: c8cb489c folded before Flop (didn't bet)
Seat 6: 385464c5 folded before Flop (didn't bet)


Poker Hand #RC3812478732: Hold'em No Limit ($0.02/$0.05) - 2025/08/16 23:38:19
Table 'RushAndCash1083992' 6-max Seat #1 is the button
Seat 1: ca6a4ee8 ($10.99 in chips)
Seat 2: 4ae7cab0 ($4.9 in chips)
Seat 3: 206a879e ($5 in chips)
Seat 4: 3fde18f1 ($5.33 in chips)
Seat 5: Hero ($13.69 in chips)
Seat 6: ff997675 ($5 in chips)
4ae7cab0: posts small blind $0.02
206a879e: posts big blind $0.05
*** HOLE CARDS ***
Dealt to ca6a4ee8 
Dealt to 4ae7cab0 
Dealt to 206a879e 
Dealt to 3fde18f1 
Dealt to Hero [Qs 6s]
Dealt to ff997675 
3fde18f1: folds
Hero: folds
ff997675: raises $0.05 to $0.1
ca6a4ee8: folds
4ae7cab0: folds
206a879e: calls $0.05
*** FLOP *** [9h 8h 5c]
206a879e: checks
ff997675: checks
*** TURN *** [9h 8h 5c] [4h]
206a879e: checks
ff997675: checks
*** RIVER *** [9h 8h 5c 4h] [9c]
206a879e: checks
ff997675: checks
206a879e: shows [Th Kc] (a pair of Nines)
ff997675: shows [Qc Tc] (a pair of Nines)
*** SHOWDOWN ***
206a879e collected $0.21 from pot
*** SUMMARY ***
Total pot $0.22 | Rake $0.01 | Jackpot $0 | Bingo $0 | Fortune $0 | Tax $0
Board [9h 8h 5c 4h 9c]
Seat 1: ca6a4ee8 (button) folded before Flop (didn't bet)
Seat 2: 4ae7cab0 (small blind) folded before Flop
Seat 3: 206a879e (big blind) showed [Th Kc] and won ($0.21) with a pair of Nines
Seat 4: 3fde18f1 folded before Flop (didn't bet)
Seat 5: Hero folded before Flop (didn't bet)
Seat 6: ff997675 showed [Qc Tc] and lost with a pair of Nines


Poker Hand #RC3812478434: Hold'em No Limit ($0.02/$0.05) - 2025/08/16 23:37:36
Table 'RushAndCash1083694' 6-max Seat #1 is the button
Seat 1: Hero ($13.84 in chips)
Seat 2: 250af0bc ($2.17 in chips)
Seat 3: dd2d083a ($9.97 in chips)
Seat 4: ca6a4ee8 ($11.01 in chips)
Seat 5: 33f3a84f ($21.79 in chips)
Seat 6: 3fde18f1 ($5.12 in chips)
250af0bc: posts small blind $0.02
dd2d083a: posts big blind $0.05
*** HOLE CARDS ***
Dealt to Hero [2h Qh]
Dealt to 250af0bc 
Dealt to dd2d083a 
Dealt to ca6a4ee8 
Dealt to 33f3a84f 
Dealt to 3fde18f1 
ca6a4ee8: folds
33f3a84f: folds
3fde18f1: raises $0.05 to $0.1
Hero: raises $0.05 to $0.15
250af0bc: folds
dd2d083a: folds
3fde18f1: calls $0.05
*** FLOP *** [Ah As Tc]
3fde18f1: checks
Hero: checks
*** TURN *** [Ah As Tc] [Ts]
3fde18f1: bets $0.13
Hero: folds
Uncalled bet ($0.13) returned to 3fde18f1
*** SHOWDOWN ***
3fde18f1 collected $0.36 from pot
*** SUMMARY ***
Total pot $0.37 | Rake $0.01 | Jackpot $0 | Bingo $0 | Fortune $0 | Tax $0
Board [Ah As Tc Ts]
Seat 1: Hero (button) folded on the Turn
Seat 2: 250af0bc (small blind) folded before Flop
Seat 3: dd2d083a (big blind) folded before Flop
Seat 4: ca6a4ee8 folded before Flop (didn't bet)
Seat 5: 33f3a84f folded before Flop (didn't bet)
Seat 6: 3fde18f1 won ($0.36)


Poker Hand #RC3812478410: Hold'em No Limit ($0.02/$0.05) - 2025/08/16 23:37:33
Table 'RushAndCash1083670' 6-max Seat #1 is the button
Seat 1: 2cd181a6 ($11.86 in chips)
Seat 2: adc4285d ($10.89 in chips)
Seat 3: 35cab0e7 ($7.84 in chips)
Seat 4: b1f919e1 ($5.22 in chips)
Seat 5: Hero ($13.84 in chips)
Seat 6: 5917f0c8 ($13.41 in chips)
adc4285d: posts small blind $0.02
35cab0e7: posts big blind $0.05
*** HOLE CARDS ***
Dealt to 2cd181a6 
Dealt to adc4285d 
Dealt to 35cab0e7 
Dealt to b1f919e1 
Dealt to Hero [5h 9c]
Dealt to 5917f0c8 
b1f919e1: folds
Hero: folds
5917f0c8: folds
2cd181a6: folds
adc4285d: raises $0.06 to $0.11
35cab0e7: raises $0.34 to $0.45
adc4285d: raises $0.7 to $1.15
35cab0e7: folds
Uncalled bet ($0.7) returned to adc4285d
*** SHOWDOWN ***
adc4285d collected $0.86 from pot
*** SUMMARY ***
Total pot $0.9 | Rake $0.04 | Jackpot $0 | Bingo $0 | Fortune $0 | Tax $0
Seat 1: 2cd181a6 (button) folded before Flop (didn't bet)
Seat 2: adc4285d (small blind) collected ($0.86)
Seat 3: 35cab0e7 (big blind) folded before Flop
Seat 4: b1f919e1 folded before Flop (didn't bet)
Seat 5: Hero folded before Flop (didn't bet)
Seat 6: 5917f0c8 folded before Flop (didn't bet)


Poker Hand #RC3812478386: Hold'em No Limit ($0.02/$0.05) - 2025/08/16 23:37:29
Table 'RushAndCash1083646' 6-max Seat #1 is the button
Seat 1: 4bde28e1 ($6.1 in chips)
Seat 2: d61c7236 ($5.18 in chips)
Seat 3: e9537cbb ($8.38 in chips)
Seat 4: b47d45d ($9.98 in chips)
Seat 5: Hero ($13.84 in chips)
Seat 6: c2818c57 ($6.51 in chips)
d61c7236: posts small blind $0.02
e9537cbb: posts big blind $0.05
*** HOLE CARDS ***
Dealt to 4bde28e1 
Dealt to d61c7236 
Dealt to e9537cbb 
Dealt to b47d45d 
Dealt to Hero [9c 4s]
Dealt to c2818c57 
b47d45d: folds
Hero: folds
c2818c57: folds
4bde28e1: raises $0.06 to $0.11
d61c7236: folds
e9537cbb: folds
Uncalled bet ($0.06) returned to 4bde28e1
*** SHOWDOWN ***
4bde28e1 collected $0.12 from pot
*** SUMMARY ***
Total pot $0.12 | Rake $0 | Jackpot $0 | Bingo $0 | Fortune $0 | Tax $0
Seat 1: 4bde28e1 (button) collected ($0.12)
Seat 2: d61c7236 (small blind) folded before Flop
Seat 3: e9537cbb (big blind) folded before Flop
Seat 4: b47d45d folded before Flop (didn't bet)
Seat 5: Hero folded before Flop (didn't bet)
Seat 6: c2818c57 folded before Flop (didn't bet)


Poker Hand #RC3812477918: Hold'em No Limit ($0.02/$0.05) - 2025/08/16 23:36:25
Table 'RushAndCash1083178' 6-max Seat #1 is the button
Seat 1: c538a18f ($4.03 in chips)
Seat 2: 58d59aff ($11.04 in chips)
Seat 3: Hero ($13.94 in chips)
Seat 4: 584e5515 ($4.7 in chips)
Seat 5: d6d9d101 ($6.1 in chips)
Seat 6: b47d45d ($8.54 in chips)
58d59aff: posts small blind $0.02
Hero: posts big blind $0.05
*** HOLE CARDS ***
Dealt to c538a18f 
Dealt to 58d59aff 
Dealt to Hero [As Qh]
Dealt to 584e5515 
Dealt to d6d9d101 
Dealt to b47d45d 
584e5515: folds
d6d9d101: folds
b47d45d: raises $0.05 to $0.1
c538a18f: calls $0.1
58d59aff: folds
Hero: calls $0.05
*** FLOP *** [8d Kc Th]
Hero: checks
b47d45d: bets $0.16
c538a18f: raises $0.64 to $0.8
Hero: folds
b47d45d: calls $0.64
*** TURN *** [8d Kc Th] [3h]
b47d45d: checks
c538a18f: checks
*** RIVER *** [8d Kc Th 3h] [8c]
b47d45d: checks
c538a18f: bets $0.64
b47d45d: calls $0.64
c538a18f: shows [Kd 9c] (two pair, Kings and Eights)
b47d45d: shows [Ac Ks] (two pair, Kings and Eights)
*** SHOWDOWN ***
b47d45d collected $2.98 from pot
*** SUMMARY ***
Total pot $3.2 | Rake $0.15 | Jackpot $0.07 | Bingo $0 | Fortune $0 | Tax $0
Board [8d Kc Th 3h 8c]
Seat 1: c538a18f (button) showed [Kd 9c] and lost with two pair, Kings and Eights
Seat 2: 58d59aff (small blind) folded before Flop
Seat 3: Hero (big blind) folded on the Flop
Seat 4: 584e5515 folded before Flop (didn't bet)
Seat 5: d6d9d101 folded before Flop (didn't bet)
Seat 6: b47d45d showed [Ac Ks] and won ($2.98) with two pair, Kings and Eights


Poker Hand #RC3812477796: Hold'em No Limit ($0.02/$0.05) - 2025/08/16 23:36:09
Table 'RushAndCash1083056' 6-max Seat #1 is the button
Seat 1: a3ad240e ($19 in chips)
Seat 2: 8fbca4d1 ($7.77 in chips)
Seat 3: 60d16038 ($9.26 in chips)
Seat 4: 5cd64818 ($5.12 in chips)
Seat 5: 520dc02a ($5.14 in chips)
Seat 6: Hero ($13.87 in chips)
8fbca4d1: posts small blind $0.02
60d16038: posts big blind $0.05
*** HOLE CARDS ***
Dealt to a3ad240e 
Dealt to 8fbca4d1 
Dealt to 60d16038 
Dealt to 5cd64818 
Dealt to 520dc02a 
Dealt to Hero [Qs Th]
5cd64818: folds
520dc02a: folds
Hero: raises $0.05 to $0.1
a3ad240e: folds
8fbca4d1: folds
60d16038: folds
Uncalled bet ($0.05) returned to Hero
*** SHOWDOWN ***
Hero collected $0.12 from pot
*** SUMMARY ***
Total pot $0.12 | Rake $0 | Jackpot $0 | Bingo $0 | Fortune $0 | Tax $0
Seat 1: a3ad240e (button) folded before Flop (didn't bet)
Seat 2: 8fbca4d1 (small blind) folded before Flop
Seat 3: 60d16038 (big blind) folded before Flop
Seat 4: 5cd64818 folded before Flop (didn't bet)
Seat 5: 520dc02a folded before Flop (didn't bet)
Seat 6: Hero collected ($0.12)


Poker Hand #RC3812477772: Hold'em No Limit ($0.02/$0.05) - 2025/08/16 23:36:05
Table 'RushAndCash1083032' 6-max Seat #1 is the button
Seat 1: 5cd64818 ($5.12 in chips)
Seat 2: 3f7fd703 ($5 in chips)
Seat 3: 66df01e4 ($10.47 in chips)
Seat 4: 520dc02a ($5.14 in chips)
Seat 5: Hero ($13.87 in chips)
Seat 6: a3ad240e ($19 in chips)
3f7fd703: posts small blind $0.02
66df01e4: posts big blind $0.05
*** HOLE CARDS ***
Dealt to 5cd64818 
Dealt to 3f7fd703 
Dealt to 66df01e4 
Dealt to 520dc02a 
Dealt to Hero [8h 7s]
Dealt to a3ad240e 
520dc02a: folds
Hero: folds
a3ad240e: folds
5cd64818: folds
3f7fd703: raises $0.08 to $0.13
66df01e4: folds
Uncalled bet ($0.08) returned to 3f7fd703
*** SHOWDOWN ***
3f7fd703 collected $0.1 from pot
*** SUMMARY ***
Total pot $0.1 | Rake $0 | Jackpot $0 | Bingo $0 | Fortune $0 | Tax $0
Seat 1: 5cd64818 (button) folded before Flop (didn't bet)
Seat 2: 3f7fd703 (small blind) collected ($0.1)
Seat 3: 66df01e4 (big blind) folded before Flop
Seat 4: 520dc02a folded before Flop (didn't bet)
Seat 5: Hero folded before Flop (didn't bet)
Seat 6: a3ad240e folded before Flop (didn't bet)


Poker Hand #RC3812477743: Hold'em No Limit ($0.02/$0.05) - 2025/08/16 23:36:01
Table 'RushAndCash1083003' 6-max Seat #1 is the button
Seat 1: 8a793748 ($6.37 in chips)
Seat 2: 71b30dd8 ($5.7 in chips)
Seat 3: c370b78c ($5.79 in chips)
Seat 4: Hero ($13.87 in chips)
Seat 5: c5d64856 ($5.17 in chips)
Seat 6: dfdf1bff ($10.49 in chips)
71b30dd8: posts small blind $0.02
c370b78c: posts big blind $0.05
*** HOLE CARDS ***
Dealt to 8a793748 
Dealt to 71b30dd8 
Dealt to c370b78c 
Dealt to Hero [4h 2d]
Dealt to c5d64856 
Dealt to dfdf1bff 
Hero: folds
c5d64856: folds
dfdf1bff: folds
8a793748: folds
71b30dd8: folds
Uncalled bet ($0.03) returned to c370b78c
*** SHOWDOWN ***
c370b78c collected $0.04 from pot
*** SUMMARY ***
Total pot $0.04 | Rake $0 | Jackpot $0 | Bingo $0 | Fortune $0 | Tax $0
Seat 1: 8a793748 (button) folded before Flop (didn't bet)
Seat 2: 71b30dd8 (small blind) folded before Flop
Seat 3: c370b78c (big blind) collected ($0.04)
Seat 4: Hero folded before Flop (didn't bet)
Seat 5: c5d64856 folded before Flop (didn't bet)
Seat 6: dfdf1bff folded before Flop (didn't bet)


Poker Hand #RC3812477676: Hold'em No Limit ($0.02/$0.05) - 2025/08/16 23:35:51
Table 'RushAndCash1082936' 6-max Seat #1 is the button
Seat 1: a24605b2 ($5.18 in chips)
Seat 2: 16b5f56b ($5 in chips)
Seat 3: Hero ($13.85 in chips)
Seat 4: 6f2b1159 ($5 in chips)
Seat 5: 2cd181a6 ($11.62 in chips)
Seat 6: 31c033f4 ($15.33 in chips)
16b5f56b: posts small blind $0.02
Hero: posts big blind $0.05
*** HOLE CARDS ***
Dealt to a24605b2 
Dealt to 16b5f56b 
Dealt to Hero [Td Ah]
Dealt to 6f2b1159 
Dealt to 2cd181a6 
Dealt to 31c033f4 
6f2b1159: folds
2cd181a6: folds
31c033f4: folds
a24605b2: folds
16b5f56b: folds
Uncalled bet ($0.03) returned to Hero
*** SHOWDOWN ***
Hero collected $0.04 from pot
*** SUMMARY ***
Total pot $0.04 | Rake $0 | Jackpot $0 | Bingo $0 | Fortune $0 | Tax $0
Seat 1: a24605b2 (button) folded before Flop (didn't bet)
Seat 2: 16b5f56b (small blind) folded before Flop
Seat 3: Hero (big blind) collected ($0.04)
Seat 4: 6f2b1159 folded before Flop (didn't bet)
Seat 5: 2cd181a6 folded before Flop (didn't bet)
Seat 6: 31c033f4 folded before Flop (didn't bet)


Poker Hand #RC3812477627: Hold'em No Limit ($0.02/$0.05) - 2025/08/16 23:35:44
Table 'RushAndCash1082887' 6-max Seat #1 is the button
Seat 1: 44245980 ($6.08 in chips)
Seat 2: Hero ($13.87 in chips)
Seat 3: c0bb45c9 ($9 in chips)
Seat 4: 66df01e4 ($10.49 in chips)
Seat 5: 8fbca4d1 ($7.63 in chips)
Seat 6: 4c48649e ($3.61 in chips)
Hero: posts small blind $0.02
c0bb45c9: posts big blind $0.05
*** HOLE CARDS ***
Dealt to 44245980 
Dealt to Hero [8c 3d]
Dealt to c0bb45c9 
Dealt to 66df01e4 
Dealt to 8fbca4d1 
Dealt to 4c48649e 
66df01e4: folds
8fbca4d1: raises $0.13 to $0.18
4c48649e: folds
44245980: folds
Hero: folds
c0bb45c9: folds
Uncalled bet ($0.13) returned to 8fbca4d1
*** SHOWDOWN ***
8fbca4d1 collected $0.12 from pot
*** SUMMARY ***
Total pot $0.12 | Rake $0 | Jackpot $0 | Bingo $0 | Fortune $0 | Tax $0
Seat 1: 44245980 (button) folded before Flop (didn't bet)
Seat 2: Hero (small blind) folded before Flop
Seat 3: c0bb45c9 (big blind) folded before Flop
Seat 4: 66df01e4 folded before Flop (didn't bet)
Seat 5: 8fbca4d1 collected ($0.12)
Seat 6: 4c48649e folded before Flop (didn't bet)


Poker Hand #RC3812477119: Hold'em No Limit ($0.02/$0.05) - 2025/08/16 23:34:38
Table 'RushAndCash1082379' 6-max Seat #1 is the button
Seat 1: Hero ($13.94 in chips)
Seat 2: 19c34900 ($5.6 in chips)
Seat 3: 281a8acb ($3.57 in chips)
Seat 4: 8fbca4d1 ($7.7 in chips)
Seat 5: d6ffe152 ($6.97 in chips)
Seat 6: a1f8d1c4 ($6.63 in chips)
19c34900: posts small blind $0.02
281a8acb: posts big blind $0.05
*** HOLE CARDS ***
Dealt to Hero [Ah Ts]
Dealt to 19c34900 
Dealt to 281a8acb 
Dealt to 8fbca4d1 
Dealt to d6ffe152 
Dealt to a1f8d1c4 
8fbca4d1: raises $0.13 to $0.18
d6ffe152: folds
a1f8d1c4: folds
Hero: calls $0.18
19c34900: folds
281a8acb: folds
*** FLOP *** [Th 5h 2d]
8fbca4d1: bets $0.43
Hero: calls $0.43
*** TURN *** [Th 5h 2d] [7c]
8fbca4d1: bets $1.29
Hero: calls $1.29
*** RIVER *** [Th 5h 2d 7c] [6c]
8fbca4d1: checks
Hero: checks
8fbca4d1: shows [Td Ac] (a pair of Tens)
Hero: shows [Ah Ts] (a pair of Tens)
*** SHOWDOWN ***
8fbca4d1 collected $1.83 from pot
Hero collected $1.83 from pot
*** SUMMARY ***
Total pot $3.87 | Rake $0.14 | Jackpot $0.07 | Bingo $0 | Fortune $0 | Tax $0
Board [Th 5h 2d 7c 6c]
Seat 1: Hero (button) showed [Ah Ts] and won ($1.83) with a pair of Tens
Seat 2: 19c34900 (small blind) folded before Flop
Seat 3: 281a8acb (big blind) folded before Flop
Seat 4: 8fbca4d1 showed [Td Ac] and won ($1.83) with a pair of Tens
Seat 5: d6ffe152 folded before Flop (didn't bet)
Seat 6: a1f8d1c4 folded before Flop (didn't bet)


Poker Hand #RC3812477086: Hold'em No Limit ($0.02/$0.05) - 2025/08/16 23:34:34
Table 'RushAndCash1082346' 6-max Seat #1 is the button
Seat 1: ca2c3937 ($8.65 in chips)
Seat 2: 821e3b2c ($8.01 in chips)
Seat 3: d140874d ($13.52 in chips)
Seat 4: 2cb5ed63 ($5.7 in chips)
Seat 5: cc4d0685 ($6.14 in chips)
Seat 6: Hero ($13.94 in chips)
821e3b2c: posts small blind $0.02
d140874d: posts big blind $0.05
*** HOLE CARDS ***
Dealt to ca2c3937 
Dealt to 821e3b2c 
Dealt to d140874d 
Dealt to 2cb5ed63 
Dealt to cc4d0685 
Dealt to Hero [4s 4h]
2cb5ed63: folds
cc4d0685: folds
Hero: folds
ca2c3937: raises $0.05 to $0.1
821e3b2c: folds
d140874d: folds
Uncalled bet ($0.05) returned to ca2c3937
*** SHOWDOWN ***
ca2c3937 collected $0.12 from pot
*** SUMMARY ***
Total pot $0.12 | Rake $0 | Jackpot $0 | Bingo $0 | Fortune $0 | Tax $0
Seat 1: ca2c3937 (button) collected ($0.12)
Seat 2: 821e3b2c (small blind) folded before Flop
Seat 3: d140874d (big blind) folded before Flop
Seat 4: 2cb5ed63 folded before Flop (didn't bet)
Seat 5: cc4d0685 folded before Flop (didn't bet)
Seat 6: Hero folded before Flop (didn't bet)


Poker Hand #RC3812477045: Hold'em No Limit ($0.02/$0.05) - 2025/08/16 23:34:28
Table 'RushAndCash1082305' 6-max Seat #1 is the button
Seat 1: 13fae3ee ($5.09 in chips)
Seat 2: beafddcf ($6.69 in chips)
Seat 3: cee7325a ($4.36 in chips)
Seat 4: 1c53873e ($5.16 in chips)
Seat 5: Hero ($13.94 in chips)
Seat 6: c8cb489c ($6.83 in chips)
beafddcf: posts small blind $0.02
cee7325a: posts big blind $0.05
*** HOLE CARDS ***
Dealt to 13fae3ee 
Dealt to beafddcf 
Dealt to cee7325a 
Dealt to 1c53873e 
Dealt to Hero [4c 2c]
Dealt to c8cb489c 
1c53873e: folds
Hero: folds
c8cb489c: folds
13fae3ee: folds
beafddcf: raises $0.1 to $0.15
cee7325a: folds
Uncalled bet ($0.1) returned to beafddcf
*** SHOWDOWN ***
beafddcf collected $0.1 from pot
*** SUMMARY ***
Total pot $0.1 | Rake $0 | Jackpot $0 | Bingo $0 | Fortune $0 | Tax $0
Seat 1: 13fae3ee (button) folded before Flop (didn't bet)
Seat 2: beafddcf (small blind) collected ($0.1)
Seat 3: cee7325a (big blind) folded before Flop
Seat 4: 1c53873e folded before Flop (didn't bet)
Seat 5: Hero folded before Flop (didn't bet)
Seat 6: c8cb489c folded before Flop (didn't bet)


Poker Hand #RC3812476931: Hold'em No Limit ($0.02/$0.05) - 2025/08/16 23:34:12
Table 'RushAndCash1082191' 6-max Seat #1 is the button
Seat 1: e9783655 ($6.23 in chips)
Seat 2: af0142ec ($5 in chips)
Seat 3: Hero ($13.99 in chips)
Seat 4: 437ee4ed ($6.1 in chips)
Seat 5: ba885c24 ($19.05 in chips)
Seat 6: 564134e6 ($1.96 in chips)
af0142ec: posts small blind $0.02
Hero: posts big blind $0.05
*** HOLE CARDS ***
Dealt to e9783655 
Dealt to af0142ec 
Dealt to Hero [9d Qh]
Dealt to 437ee4ed 
Dealt to ba885c24 
Dealt to 564134e6 
437ee4ed: folds
ba885c24: folds
564134e6: raises $0.07 to $0.12
e9783655: folds
af0142ec: folds
Hero: folds
Uncalled bet ($0.07) returned to 564134e6
*** SHOWDOWN ***
564134e6 collected $0.12 from pot
*** SUMMARY ***
Total pot $0.12 | Rake $0 | Jackpot $0 | Bingo $0 | Fortune $0 | Tax $0
Seat 1: e9783655 (button) folded before Flop (didn't bet)
Seat 2: af0142ec (small blind) folded before Flop
Seat 3: Hero (big blind) folded before Flop
Seat 4: 437ee4ed folded before Flop (didn't bet)
Seat 5: ba885c24 folded before Flop (didn't bet)
Seat 6: 564134e6 collected ($0.12)


Poker Hand #RC3812476901: Hold'em No Limit ($0.02/$0.05) - 2025/08/16 23:34:08
Table 'RushAndCash1082161' 6-max Seat #1 is the button
Seat 1: Hero ($13.99 in chips)
Seat 2: e8f3d79 ($6.4 in chips)
Seat 3: 8fbca4d1 ($7.21 in chips)
Seat 4: 30a7bd78 ($6.39 in chips)
Seat 5: 19c34900 ($6.19 in chips)
Seat 6: cba824df ($7.48 in chips)
e8f3d79: posts small blind $0.02
8fbca4d1: posts big blind $0.05
*** HOLE CARDS ***
Dealt to Hero [5d Kh]
Dealt to e8f3d79 
Dealt to 8fbca4d1 
Dealt to 30a7bd78 
Dealt to 19c34900 
Dealt to cba824df 
30a7bd78: folds
19c34900: raises $0.05 to $0.1
cba824df: folds
Hero: folds
e8f3d79: folds
8fbca4d1: calls $0.05
*** FLOP *** [5c Qc Ts]
8fbca4d1: checks
19c34900: bets $0.11
8fbca4d1: calls $0.11
*** TURN *** [5c Qc Ts] [3h]
8fbca4d1: checks
19c34900: bets $0.33
8fbca4d1: calls $0.33
*** RIVER *** [5c Qc Ts 3h] [4h]
8fbca4d1: checks
19c34900: checks
8fbca4d1: shows [Qd 9d] (a pair of Queens)
19c34900: shows [Js Ad] (Ace high)
*** SHOWDOWN ***
8fbca4d1 collected $1.05 from pot
*** SUMMARY ***
Total pot $1.1 | Rake $0.05 | Jackpot $0 | Bingo $0 | Fortune $0 | Tax $0
Board [5c Qc Ts 3h 4h]
Seat 1: Hero (button) folded before Flop (didn't bet)
Seat 2: e8f3d79 (small blind) folded before Flop
Seat 3: 8fbca4d1 (big blind) showed [Qd 9d] and won ($1.05) with a pair of Queens
Seat 4: 30a7bd78 folded before Flop (didn't bet)
Seat 5: 19c34900 showed [Js Ad] and lost with Ace high
Seat 6: cba824df folded before Flop (didn't bet)


Poker Hand #RC3812476829: Hold'em No Limit ($0.02/$0.05) - 2025/08/16 23:33:58
Table 'RushAndCash1082089' 6-max Seat #1 is the button
Seat 1: bcaf1449 ($9.8 in chips)
Seat 2: Hero ($14.01 in chips)
Seat 3: 1c53873e ($5.05 in chips)
Seat 4: a4c0e017 ($14.95 in chips)
Seat 5: da900d7a ($13.74 in chips)
Seat 6: 7aef4ae5 ($5.29 in chips)
Hero: posts small blind $0.02
1c53873e: posts big blind $0.05
*** HOLE CARDS ***
Dealt to bcaf1449 
Dealt to Hero [8h 7d]
Dealt to 1c53873e 
Dealt to a4c0e017 
Dealt to da900d7a 
Dealt to 7aef4ae5 
a4c0e017: folds
da900d7a: folds
7aef4ae5: folds
bcaf1449: raises $0.08 to $0.13
Hero: folds
1c53873e: folds
Uncalled bet ($0.08) returned to bcaf1449
*** SHOWDOWN ***
bcaf1449 collected $0.12 from pot
*** SUMMARY ***
Total pot $0.12 | Rake $0 | Jackpot $0 | Bingo $0 | Fortune $0 | Tax $0
Seat 1: bcaf1449 (button) collected ($0.12)
Seat 2: Hero (small blind) folded before Flop
Seat 3: 1c53873e (big blind) folded before Flop
Seat 4: a4c0e017 folded before Flop (didn't bet)
Seat 5: da900d7a folded before Flop (didn't bet)
Seat 6: 7aef4ae5 folded before Flop (didn't bet)


Poker Hand #RC3812476517: Hold'em No Limit ($0.02/$0.05) - 2025/08/16 23:33:19
Table 'RushAndCash1081777' 6-max Seat #1 is the button
Seat 1: 4d5acc21 ($7.34 in chips)
Seat 2: b1f919e1 ($5.07 in chips)
Seat 3: c2818c57 ($5 in chips)
Seat 4: e285be9a ($13.07 in chips)
Seat 5: 370bf11f ($7.43 in chips)
Seat 6: Hero ($13.9 in chips)
b1f919e1: posts small blind $0.02
c2818c57: posts big blind $0.05
*** HOLE CARDS ***
Dealt to 4d5acc21 
Dealt to b1f919e1 
Dealt to c2818c57 
Dealt to e285be9a 
Dealt to 370bf11f 
Dealt to Hero [Kc Jc]
e285be9a: folds
370bf11f: folds
Hero: raises $0.05 to $0.1
4d5acc21: folds
b1f919e1: folds
c2818c57: calls $0.05
*** FLOP *** [5s Jd Kh]
c2818c57: checks
Hero: bets $0.07
c2818c57: folds
Uncalled bet ($0.07) returned to Hero
*** SHOWDOWN ***
Hero collected $0.21 from pot
*** SUMMARY ***
Total pot $0.22 | Rake $0.01 | Jackpot $0 | Bingo $0 | Fortune $0 | Tax $0
Board [5s Jd Kh]
Seat 1: 4d5acc21 (button) folded before Flop (didn't bet)
Seat 2: b1f919e1 (small blind) folded before Flop
Seat 3: c2818c57 (big blind) folded on the Flop
Seat 4: e285be9a folded before Flop (didn't bet)
Seat 5: 370bf11f folded before Flop (didn't bet)
Seat 6: Hero won ($0.21)


Poker Hand #RC3812476168: Hold'em No Limit ($0.02/$0.05) - 2025/08/16 23:32:36
Table 'RushAndCash1081428' 6-max Seat #1 is the button
Seat 1: d71bbb36 ($9.86 in chips)
Seat 2: dcc428e3 ($3.88 in chips)
Seat 3: b1f919e1 ($5.17 in chips)
Seat 4: acaedc6c ($4.66 in chips)
Seat 5: 6ec47996 ($7.64 in chips)
Seat 6: Hero ($13.71 in chips)
dcc428e3: posts small blind $0.02
b1f919e1: posts big blind $0.05
*** HOLE CARDS ***
Dealt to d71bbb36 
Dealt to dcc428e3 
Dealt to b1f919e1 
Dealt to acaedc6c 
Dealt to 6ec47996 
Dealt to Hero [Th Td]
acaedc6c: folds
6ec47996: folds
Hero: raises $0.05 to $0.1
d71bbb36: folds
dcc428e3: calls $0.08
b1f919e1: calls $0.05
*** FLOP *** [4d Tc Ad]
dcc428e3: checks
b1f919e1: checks
Hero: bets $0.15
dcc428e3: folds
b1f919e1: folds
Uncalled bet ($0.15) returned to Hero
*** SHOWDOWN ***
Hero collected $0.29 from pot
*** SUMMARY ***
Total pot $0.3 | Rake $0.01 | Jackpot $0 | Bingo $0 | Fortune $0 | Tax $0
Board [4d Tc Ad]
Seat 1: d71bbb36 (button) folded before Flop (didn't bet)
Seat 2: dcc428e3 (small blind) folded on the Flop
Seat 3: b1f919e1 (big blind) folded on the Flop
Seat 4: acaedc6c folded before Flop (didn't bet)
Seat 5: 6ec47996 folded before Flop (didn't bet)
Seat 6: Hero won ($0.29)


Poker Hand #RC3812476108: Hold'em No Limit ($0.02/$0.05) - 2025/08/16 23:32:29
Table 'RushAndCash1081368' 6-max Seat #1 is the button
Seat 1: Hero ($13.71 in chips)
Seat 2: 35cab0e7 ($8.29 in chips)
Seat 3: 1656660f ($6.09 in chips)
Seat 4: bc28ebe8 ($12.22 in chips)
Seat 5: d6bdbdc4 ($5.17 in chips)
Seat 6: 436b8683 ($5.18 in chips)
35cab0e7: posts small blind $0.02
1656660f: posts big blind $0.05
*** HOLE CARDS ***
Dealt to Hero [3h Qc]
Dealt to 35cab0e7 
Dealt to 1656660f 
Dealt to bc28ebe8 
Dealt to d6bdbdc4 
Dealt to 436b8683 
bc28ebe8: folds
d6bdbdc4: folds
436b8683: folds
Hero: folds
35cab0e7: folds
Uncalled bet ($0.03) returned to 1656660f
*** SHOWDOWN ***
1656660f collected $0.04 from pot
*** SUMMARY ***
Total pot $0.04 | Rake $0 | Jackpot $0 | Bingo $0 | Fortune $0 | Tax $0
Seat 1: Hero (button) folded before Flop (didn't bet)
Seat 2: 35cab0e7 (small blind) folded before Flop
Seat 3: 1656660f (big blind) collected ($0.04)
Seat 4: bc28ebe8 folded before Flop (didn't bet)
Seat 5: d6bdbdc4 folded before Flop (didn't bet)
Seat 6: 436b8683 folded before Flop (didn't bet)


Poker Hand #RC3812476076: Hold'em No Limit ($0.02/$0.05) - 2025/08/16 23:32:25
Table 'RushAndCash1081336' 6-max Seat #1 is the button
Seat 1: cee7325a ($4.5 in chips)
Seat 2: 83a66d1b ($6.63 in chips)
Seat 3: 222c39c7 ($5.27 in chips)
Seat 4: 3f30f128 ($10.23 in chips)
Seat 5: Hero ($13.71 in chips)
Seat 6: 38b3dce8 ($6.1 in chips)
83a66d1b: posts small blind $0.02
222c39c7: posts big blind $0.05
*** HOLE CARDS ***
Dealt to cee7325a 
Dealt to 83a66d1b 
Dealt to 222c39c7 
Dealt to 3f30f128 
Dealt to Hero [4h Tc]
Dealt to 38b3dce8 
3f30f128: folds
Hero: folds
38b3dce8: raises $0.08 to $0.13
cee7325a: calls $0.13
83a66d1b: folds
222c39c7: folds
*** FLOP *** [Jd 6c 5h]
38b3dce8: bets $0.17
cee7325a: folds
Uncalled bet ($0.17) returned to 38b3dce8
*** SHOWDOWN ***
38b3dce8 collected $0.32 from pot
*** SUMMARY ***
Total pot $0.33 | Rake $0.01 | Jackpot $0 | Bingo $0 | Fortune $0 | Tax $0
Board [Jd 6c 5h]
Seat 1: cee7325a (button) folded on the Flop
Seat 2: 83a66d1b (small blind) folded before Flop
Seat 3: 222c39c7 (big blind) folded before Flop
Seat 4: 3f30f128 folded before Flop (didn't bet)
Seat 5: Hero folded before Flop (didn't bet)
Seat 6: 38b3dce8 won ($0.32)


Poker Hand #RC3812475321: Hold'em No Limit ($0.02/$0.05) - 2025/08/16 23:30:43
Table 'RushAndCash1080581' 6-max Seat #1 is the button
Seat 1: 90083bbe ($5 in chips)
Seat 2: e2247168 ($5.21 in chips)
Seat 3: 468174bd ($8.25 in chips)
Seat 4: Hero ($8.58 in chips)
Seat 5: 6fc5f880 ($5 in chips)
Seat 6: 7c8547fc ($21.93 in chips)
e2247168: posts small blind $0.02
468174bd: posts big blind $0.05
*** HOLE CARDS ***
Dealt to 90083bbe 
Dealt to e2247168 
Dealt to 468174bd 
Dealt to Hero [8c 8s]
Dealt to 6fc5f880 
Dealt to 7c8547fc 
Hero: raises $0.05 to $0.1
6fc5f880: folds
7c8547fc: folds
90083bbe: folds
e2247168: folds
468174bd: calls $0.05
*** FLOP *** [Ah 8d 6s]
468174bd: checks
Hero: bets $0.1
468174bd: raises $0.32 to $0.42
Hero: calls $0.32
*** TURN *** [Ah 8d 6s] [9s]
468174bd: bets $1.25
Hero: calls $1.25
*** RIVER *** [Ah 8d 6s 9s] [2d]
468174bd: bets $3.56
Hero: raises $3.25 to $6.81 and is all-in
468174bd: folds
Uncalled bet ($3.25) returned to Hero
*** SHOWDOWN ***
Hero collected $10.46 from pot
*** SUMMARY ***
Total pot $10.68 | Rake $0.15 | Jackpot $0.07 | Bingo $0 | Fortune $0 | Tax $0
Board [Ah 8d 6s 9s 2d]
Seat 1: 90083bbe (button) folded before Flop (didn't bet)
Seat 2: e2247168 (small blind) folded before Flop
Seat 3: 468174bd (big blind) folded on the River
Seat 4: Hero won ($10.46)
Seat 5: 6fc5f880 folded before Flop (didn't bet)
Seat 6: 7c8547fc folded before Flop (didn't bet)


Poker Hand #RC3812475223: Hold'em No Limit ($0.02/$0.05) - 2025/08/16 23:30:29
Table 'RushAndCash1080483' 6-max Seat #1 is the button
Seat 1: f1ee4b08 ($10.93 in chips)
Seat 2: d4b95f0b ($5.37 in chips)
Seat 3: Hero ($8.63 in chips)
Seat 4: f70ec30d ($5.01 in chips)
Seat 5: e347d4ad ($12.1 in chips)
Seat 6: 82170b33 ($17.47 in chips)
d4b95f0b: posts small blind $0.02
Hero: posts big blind $0.05
*** HOLE CARDS ***
Dealt to f1ee4b08 
Dealt to d4b95f0b 
Dealt to Hero [Qh 3c]
Dealt to f70ec30d 
Dealt to e347d4ad 
Dealt to 82170b33 
f70ec30d: folds
e347d4ad: folds
82170b33: folds
f1ee4b08: raises $0.05 to $0.1
d4b95f0b: folds
Hero: folds
Uncalled bet ($0.05) returned to f1ee4b08
*** SHOWDOWN ***
f1ee4b08 collected $0.12 from pot
*** SUMMARY ***
Total pot $0.12 | Rake $0 | Jackpot $0 | Bingo $0 | Fortune $0 | Tax $0
Seat 1: f1ee4b08 (button) collected ($0.12)
Seat 2: d4b95f0b (small blind) folded before Flop
Seat 3: Hero (big blind) folded before Flop
Seat 4: f70ec30d folded before Flop (didn't bet)
Seat 5: e347d4ad folded before Flop (didn't bet)
Seat 6: 82170b33 folded before Flop (didn't bet)


Poker Hand #RC3812475112: Hold'em No Limit ($0.02/$0.05) - 2025/08/16 23:30:13
Table 'RushAndCash1080372' 6-max Seat #1 is the button
Seat 1: d3d9e1af ($7.81 in chips)
Seat 2: Hero ($8.65 in chips)
Seat 3: dba0bd0e ($5.15 in chips)
Seat 4: 4a3e59cc ($4.95 in chips)
Seat 5: c8489c74 ($7.8 in chips)
Seat 6: a6d7494b ($7.13 in chips)
Hero: posts small blind $0.02
dba0bd0e: posts big blind $0.05
*** HOLE CARDS ***
Dealt to d3d9e1af 
Dealt to Hero [Kd 9h]
Dealt to dba0bd0e 
Dealt to 4a3e59cc 
Dealt to c8489c74 
Dealt to a6d7494b 
4a3e59cc: raises $0.08 to $0.13
c8489c74: folds
a6d7494b: folds
d3d9e1af: folds
Hero: folds
dba0bd0e: folds
Uncalled bet ($0.08) returned to 4a3e59cc
*** SHOWDOWN ***
4a3e59cc collected $0.12 from pot
*** SUMMARY ***
Total pot $0.12 | Rake $0 | Jackpot $0 | Bingo $0 | Fortune $0 | Tax $0
Seat 1: d3d9e1af (button) folded before Flop (didn't bet)
Seat 2: Hero (small blind) folded before Flop
Seat 3: dba0bd0e (big blind) folded before Flop
Seat 4: 4a3e59cc collected ($0.12)
Seat 5: c8489c74 folded before Flop (didn't bet)
Seat 6: a6d7494b folded before Flop (didn't bet)


Poker Hand #RC3812475071: Hold'em No Limit ($0.02/$0.05) - 2025/08/16 23:30:08
Table 'RushAndCash1080331' 6-max Seat #1 is the button
Seat 1: adc4285d ($15.3 in chips)
Seat 2: a9ceab4e ($5.87 in chips)
Seat 3: cc4f99d ($5 in chips)
Seat 4: 89130aff ($5 in chips)
Seat 5: 3dc9b1ad ($5 in chips)
Seat 6: Hero ($8.65 in chips)
a9ceab4e: posts small blind $0.02
cc4f99d: posts big blind $0.05
*** HOLE CARDS ***
Dealt to adc4285d 
Dealt to a9ceab4e 
Dealt to cc4f99d 
Dealt to 89130aff 
Dealt to 3dc9b1ad 
Dealt to Hero [9s Kh]
89130aff: raises $0.05 to $0.1
3dc9b1ad: folds
Hero: folds
adc4285d: folds
a9ceab4e: folds
cc4f99d: folds
Uncalled bet ($0.05) returned to 89130aff
*** SHOWDOWN ***
89130aff collected $0.12 from pot
*** SUMMARY ***
Total pot $0.12 | Rake $0 | Jackpot $0 | Bingo $0 | Fortune $0 | Tax $0
Seat 1: adc4285d (button) folded before Flop (didn't bet)
Seat 2: a9ceab4e (small blind) folded before Flop
Seat 3: cc4f99d (big blind) folded before Flop
Seat 4: 89130aff collected ($0.12)
Seat 5: 3dc9b1ad folded before Flop (didn't bet)
Seat 6: Hero folded before Flop (didn't bet)


Poker Hand #RC3812474997: Hold'em No Limit ($0.02/$0.05) - 2025/08/16 23:29:58
Table 'RushAndCash1080257' 6-max Seat #1 is the button
Seat 1: Hero ($8.65 in chips)
Seat 2: 3812131a ($11.71 in chips)
Seat 3: 6f2b1159 ($5.43 in chips)
Seat 4: b47ed6ee ($5.1 in chips)
Seat 5: d653541d ($4.9 in chips)
Seat 6: a1ba8d52 ($9.33 in chips)
3812131a: posts small blind $0.02
6f2b1159: posts big blind $0.05
*** HOLE CARDS ***
Dealt to Hero [8c 4h]
Dealt to 3812131a 
Dealt to 6f2b1159 
Dealt to b47ed6ee 
Dealt to d653541d 
Dealt to a1ba8d52 
b47ed6ee: folds
d653541d: folds
a1ba8d52: folds
Hero: folds
3812131a: folds
Uncalled bet ($0.03) returned to 6f2b1159
*** SHOWDOWN ***
6f2b1159 collected $0.04 from pot
*** SUMMARY ***
Total pot $0.04 | Rake $0 | Jackpot $0 | Bingo $0 | Fortune $0 | Tax $0
Seat 1: Hero (button) folded before Flop (didn't bet)
Seat 2: 3812131a (small blind) folded before Flop
Seat 3: 6f2b1159 (big blind) collected ($0.04)
Seat 4: b47ed6ee folded before Flop (didn't bet)
Seat 5: d653541d folded before Flop (didn't bet)
Seat 6: a1ba8d52 folded before Flop (didn't bet)


Poker Hand #RC3812474936: Hold'em No Limit ($0.02/$0.05) - 2025/08/16 23:29:50
Table 'RushAndCash1080196' 6-max Seat #1 is the button
Seat 1: d6b9968d ($7.34 in chips)
Seat 2: 42cd8071 ($7.79 in chips)
Seat 3: Hero ($8.63 in chips)
Seat 4: b84f55ca ($5 in chips)
Seat 5: 5163d6d4 ($7.73 in chips)
Seat 6: ce835e9f ($4.68 in chips)
42cd8071: posts small blind $0.02
Hero: posts big blind $0.05
*** HOLE CARDS ***
Dealt to d6b9968d 
Dealt to 42cd8071 
Dealt to Hero [4c 8h]
Dealt to b84f55ca 
Dealt to 5163d6d4 
Dealt to ce835e9f 
b84f55ca: folds
5163d6d4: folds
ce835e9f: folds
d6b9968d: folds
42cd8071: folds
Uncalled bet ($0.03) returned to Hero
*** SHOWDOWN ***
Hero collected $0.04 from pot
*** SUMMARY ***
Total pot $0.04 | Rake $0 | Jackpot $0 | Bingo $0 | Fortune $0 | Tax $0
Seat 1: d6b9968d (button) folded before Flop (didn't bet)
Seat 2: 42cd8071 (small blind) folded before Flop
Seat 3: Hero (big blind) collected ($0.04)
Seat 4: b84f55ca folded before Flop (didn't bet)
Seat 5: 5163d6d4 folded before Flop (didn't bet)
Seat 6: ce835e9f folded before Flop (didn't bet)


Poker Hand #RC3812474907: Hold'em No Limit ($0.02/$0.05) - 2025/08/16 23:29:47
Table 'RushAndCash1080167' 6-max Seat #1 is the button
Seat 1: fcbc6de9 ($3.12 in chips)
Seat 2: d57b353c ($5.21 in chips)
Seat 3: 53cfaa1d ($5.93 in chips)
Seat 4: Hero ($8.63 in chips)
Seat 5: cf4134a8 ($6.07 in chips)
Seat 6: 540edb4b ($7.9 in chips)
d57b353c: posts small blind $0.02
53cfaa1d: posts big blind $0.05
*** HOLE CARDS ***
Dealt to fcbc6de9 
Dealt to d57b353c 
Dealt to 53cfaa1d 
Dealt to Hero [Kc 9s]
Dealt to cf4134a8 
Dealt to 540edb4b 
Hero: folds
cf4134a8: folds
540edb4b: raises $0.05 to $0.1
fcbc6de9: folds
d57b353c: folds
53cfaa1d: folds
Uncalled bet ($0.05) returned to 540edb4b
*** SHOWDOWN ***
540edb4b collected $0.12 from pot
*** SUMMARY ***
Total pot $0.12 | Rake $0 | Jackpot $0 | Bingo $0 | Fortune $0 | Tax $0
Seat 1: fcbc6de9 (button) folded before Flop (didn't bet)
Seat 2: d57b353c (small blind) folded before Flop
Seat 3: 53cfaa1d (big blind) folded before Flop
Seat 4: Hero folded before Flop (didn't bet)
Seat 5: cf4134a8 folded before Flop (didn't bet)
Seat 6: 540edb4b collected ($0.12)


Poker Hand #RC3812474810: Hold'em No Limit ($0.02/$0.05) - 2025/08/16 23:29:34
Table 'RushAndCash1080070' 6-max Seat #1 is the button
Seat 1: cf8b8e7d ($4.8 in chips)
Seat 2: Hero ($8.65 in chips)
Seat 3: 6c3973b1 ($7.55 in chips)
Seat 4: 3f7fd703 ($5.07 in chips)
Seat 5: de277201 ($5 in chips)
Seat 6: 8648b46c ($5.66 in chips)
Hero: posts small blind $0.02
6c3973b1: posts big blind $0.05
*** HOLE CARDS ***
Dealt to cf8b8e7d 
Dealt to Hero [Tc Js]
Dealt to 6c3973b1 
Dealt to 3f7fd703 
Dealt to de277201 
Dealt to 8648b46c 
3f7fd703: folds
de277201: raises $0.06 to $0.11
8648b46c: calls $0.11
cf8b8e7d: folds
Hero: folds
6c3973b1: raises $0.51 to $0.62
de277201: calls $0.51
8648b46c: calls $0.51
*** FLOP *** [2d 6s 5d]
6c3973b1: checks
de277201: checks
8648b46c: checks
*** TURN *** [2d 6s 5d] [3s]
6c3973b1: checks
de277201: checks
8648b46c: bets $1.41
6c3973b1: folds
de277201: folds
Uncalled bet ($1.41) returned to 8648b46c
*** SHOWDOWN ***
8648b46c collected $1.72 from pot
*** SUMMARY ***
Total pot $1.88 | Rake $0.09 | Jackpot $0.07 | Bingo $0 | Fortune $0 | Tax $0
Board [2d 6s 5d 3s]
Seat 1: cf8b8e7d (button) folded before Flop (didn't bet)
Seat 2: Hero (small blind) folded before Flop
Seat 3: 6c3973b1 (big blind) folded on the Turn
Seat 4: 3f7fd703 folded before Flop (didn't bet)
Seat 5: de277201 folded on the Turn
Seat 6: 8648b46c won ($1.72)


Poker Hand #RC3812424725: Hold'em No Limit ($0.02/$0.05) - 2025/08/16 23:29:21
Table 'RushAndCash1079985' 6-max Seat #1 is the button
Seat 1: 4e12ea8c ($1.81 in chips)
Seat 2: 46068b1c ($5.16 in chips)
Seat 3: aca78d98 ($8.08 in chips)
Seat 4: 940fc210 ($5.18 in chips)
Seat 5: Hero ($8.58 in chips)
Seat 6: fe7b6407 ($12.1 in chips)
46068b1c: posts small blind $0.02
aca78d98: posts big blind $0.05
*** HOLE CARDS ***
Dealt to 4e12ea8c 
Dealt to 46068b1c 
Dealt to aca78d98 
Dealt to 940fc210 
Dealt to Hero [8d 7d]
Dealt to fe7b6407 
940fc210: folds
Hero: raises $0.05 to $0.1
fe7b6407: folds
4e12ea8c: folds
46068b1c: folds
aca78d98: folds
Uncalled bet ($0.05) returned to Hero
*** SHOWDOWN ***
Hero collected $0.12 from pot
*** SUMMARY ***
Total pot $0.12 | Rake $0 | Jackpot $0 | Bingo $0 | Fortune $0 | Tax $0
Seat 1: 4e12ea8c (button) folded before Flop (didn't bet)
Seat 2: 46068b1c (small blind) folded before Flop
Seat 3: aca78d98 (big blind) folded before Flop
Seat 4: 940fc210 folded before Flop (didn't bet)
Seat 5: Hero collected ($0.12)
Seat 6: fe7b6407 folded before Flop (didn't bet)


Poker Hand #RC3812424702: Hold'em No Limit ($0.02/$0.05) - 2025/08/16 23:29:18
Table 'RushAndCash1079962' 6-max Seat #1 is the button
Seat 1: bab6154f ($24.97 in chips)
Seat 2: 9bba955a ($10.34 in chips)
Seat 3: 66df01e4 ($5.14 in chips)
Seat 4: 21460470 ($5.33 in chips)
Seat 5: Hero ($8.58 in chips)
Seat 6: b76cb406 ($4.83 in chips)
9bba955a: posts small blind $0.02
66df01e4: posts big blind $0.05
*** HOLE CARDS ***
Dealt to bab6154f 
Dealt to 9bba955a 
Dealt to 66df01e4 
Dealt to 21460470 
Dealt to Hero [3s 7s]
Dealt to b76cb406 
21460470: folds
Hero: folds
b76cb406: folds
bab6154f: raises $0.05 to $0.1
9bba955a: folds
66df01e4: folds
Uncalled bet ($0.05) returned to bab6154f
*** SHOWDOWN ***
bab6154f collected $0.12 from pot
*** SUMMARY ***
Total pot $0.12 | Rake $0 | Jackpot $0 | Bingo $0 | Fortune $0 | Tax $0
Seat 1: bab6154f (button) collected ($0.12)
Seat 2: 9bba955a (small blind) folded before Flop
Seat 3: 66df01e4 (big blind) folded before Flop
Seat 4: 21460470 folded before Flop (didn't bet)
Seat 5: Hero folded before Flop (didn't bet)
Seat 6: b76cb406 folded before Flop (didn't bet)


Poker Hand #RC3812424208: Hold'em No Limit ($0.02/$0.05) - 2025/08/16 23:28:13
Table 'RushAndCash1079468' 6-max Seat #1 is the button
Seat 1: 21460470 ($4.93 in chips)
Seat 2: 4b5dfc09 ($5.28 in chips)
Seat 3: 68a83c99 ($5.05 in chips)
Seat 4: 94e12bc9 ($5.99 in chips)
Seat 5: b76cb406 ($4.42 in chips)
Seat 6: Hero ($8.95 in chips)
4b5dfc09: posts small blind $0.02
68a83c99: posts big blind $0.05
*** HOLE CARDS ***
Dealt to 21460470 
Dealt to 4b5dfc09 
Dealt to 68a83c99 
Dealt to 94e12bc9 
Dealt to b76cb406 
Dealt to Hero [As Qd]
94e12bc9: folds
b76cb406: folds
Hero: raises $0.05 to $0.1
21460470: raises $0.27 to $0.37
4b5dfc09: folds
68a83c99: folds
Hero: calls $0.27
*** FLOP *** [2h 5s 9d]
Hero: checks
21460470: checks
*** TURN *** [2h 5s 9d] [Jh]
Hero: checks
21460470: checks
*** RIVER *** [2h 5s 9d Jh] [Ks]
Hero: checks
21460470: bets $0.41
Hero: folds
Uncalled bet ($0.41) returned to 21460470
*** SHOWDOWN ***
21460470 collected $0.77 from pot
*** SUMMARY ***
Total pot $0.81 | Rake $0.04 | Jackpot $0 | Bingo $0 | Fortune $0 | Tax $0
Board [2h 5s 9d Jh Ks]
Seat 1: 21460470 (button) won ($0.77)
Seat 2: 4b5dfc09 (small blind) folded before Flop
Seat 3: 68a83c99 (big blind) folded before Flop
Seat 4: 94e12bc9 folded before Flop (didn't bet)
Seat 5: b76cb406 folded before Flop (didn't bet)
Seat 6: Hero folded on the River


Poker Hand #RC3812424159: Hold'em No Limit ($0.02/$0.05) - 2025/08/16 23:28:06
Table 'RushAndCash1079419' 6-max Seat #1 is the button
Seat 1: Hero ($8.95 in chips)
Seat 2: cf396bf7 ($16.11 in chips)
Seat 3: dfdf1bff ($8.76 in chips)
Seat 4: 6fc5f880 ($5.12 in chips)
Seat 5: fc10d8a6 ($12.11 in chips)
Seat 6: 8af3b254 ($5.08 in chips)
cf396bf7: posts small blind $0.02
dfdf1bff: posts big blind $0.05
*** HOLE CARDS ***
Dealt to Hero [Kc Th]
Dealt to cf396bf7 
Dealt to dfdf1bff 
Dealt to 6fc5f880 
Dealt to fc10d8a6 
Dealt to 8af3b254 
6fc5f880: folds
fc10d8a6: calls $0.05
8af3b254: folds
Hero: folds
cf396bf7: folds
dfdf1bff: checks
*** FLOP *** [Ad 6d 5d]
dfdf1bff: checks
fc10d8a6: bets $0.1
dfdf1bff: folds
Uncalled bet ($0.1) returned to fc10d8a6
*** SHOWDOWN ***
fc10d8a6 collected $0.12 from pot
*** SUMMARY ***
Total pot $0.12 | Rake $0 | Jackpot $0 | Bingo $0 | Fortune $0 | Tax $0
Board [Ad 6d 5d]
Seat 1: Hero (button) folded before Flop (didn't bet)
Seat 2: cf396bf7 (small blind) folded before Flop
Seat 3: dfdf1bff (big blind) folded on the Flop
Seat 4: 6fc5f880 folded before Flop (didn't bet)
Seat 5: fc10d8a6 won ($0.12)
Seat 6: 8af3b254 folded before Flop (didn't bet)


Poker Hand #RC3812423528: Hold'em No Limit ($0.02/$0.05) - 2025/08/16 23:26:42
Table 'RushAndCash1078788' 6-max Seat #1 is the button
Seat 1: 8648b46c ($7.14 in chips)
Seat 2: 63eb852 ($7.91 in chips)
Seat 3: Hero ($9.17 in chips)
Seat 4: fc10d8a6 ($11.68 in chips)
Seat 5: 8af3b254 ($5.3 in chips)
Seat 6: b6774e9c ($10.83 in chips)
63eb852: posts small blind $0.02
Hero: posts big blind $0.05
*** HOLE CARDS ***
Dealt to 8648b46c 
Dealt to 63eb852 
Dealt to Hero [Td 9d]
Dealt to fc10d8a6 
Dealt to 8af3b254 
Dealt to b6774e9c 
fc10d8a6: calls $0.05
8af3b254: raises $0.17 to $0.22
b6774e9c: folds
8648b46c: folds
63eb852: folds
Hero: calls $0.17
fc10d8a6: calls $0.17
*** FLOP *** [8c 5d 4s]
Hero: checks
fc10d8a6: checks
8af3b254: checks
*** TURN *** [8c 5d 4s] [5c]
Hero: checks
fc10d8a6: bets $0.24
8af3b254: folds
Hero: folds
Uncalled bet ($0.24) returned to fc10d8a6
*** SHOWDOWN ***
fc10d8a6 collected $0.65 from pot
*** SUMMARY ***
Total pot $0.68 | Rake $0.03 | Jackpot $0 | Bingo $0 | Fortune $0 | Tax $0
Board [8c 5d 4s 5c]
Seat 1: 8648b46c (button) folded before Flop (didn't bet)
Seat 2: 63eb852 (small blind) folded before Flop
Seat 3: Hero (big blind) folded on the Turn
Seat 4: fc10d8a6 won ($0.65)
Seat 5: 8af3b254 folded on the Turn
Seat 6: b6774e9c folded before Flop (didn't bet)


Poker Hand #RC3812423470: Hold'em No Limit ($0.02/$0.05) - 2025/08/16 23:26:36
Table 'RushAndCash1078730' 6-max Seat #1 is the button
Seat 1: ad6cb65b ($5 in chips)
Seat 2: Hero ($9.19 in chips)
Seat 3: 3465e7e1 ($5.07 in chips)
Seat 4: 8648b46c ($7.14 in chips)
Seat 5: e879b743 ($3.5 in chips)
Seat 6: 4346847b ($4.1 in chips)
Hero: posts small blind $0.02
3465e7e1: posts big blind $0.05
*** HOLE CARDS ***
Dealt to ad6cb65b 
Dealt to Hero [2h 9d]
Dealt to 3465e7e1 
Dealt to 8648b46c 
Dealt to e879b743 
Dealt to 4346847b 
8648b46c: folds
e879b743: folds
4346847b: raises $0.05 to $0.1
ad6cb65b: folds
Hero: folds
3465e7e1: calls $0.05
*** FLOP *** [Qh 9c As]
3465e7e1: checks
4346847b: bets $0.17
3465e7e1: folds
Uncalled bet ($0.17) returned to 4346847b
*** SHOWDOWN ***
4346847b collected $0.21 from pot
*** SUMMARY ***
Total pot $0.22 | Rake $0.01 | Jackpot $0 | Bingo $0 | Fortune $0 | Tax $0
Board [Qh 9c As]
Seat 1: ad6cb65b (button) folded before Flop (didn't bet)
Seat 2: Hero (small blind) folded before Flop
Seat 3: 3465e7e1 (big blind) folded on the Flop
Seat 4: 8648b46c folded before Flop (didn't bet)
Seat 5: e879b743 folded before Flop (didn't bet)
Seat 6: 4346847b won ($0.21)


Poker Hand #RC3812422953: Hold'em No Limit ($0.02/$0.05) - 2025/08/16 23:25:30
Table 'RushAndCash1078213' 6-max Seat #1 is the button
Seat 1: dfdf1bff ($8.98 in chips)
Seat 2: b40689b1 ($9.41 in chips)
Seat 3: 4d5acc21 ($6.57 in chips)
Seat 4: b76cb406 ($5.48 in chips)
Seat 5: Hero ($8.93 in chips)
Seat 6: 5d1d73db ($5.42 in chips)
b40689b1: posts small blind $0.02
4d5acc21: posts big blind $0.05
*** HOLE CARDS ***
Dealt to dfdf1bff 
Dealt to b40689b1 
Dealt to 4d5acc21 
Dealt to b76cb406 
Dealt to Hero [Kc Jh]
Dealt to 5d1d73db 
b76cb406: folds
Hero: raises $0.05 to $0.1
5d1d73db: folds
dfdf1bff: folds
b40689b1: folds
4d5acc21: calls $0.05
*** FLOP *** [Kd 4s Qd]
4d5acc21: checks
Hero: bets $0.16
4d5acc21: calls $0.16
*** TURN *** [Kd 4s Qd] [6d]
4d5acc21: checks
Hero: checks
*** RIVER *** [Kd 4s Qd 6d] [6c]
4d5acc21: checks
Hero: checks
4d5acc21: shows [Qs 8s] (two pair, Queens and Sixes)
Hero: shows [Kc Jh] (two pair, Kings and Sixes)
*** SHOWDOWN ***
Hero collected $0.52 from pot
*** SUMMARY ***
Total pot $0.54 | Rake $0.02 | Jackpot $0 | Bingo $0 | Fortune $0 | Tax $0
Board [Kd 4s Qd 6d 6c]
Seat 1: dfdf1bff (button) folded before Flop (didn't bet)
Seat 2: b40689b1 (small blind) folded before Flop
Seat 3: 4d5acc21 (big blind) showed [Qs 8s] and lost with two pair, Queens and Sixes
Seat 4: b76cb406 folded before Flop (didn't bet)
Seat 5: Hero showed [Kc Jh] and won ($0.52) with two pair, Kings and Sixes
Seat 6: 5d1d73db folded before Flop (didn't bet)


Poker Hand #RC3812422923: Hold'em No Limit ($0.02/$0.05) - 2025/08/16 23:25:26
Table 'RushAndCash1078183' 6-max Seat #1 is the button
Seat 1: fbfae31e ($9.59 in chips)
Seat 2: 4878e795 ($5.52 in chips)
Seat 3: 8a97de91 ($6.55 in chips)
Seat 4: c8489c74 ($7.32 in chips)
Seat 5: d3b0f7d7 ($5.32 in chips)
Seat 6: Hero ($8.93 in chips)
4878e795: posts small blind $0.02
8a97de91: posts big blind $0.05
*** HOLE CARDS ***
Dealt to fbfae31e 
Dealt to 4878e795 
Dealt to 8a97de91 
Dealt to c8489c74 
Dealt to d3b0f7d7 
Dealt to Hero [5d 9c]
c8489c74: folds
d3b0f7d7: calls $0.05
Hero: folds
fbfae31e: folds
4878e795: folds
8a97de91: checks
*** FLOP *** [9d Ac Jh]
8a97de91: checks
d3b0f7d7: bets $0.05
8a97de91: folds
Uncalled bet ($0.05) returned to d3b0f7d7
*** SHOWDOWN ***
d3b0f7d7 collected $0.12 from pot
*** SUMMARY ***
Total pot $0.12 | Rake $0 | Jackpot $0 | Bingo $0 | Fortune $0 | Tax $0
Board [9d Ac Jh]
Seat 1: fbfae31e (button) folded before Flop (didn't bet)
Seat 2: 4878e795 (small blind) folded before Flop
Seat 3: 8a97de91 (big blind) folded on the Flop
Seat 4: c8489c74 folded before Flop (didn't bet)
Seat 5: d3b0f7d7 won ($0.12)
Seat 6: Hero folded before Flop (didn't bet)


Poker Hand #RC3812422893: Hold'em No Limit ($0.02/$0.05) - 2025/08/16 23:25:23
Table 'RushAndCash1078153' 6-max Seat #1 is the button
Seat 1: 5d1d73db ($5.42 in chips)
Seat 2: 15f48232 ($4.65 in chips)
Seat 3: a0fb338d ($8.26 in chips)
Seat 4: Hero ($8.93 in chips)
Seat 5: 2309ebdd ($5 in chips)
Seat 6: 44245980 ($6.26 in chips)
15f48232: posts small blind $0.02
a0fb338d: posts big blind $0.05
*** HOLE CARDS ***
Dealt to 5d1d73db 
Dealt to 15f48232 
Dealt to a0fb338d 
Dealt to Hero [3d 8c]
Dealt to 2309ebdd 
Dealt to 44245980 
Hero: folds
2309ebdd: folds
44245980: folds
5d1d73db: folds
15f48232: raises $0.1 to $0.15
a0fb338d: folds
Uncalled bet ($0.1) returned to 15f48232
*** SHOWDOWN ***
15f48232 collected $0.1 from pot
*** SUMMARY ***
Total pot $0.1 | Rake $0 | Jackpot $0 | Bingo $0 | Fortune $0 | Tax $0
Seat 1: 5d1d73db (button) folded before Flop (didn't bet)
Seat 2: 15f48232 (small blind) collected ($0.1)
Seat 3: a0fb338d (big blind) folded before Flop
Seat 4: Hero folded before Flop (didn't bet)
Seat 5: 2309ebdd folded before Flop (didn't bet)
Seat 6: 44245980 folded before Flop (didn't bet)


Poker Hand #RC3812422811: Hold'em No Limit ($0.02/$0.05) - 2025/08/16 23:25:13
Table 'RushAndCash1078071' 6-max Seat #1 is the button
Seat 1: Hero ($8.93 in chips)
Seat 2: 5ad55379 ($5.04 in chips)
Seat 3: fc528430 ($5.97 in chips)
Seat 4: cd078af1 ($6.68 in chips)
Seat 5: 46068b1c ($5.82 in chips)
Seat 6: b6774e9c ($11.34 in chips)
5ad55379: posts small blind $0.02
fc528430: posts big blind $0.05
*** HOLE CARDS ***
Dealt to Hero [6s 2s]
Dealt to 5ad55379 
Dealt to fc528430 
Dealt to cd078af1 
Dealt to 46068b1c 
Dealt to b6774e9c 
cd078af1: folds
46068b1c: folds
b6774e9c: raises $0.05 to $0.1
Hero: folds
5ad55379: folds
fc528430: calls $0.05
*** FLOP *** [8c 7h Qd]
fc528430: checks
b6774e9c: checks
*** TURN *** [8c 7h Qd] [6d]
fc528430: checks
b6774e9c: checks
*** RIVER *** [8c 7h Qd 6d] [Js]
fc528430: checks
b6774e9c: checks
fc528430: shows [Kc 7c] (a pair of Sevens)
b6774e9c: shows [Th Kh] (King high)
*** SHOWDOWN ***
fc528430 collected $0.21 from pot
*** SUMMARY ***
Total pot $0.22 | Rake $0.01 | Jackpot $0 | Bingo $0 | Fortune $0 | Tax $0
Board [8c 7h Qd 6d Js]
Seat 1: Hero (button) folded before Flop (didn't bet)
Seat 2: 5ad55379 (small blind) folded before Flop
Seat 3: fc528430 (big blind) showed [Kc 7c] and won ($0.21) with a pair of Sevens
Seat 4: cd078af1 folded before Flop (didn't bet)
Seat 5: 46068b1c folded before Flop (didn't bet)
Seat 6: b6774e9c showed [Th Kh] and lost with King high


Poker Hand #RC3812422396: Hold'em No Limit ($0.02/$0.05) - 2025/08/16 23:24:18
Table 'RushAndCash1077656' 6-max Seat #1 is the button
Seat 1: 46068b1c ($5.86 in chips)
Seat 2: 5682dfc7 ($4.94 in chips)
Seat 3: Hero ($9.03 in chips)
Seat 4: 2cd181a6 ($5.47 in chips)
Seat 5: ce835e9f ($5.35 in chips)
Seat 6: 5ad55379 ($5.07 in chips)
5682dfc7: posts small blind $0.02
Hero: posts big blind $0.05
*** HOLE CARDS ***
Dealt to 46068b1c 
Dealt to 5682dfc7 
Dealt to Hero [8c 6d]
Dealt to 2cd181a6 
Dealt to ce835e9f 
Dealt to 5ad55379 
2cd181a6: folds
ce835e9f: folds
5ad55379: raises $0.05 to $0.1
46068b1c: calls $0.1
5682dfc7: folds
Hero: calls $0.05
*** FLOP *** [Ts Js Ah]
Hero: checks
5ad55379: bets $0.11
46068b1c: calls $0.11
Hero: folds
*** TURN *** [Ts Js Ah] [Kd]
5ad55379: bets $0.41
46068b1c: calls $0.41
*** RIVER *** [Ts Js Ah Kd] [7h]
5ad55379: bets $0.68
46068b1c: calls $0.68
5ad55379: shows [Kh Qs] (a straight, Ace to Ten)
46068b1c: shows [9h Qh] (a straight, Ace to Ten)
*** SHOWDOWN ***
5ad55379 collected $1.27 from pot
46068b1c collected $1.26 from pot
*** SUMMARY ***
Total pot $2.72 | Rake $0.12 | Jackpot $0.07 | Bingo $0 | Fortune $0 | Tax $0
Board [Ts Js Ah Kd 7h]
Seat 1: 46068b1c (button) showed [9h Qh] and won ($1.26) with a straight, Ace to Ten
Seat 2: 5682dfc7 (small blind) folded before Flop
Seat 3: Hero (big blind) folded on the Flop
Seat 4: 2cd181a6 folded before Flop (didn't bet)
Seat 5: ce835e9f folded before Flop (didn't bet)
Seat 6: 5ad55379 showed [Kh Qs] and won ($1.27) with a straight, Ace to Ten


Poker Hand #RC3812422370: Hold'em No Limit ($0.02/$0.05) - 2025/08/16 23:24:15
Table 'RushAndCash1077630' 6-max Seat #1 is the button
Seat 1: dd2d083a ($7.78 in chips)
Seat 2: 66df01e4 ($6.02 in chips)
Seat 3: 5893ed20 ($5.01 in chips)
Seat 4: 24d280ec ($9.71 in chips)
Seat 5: ce835e9f ($5.35 in chips)
Seat 6: Hero ($9.03 in chips)
66df01e4: posts small blind $0.02
5893ed20: posts big blind $0.05
*** HOLE CARDS ***
Dealt to dd2d083a 
Dealt to 66df01e4 
Dealt to 5893ed20 
Dealt to 24d280ec 
Dealt to ce835e9f 
Dealt to Hero [9s Qc]
24d280ec: raises $0.05 to $0.1
ce835e9f: folds
Hero: folds
dd2d083a: folds
66df01e4: folds
5893ed20: calls $0.05
*** FLOP *** [2h 3d Qs]
5893ed20: checks
24d280ec: bets $0.13
5893ed20: folds
Uncalled bet ($0.13) returned to 24d280ec
*** SHOWDOWN ***
24d280ec collected $0.21 from pot
*** SUMMARY ***
Total pot $0.22 | Rake $0.01 | Jackpot $0 | Bingo $0 | Fortune $0 | Tax $0
Board [2h 3d Qs]
Seat 1: dd2d083a (button) folded before Flop (didn't bet)
Seat 2: 66df01e4 (small blind) folded before Flop
Seat 3: 5893ed20 (big blind) folded on the Flop
Seat 4: 24d280ec won ($0.21)
Seat 5: ce835e9f folded before Flop (didn't bet)
Seat 6: Hero folded before Flop (didn't bet)


Poker Hand #RC3812422200: Hold'em No Limit ($0.02/$0.05) - 2025/08/16 23:23:52
Table 'RushAndCash1077460' 6-max Seat #1 is the button
Seat 1: e5a75ca8 ($5.05 in chips)
Seat 2: Hero ($9.05 in chips)
Seat 3: 7691efea ($7.9 in chips)
Seat 4: fc36e8f5 ($8.09 in chips)
Seat 5: bba6bc95 ($6.6 in chips)
Seat 6: 19c34900 ($6.04 in chips)
Hero: posts small blind $0.02
7691efea: posts big blind $0.05
*** HOLE CARDS ***
Dealt to e5a75ca8 
Dealt to Hero [5d Qs]
Dealt to 7691efea 
Dealt to fc36e8f5 
Dealt to bba6bc95 
Dealt to 19c34900 
fc36e8f5: folds
bba6bc95: folds
19c34900: folds
e5a75ca8: folds
Hero: folds
Uncalled bet ($0.03) returned to 7691efea
*** SHOWDOWN ***
7691efea collected $0.04 from pot
*** SUMMARY ***
Total pot $0.04 | Rake $0 | Jackpot $0 | Bingo $0 | Fortune $0 | Tax $0
Seat 1: e5a75ca8 (button) folded before Flop (didn't bet)
Seat 2: Hero (small blind) folded before Flop
Seat 3: 7691efea (big blind) collected ($0.04)
Seat 4: fc36e8f5 folded before Flop (didn't bet)
Seat 5: bba6bc95 folded before Flop (didn't bet)
Seat 6: 19c34900 folded before Flop (didn't bet)


Poker Hand #RC3812422175: Hold'em No Limit ($0.02/$0.05) - 2025/08/16 23:23:49
Table 'RushAndCash1077435' 6-max Seat #1 is the button
Seat 1: 57835ed1 ($5 in chips)
Seat 2: f42bd891 ($8.15 in chips)
Seat 3: fe7b6407 ($10.64 in chips)
Seat 4: Hero ($9.05 in chips)
Seat 5: 371aed7 ($5.28 in chips)
Seat 6: da900d7a ($11.44 in chips)
f42bd891: posts small blind $0.02
fe7b6407: posts big blind $0.05
*** HOLE CARDS ***
Dealt to 57835ed1 
Dealt to f42bd891 
Dealt to fe7b6407 
Dealt to Hero [4s 7h]
Dealt to 371aed7 
Dealt to da900d7a 
Hero: folds
371aed7: folds
da900d7a: folds
57835ed1: folds
f42bd891: raises $0.09 to $0.14
fe7b6407: folds
Uncalled bet ($0.09) returned to f42bd891
*** SHOWDOWN ***
f42bd891 collected $0.1 from pot
*** SUMMARY ***
Total pot $0.1 | Rake $0 | Jackpot $0 | Bingo $0 | Fortune $0 | Tax $0
Seat 1: 57835ed1 (button) folded before Flop (didn't bet)
Seat 2: f42bd891 (small blind) collected ($0.1)
Seat 3: fe7b6407 (big blind) folded before Flop
Seat 4: Hero folded before Flop (didn't bet)
Seat 5: 371aed7 folded before Flop (didn't bet)
Seat 6: da900d7a folded before Flop (didn't bet)


Poker Hand #RC3812422150: Hold'em No Limit ($0.02/$0.05) - 2025/08/16 23:23:45
Table 'RushAndCash1077410' 6-max Seat #1 is the button
Seat 1: 7691efea ($7.9 in chips)
Seat 2: edba6ccc ($8.77 in chips)
Seat 3: cc4d0685 ($6.19 in chips)
Seat 4: Hero ($9.05 in chips)
Seat 5: a27c05aa ($5.16 in chips)
Seat 6: 6ce0e31c ($15.03 in chips)
edba6ccc: posts small blind $0.02
cc4d0685: posts big blind $0.05
*** HOLE CARDS ***
Dealt to 7691efea 
Dealt to edba6ccc 
Dealt to cc4d0685 
Dealt to Hero [3h 8d]
Dealt to a27c05aa 
Dealt to 6ce0e31c 
Hero: folds
a27c05aa: folds
6ce0e31c: folds
7691efea: folds
edba6ccc: folds
Uncalled bet ($0.03) returned to cc4d0685
*** SHOWDOWN ***
cc4d0685 collected $0.04 from pot
*** SUMMARY ***
Total pot $0.04 | Rake $0 | Jackpot $0 | Bingo $0 | Fortune $0 | Tax $0
Seat 1: 7691efea (button) folded before Flop (didn't bet)
Seat 2: edba6ccc (small blind) folded before Flop
Seat 3: cc4d0685 (big blind) collected ($0.04)
Seat 4: Hero folded before Flop (didn't bet)
Seat 5: a27c05aa folded before Flop (didn't bet)
Seat 6: 6ce0e31c folded before Flop (didn't bet)


Poker Hand #RC3812422075: Hold'em No Limit ($0.02/$0.05) - 2025/08/16 23:23:34
Table 'RushAndCash1077335' 6-max Seat #1 is the button
Seat 1: 45c428ad ($5 in chips)
Seat 2: Hero ($9.07 in chips)
Seat 3: 57ee63e0 ($5.2 in chips)
Seat 4: e2401dad ($5.37 in chips)
Seat 5: 17d650ae ($5.2 in chips)
Seat 6: 3dc9b1ad ($5 in chips)
Hero: posts small blind $0.02
57ee63e0: posts big blind $0.05
*** HOLE CARDS ***
Dealt to 45c428ad 
Dealt to Hero [6h Kd]
Dealt to 57ee63e0 
Dealt to e2401dad 
Dealt to 17d650ae 
Dealt to 3dc9b1ad 
e2401dad: folds
17d650ae: raises $0.07 to $0.12
3dc9b1ad: folds
45c428ad: folds
Hero: folds
57ee63e0: calls $0.07
*** FLOP *** [Kh 9d 3c]
57ee63e0: checks
17d650ae: checks
*** TURN *** [Kh 9d 3c] [7s]
57ee63e0: bets $0.38
17d650ae: folds
Uncalled bet ($0.38) returned to 57ee63e0
*** SHOWDOWN ***
57ee63e0 collected $0.25 from pot
*** SUMMARY ***
Total pot $0.26 | Rake $0.01 | Jackpot $0 | Bingo $0 | Fortune $0 | Tax $0
Board [Kh 9d 3c 7s]
Seat 1: 45c428ad (button) folded before Flop (didn't bet)
Seat 2: Hero (small blind) folded before Flop
Seat 3: 57ee63e0 (big blind) won ($0.25)
Seat 4: e2401dad folded before Flop (didn't bet)
Seat 5: 17d650ae folded on the Turn
Seat 6: 3dc9b1ad folded before Flop (didn't bet)


Poker Hand #RC3812421811: Hold'em No Limit ($0.02/$0.05) - 2025/08/16 23:22:57
Table 'RushAndCash1077071' 6-max Seat #1 is the button
Seat 1: 27e4d0e3 ($5.06 in chips)
Seat 2: e74d57be ($5 in chips)
Seat 3: abca4981 ($5.72 in chips)
Seat 4: cd078af1 ($5.71 in chips)
Seat 5: Hero ($8.96 in chips)
Seat 6: d53969aa ($6.14 in chips)
e74d57be: posts small blind $0.02
abca4981: posts big blind $0.05
*** HOLE CARDS ***
Dealt to 27e4d0e3 
Dealt to e74d57be 
Dealt to abca4981 
Dealt to cd078af1 
Dealt to Hero [Ah Qh]
Dealt to d53969aa 
cd078af1: folds
Hero: raises $0.05 to $0.1
d53969aa: folds
27e4d0e3: folds
e74d57be: folds
abca4981: calls $0.05
*** FLOP *** [Js 9s Ac]
abca4981: checks
Hero: bets $0.07
abca4981: folds
Uncalled bet ($0.07) returned to Hero
*** SHOWDOWN ***
Hero collected $0.21 from pot
*** SUMMARY ***
Total pot $0.22 | Rake $0.01 | Jackpot $0 | Bingo $0 | Fortune $0 | Tax $0
Board [Js 9s Ac]
Seat 1: 27e4d0e3 (button) folded before Flop (didn't bet)
Seat 2: e74d57be (small blind) folded before Flop
Seat 3: abca4981 (big blind) folded on the Flop
Seat 4: cd078af1 folded before Flop (didn't bet)
Seat 5: Hero won ($0.21)
Seat 6: d53969aa folded before Flop (didn't bet)


Poker Hand #RC3812421428: Hold'em No Limit ($0.02/$0.05) - 2025/08/16 23:22:04
Table 'RushAndCash1076688' 6-max Seat #1 is the button
Seat 1: Hero ($8.27 in chips)
Seat 2: d171b62f ($5 in chips)
Seat 3: e74d57be ($5.09 in chips)
Seat 4: 2cd181a6 ($5.2 in chips)
Seat 5: 1d487da4 ($8.03 in chips)
Seat 6: fb3f4029 ($5.91 in chips)
d171b62f: posts small blind $0.02
e74d57be: posts big blind $0.05
*** HOLE CARDS ***
Dealt to Hero [Kc Kh]
Dealt to d171b62f 
Dealt to e74d57be 
Dealt to 2cd181a6 
Dealt to 1d487da4 
Dealt to fb3f4029 
2cd181a6: folds
1d487da4: folds
fb3f4029: raises $0.05 to $0.1
Hero: calls $0.1
d171b62f: folds
e74d57be: raises $0.53 to $0.63
fb3f4029: folds
Hero: calls $0.53
*** FLOP *** [5h 6h Js]
e74d57be: checks
Hero: bets $0.5
e74d57be: folds
Uncalled bet ($0.5) returned to Hero
*** SHOWDOWN ***
Hero collected $1.32 from pot
*** SUMMARY ***
Total pot $1.38 | Rake $0.06 | Jackpot $0 | Bingo $0 | Fortune $0 | Tax $0
Board [5h 6h Js]
Seat 1: Hero (button) won ($1.32)
Seat 2: d171b62f (small blind) folded before Flop
Seat 3: e74d57be (big blind) folded on the Flop
Seat 4: 2cd181a6 folded before Flop (didn't bet)
Seat 5: 1d487da4 folded before Flop (didn't bet)
Seat 6: fb3f4029 folded before Flop


Poker Hand #RC3812421231: Hold'em No Limit ($0.02/$0.05) - 2025/08/16 23:21:38
Table 'RushAndCash1076491' 6-max Seat #1 is the button
Seat 1: d171b62f ($5 in chips)
Seat 2: d03f1112 ($6.37 in chips)
Seat 3: Hero ($8.25 in chips)
Seat 4: 7ae23058 ($5.82 in chips)
Seat 5: 832192ba ($5 in chips)
Seat 6: 33236916 ($14.81 in chips)
d03f1112: posts small blind $0.02
Hero: posts big blind $0.05
*** HOLE CARDS ***
Dealt to d171b62f 
Dealt to d03f1112 
Dealt to Hero [4s Jh]
Dealt to 7ae23058 
Dealt to 832192ba 
Dealt to 33236916 
7ae23058: folds
832192ba: folds
33236916: folds
d171b62f: folds
d03f1112: folds
Uncalled bet ($0.03) returned to Hero
*** SHOWDOWN ***
Hero collected $0.04 from pot
*** SUMMARY ***
Total pot $0.04 | Rake $0 | Jackpot $0 | Bingo $0 | Fortune $0 | Tax $0
Seat 1: d171b62f (button) folded before Flop (didn't bet)
Seat 2: d03f1112 (small blind) folded before Flop
Seat 3: Hero (big blind) collected ($0.04)
Seat 4: 7ae23058 folded before Flop (didn't bet)
Seat 5: 832192ba folded before Flop (didn't bet)
Seat 6: 33236916 folded before Flop (didn't bet)


Poker Hand #RC3812421205: Hold'em No Limit ($0.02/$0.05) - 2025/08/16 23:21:35
Table 'RushAndCash1076465' 6-max Seat #1 is the button
Seat 1: 659e76bd ($6.94 in chips)
Seat 2: 2d778754 ($5.02 in chips)
Seat 3: aca78d98 ($7.67 in chips)
Seat 4: Hero ($8.25 in chips)
Seat 5: 731b5a58 ($5.21 in chips)
Seat 6: 2b54e7a1 ($6.22 in chips)
2d778754: posts small blind $0.02
aca78d98: posts big blind $0.05
*** HOLE CARDS ***
Dealt to 659e76bd 
Dealt to 2d778754 
Dealt to aca78d98 
Dealt to Hero [Qs 5s]
Dealt to 731b5a58 
Dealt to 2b54e7a1 
Hero: folds
731b5a58: folds
2b54e7a1: raises $0.06 to $0.11
659e76bd: folds
2d778754: folds
aca78d98: folds
Uncalled bet ($0.06) returned to 2b54e7a1
*** SHOWDOWN ***
2b54e7a1 collected $0.12 from pot
*** SUMMARY ***
Total pot $0.12 | Rake $0 | Jackpot $0 | Bingo $0 | Fortune $0 | Tax $0
Seat 1: 659e76bd (button) folded before Flop (didn't bet)
Seat 2: 2d778754 (small blind) folded before Flop
Seat 3: aca78d98 (big blind) folded before Flop
Seat 4: Hero folded before Flop (didn't bet)
Seat 5: 731b5a58 folded before Flop (didn't bet)
Seat 6: 2b54e7a1 collected ($0.12)


Poker Hand #RC3812421180: Hold'em No Limit ($0.02/$0.05) - 2025/08/16 23:21:31
Table 'RushAndCash1076440' 6-max Seat #1 is the button
Seat 1: a4c0e017 ($13.88 in chips)
Seat 2: f42bd891 ($7.88 in chips)
Seat 3: 43ce6238 ($5.25 in chips)
Seat 4: Hero ($8.25 in chips)
Seat 5: 370bf11f ($6.83 in chips)
Seat 6: 4da56cdf ($7.58 in chips)
f42bd891: posts small blind $0.02
43ce6238: posts big blind $0.05
*** HOLE CARDS ***
Dealt to a4c0e017 
Dealt to f42bd891 
Dealt to 43ce6238 
Dealt to Hero [4s 8c]
Dealt to 370bf11f 
Dealt to 4da56cdf 
Hero: folds
370bf11f: folds
4da56cdf: raises $0.08 to $0.13
a4c0e017: folds
f42bd891: folds
43ce6238: folds
Uncalled bet ($0.08) returned to 4da56cdf
*** SHOWDOWN ***
4da56cdf collected $0.12 from pot
*** SUMMARY ***
Total pot $0.12 | Rake $0 | Jackpot $0 | Bingo $0 | Fortune $0 | Tax $0
Seat 1: a4c0e017 (button) folded before Flop (didn't bet)
Seat 2: f42bd891 (small blind) folded before Flop
Seat 3: 43ce6238 (big blind) folded before Flop
Seat 4: Hero folded before Flop (didn't bet)
Seat 5: 370bf11f folded before Flop (didn't bet)
Seat 6: 4da56cdf collected ($0.12)


Poker Hand #RC3812421086: Hold'em No Limit ($0.02/$0.05) - 2025/08/16 23:21:18
Table 'RushAndCash1076346' 6-max Seat #1 is the button
Seat 1: d5afdf2c ($17.69 in chips)
Seat 2: Hero ($8.2 in chips)
Seat 3: 10dff872 ($11.85 in chips)
Seat 4: 468174bd ($9.52 in chips)
Seat 5: a3fc330b ($5 in chips)
Seat 6: 2cb5ed63 ($4.68 in chips)
Hero: posts small blind $0.02
10dff872: posts big blind $0.05
*** HOLE CARDS ***
Dealt to d5afdf2c 
Dealt to Hero [3d 4d]
Dealt to 10dff872 
Dealt to 468174bd 
Dealt to a3fc330b 
Dealt to 2cb5ed63 
468174bd: folds
a3fc330b: folds
2cb5ed63: folds
d5afdf2c: folds
Hero: raises $0.05 to $0.1
10dff872: folds
Uncalled bet ($0.05) returned to Hero
*** SHOWDOWN ***
Hero collected $0.1 from pot
*** SUMMARY ***
Total pot $0.1 | Rake $0 | Jackpot $0 | Bingo $0 | Fortune $0 | Tax $0
Seat 1: d5afdf2c (button) folded before Flop (didn't bet)
Seat 2: Hero (small blind) collected ($0.1)
Seat 3: 10dff872 (big blind) folded before Flop
Seat 4: 468174bd folded before Flop (didn't bet)
Seat 5: a3fc330b folded before Flop (didn't bet)
Seat 6: 2cb5ed63 folded before Flop (didn't bet)


Poker Hand #RC3812420973: Hold'em No Limit ($0.02/$0.05) - 2025/08/16 23:21:02
Table 'RushAndCash1076233' 6-max Seat #1 is the button
Seat 1: de87a73 ($5.56 in chips)
Seat 2: a1bea61b ($10.63 in chips)
Seat 3: Hero ($8.18 in chips)
Seat 4: 4a5a3509 ($3.56 in chips)
Seat 5: f57ab9 ($5.05 in chips)
Seat 6: 1436e805 ($10.11 in chips)
a1bea61b: posts small blind $0.02
Hero: posts big blind $0.05
*** HOLE CARDS ***
Dealt to de87a73 
Dealt to a1bea61b 
Dealt to Hero [6h Qh]
Dealt to 4a5a3509 
Dealt to f57ab9 
Dealt to 1436e805 
4a5a3509: folds
f57ab9: folds
1436e805: folds
de87a73: folds
a1bea61b: folds
Uncalled bet ($0.03) returned to Hero
*** SHOWDOWN ***
Hero collected $0.04 from pot
*** SUMMARY ***
Total pot $0.04 | Rake $0 | Jackpot $0 | Bingo $0 | Fortune $0 | Tax $0
Seat 1: de87a73 (button) folded before Flop (didn't bet)
Seat 2: a1bea61b (small blind) folded before Flop
Seat 3: Hero (big blind) collected ($0.04)
Seat 4: 4a5a3509 folded before Flop (didn't bet)
Seat 5: f57ab9 folded before Flop (didn't bet)
Seat 6: 1436e805 folded before Flop (didn't bet)


Poker Hand #RC3812420948: Hold'em No Limit ($0.02/$0.05) - 2025/08/16 23:20:59
Table 'RushAndCash1076208' 6-max Seat #1 is the button
Seat 1: Hero ($8.18 in chips)
Seat 2: 36652e67 ($6.62 in chips)
Seat 3: cfe4d013 ($4.83 in chips)
Seat 4: aa8bc92 ($5.63 in chips)
Seat 5: a1bea61b ($10.63 in chips)
Seat 6: fed1995e ($2.88 in chips)
36652e67: posts small blind $0.02
cfe4d013: posts big blind $0.05
*** HOLE CARDS ***
Dealt to Hero [4s 6h]
Dealt to 36652e67 
Dealt to cfe4d013 
Dealt to aa8bc92 
Dealt to a1bea61b 
Dealt to fed1995e 
aa8bc92: folds
a1bea61b: folds
fed1995e: folds
Hero: folds
36652e67: raises $0.05 to $0.1
cfe4d013: folds
Uncalled bet ($0.05) returned to 36652e67
*** SHOWDOWN ***
36652e67 collected $0.1 from pot
*** SUMMARY ***
Total pot $0.1 | Rake $0 | Jackpot $0 | Bingo $0 | Fortune $0 | Tax $0
Seat 1: Hero (button) folded before Flop (didn't bet)
Seat 2: 36652e67 (small blind) collected ($0.1)
Seat 3: cfe4d013 (big blind) folded before Flop
Seat 4: aa8bc92 folded before Flop (didn't bet)
Seat 5: a1bea61b folded before Flop (didn't bet)
Seat 6: fed1995e folded before Flop (didn't bet)


Poker Hand #RC3812420920: Hold'em No Limit ($0.02/$0.05) - 2025/08/16 23:20:55
Table 'RushAndCash1076180' 6-max Seat #1 is the button
Seat 1: 19ee4bf8 ($5 in chips)
Seat 2: 371aed7 ($4.71 in chips)
Seat 3: a5b42508 ($5.79 in chips)
Seat 4: Hero ($8.18 in chips)
Seat 5: 2e10c05e ($2.5 in chips)
Seat 6: a078e765 ($5 in chips)
371aed7: posts small blind $0.02
a5b42508: posts big blind $0.05
*** HOLE CARDS ***
Dealt to 19ee4bf8 
Dealt to 371aed7 
Dealt to a5b42508 
Dealt to Hero [4d Th]
Dealt to 2e10c05e 
Dealt to a078e765 
Hero: folds
2e10c05e: folds
a078e765: raises $0.07 to $0.12
19ee4bf8: folds
371aed7: raises $0.22 to $0.34
a5b42508: folds
a078e765: calls $0.22
*** FLOP *** [8c 5d Jh]
371aed7: bets $0.37
a078e765: folds
Uncalled bet ($0.37) returned to 371aed7
*** SHOWDOWN ***
371aed7 collected $0.7 from pot
*** SUMMARY ***
Total pot $0.73 | Rake $0.03 | Jackpot $0 | Bingo $0 | Fortune $0 | Tax $0
Board [8c 5d Jh]
Seat 1: 19ee4bf8 (button) folded before Flop (didn't bet)
Seat 2: 371aed7 (small blind) won ($0.7)
Seat 3: a5b42508 (big blind) folded before Flop
Seat 4: Hero folded before Flop (didn't bet)
Seat 5: 2e10c05e folded before Flop (didn't bet)
Seat 6: a078e765 folded on the Flop


Poker Hand #RC3812420896: Hold'em No Limit ($0.02/$0.05) - 2025/08/16 23:20:52
Table 'RushAndCash1076156' 6-max Seat #1 is the button
Seat 1: 45e92a55 ($5.86 in chips)
Seat 2: 14f34b32 ($5 in chips)
Seat 3: d9c03304 ($5.78 in chips)
Seat 4: Hero ($8.18 in chips)
Seat 5: 371aed7 ($4.71 in chips)
Seat 6: 27e4d0e3 ($5 in chips)
14f34b32: posts small blind $0.02
d9c03304: posts big blind $0.05
*** HOLE CARDS ***
Dealt to 45e92a55 
Dealt to 14f34b32 
Dealt to d9c03304 
Dealt to Hero [5c Jh]
Dealt to 371aed7 
Dealt to 27e4d0e3 
Hero: folds
371aed7: folds
27e4d0e3: folds
45e92a55: folds
14f34b32: folds
Uncalled bet ($0.03) returned to d9c03304
*** SHOWDOWN ***
d9c03304 collected $0.04 from pot
*** SUMMARY ***
Total pot $0.04 | Rake $0 | Jackpot $0 | Bingo $0 | Fortune $0 | Tax $0
Seat 1: 45e92a55 (button) folded before Flop (didn't bet)
Seat 2: 14f34b32 (small blind) folded before Flop
Seat 3: d9c03304 (big blind) collected ($0.04)
Seat 4: Hero folded before Flop (didn't bet)
Seat 5: 371aed7 folded before Flop (didn't bet)
Seat 6: 27e4d0e3 folded before Flop (didn't bet)


Poker Hand #RC3812420869: Hold'em No Limit ($0.02/$0.05) - 2025/08/16 23:20:48
Table 'RushAndCash1076129' 6-max Seat #1 is the button
Seat 1: 5163d6d4 ($8.89 in chips)
Seat 2: 8af3b254 ($5.02 in chips)
Seat 3: ff997675 ($5.61 in chips)
Seat 4: e2401dad ($5.27 in chips)
Seat 5: Hero ($8.18 in chips)
Seat 6: 3b661f83 ($16.37 in chips)
8af3b254: posts small blind $0.02
ff997675: posts big blind $0.05
*** HOLE CARDS ***
Dealt to 5163d6d4 
Dealt to 8af3b254 
Dealt to ff997675 
Dealt to e2401dad 
Dealt to Hero [Jh 9d]
Dealt to 3b661f83 
e2401dad: folds
Hero: folds
3b661f83: folds
5163d6d4: folds
8af3b254: folds
Uncalled bet ($0.03) returned to ff997675
*** SHOWDOWN ***
ff997675 collected $0.04 from pot
*** SUMMARY ***
Total pot $0.04 | Rake $0 | Jackpot $0 | Bingo $0 | Fortune $0 | Tax $0
Seat 1: 5163d6d4 (button) folded before Flop (didn't bet)
Seat 2: 8af3b254 (small blind) folded before Flop
Seat 3: ff997675 (big blind) collected ($0.04)
Seat 4: e2401dad folded before Flop (didn't bet)
Seat 5: Hero folded before Flop (didn't bet)
Seat 6: 3b661f83 folded before Flop (didn't bet)


Poker Hand #RC3812420846: Hold'em No Limit ($0.02/$0.05) - 2025/08/16 23:20:45
Table 'RushAndCash1076106' 6-max Seat #1 is the button
Seat 1: 84412c1e ($8.07 in chips)
Seat 2: 8870af3a ($4.83 in chips)
Seat 3: 11a1276 ($5.02 in chips)
Seat 4: 709f8e36 ($5.12 in chips)
Seat 5: fc36e8f5 ($8.85 in chips)
Seat 6: Hero ($8.18 in chips)
8870af3a: posts small blind $0.02
11a1276: posts big blind $0.05
*** HOLE CARDS ***
Dealt to 84412c1e 
Dealt to 8870af3a 
Dealt to 11a1276 
Dealt to 709f8e36 
Dealt to fc36e8f5 
Dealt to Hero [Qh 4d]
709f8e36: raises $0.05 to $0.1
fc36e8f5: calls $0.1
Hero: folds
84412c1e: folds
8870af3a: folds
11a1276: folds
*** FLOP *** [Ks Ah 3s]
709f8e36: bets $0.1
fc36e8f5: calls $0.1
*** TURN *** [Ks Ah 3s] [5c]
709f8e36: bets $0.25
fc36e8f5: calls $0.25
*** RIVER *** [Ks Ah 3s 5c] [7s]
709f8e36: bets $0.5
fc36e8f5: calls $0.5
709f8e36: shows [3d 3h] (three of a kind, Threes)
fc36e8f5: shows [6s 6c] (a pair of Sixes)
*** SHOWDOWN ***
709f8e36 collected $1.81 from pot
*** SUMMARY ***
Total pot $1.97 | Rake $0.09 | Jackpot $0.07 | Bingo $0 | Fortune $0 | Tax $0
Board [Ks Ah 3s 5c 7s]
Seat 1: 84412c1e (button) folded before Flop (didn't bet)
Seat 2: 8870af3a (small blind) folded before Flop
Seat 3: 11a1276 (big blind) folded before Flop
Seat 4: 709f8e36 showed [3d 3h] and won ($1.81) with three of a kind, Threes
Seat 5: fc36e8f5 showed [6s 6c] and lost with a pair of Sixes
Seat 6: Hero folded before Flop (didn't bet)


Poker Hand #RC3812420811: Hold'em No Limit ($0.02/$0.05) - 2025/08/16 23:20:39
Table 'RushAndCash1076071' 6-max Seat #1 is the button
Seat 1: Hero ($8.18 in chips)
Seat 2: b9846e09 ($5 in chips)
Seat 3: 4e913e64 ($5 in chips)
Seat 4: b699a745 ($7.87 in chips)
Seat 5: 1179fe80 ($6.72 in chips)
Seat 6: 420c080f ($5 in chips)
b9846e09: posts small blind $0.02
4e913e64: posts big blind $0.05
*** HOLE CARDS ***
Dealt to Hero [5s Ad]
Dealt to b9846e09 
Dealt to 4e913e64 
Dealt to b699a745 
Dealt to 1179fe80 
Dealt to 420c080f 
b699a745: folds
1179fe80: folds
420c080f: folds
Hero: folds
b9846e09: folds
Uncalled bet ($0.03) returned to 4e913e64
*** SHOWDOWN ***
4e913e64 collected $0.04 from pot
*** SUMMARY ***
Total pot $0.04 | Rake $0 | Jackpot $0 | Bingo $0 | Fortune $0 | Tax $0
Seat 1: Hero (button) folded before Flop (didn't bet)
Seat 2: b9846e09 (small blind) folded before Flop
Seat 3: 4e913e64 (big blind) collected ($0.04)
Seat 4: b699a745 folded before Flop (didn't bet)
Seat 5: 1179fe80 folded before Flop (didn't bet)
Seat 6: 420c080f folded before Flop (didn't bet)


Poker Hand #RC3812420249: Hold'em No Limit ($0.02/$0.05) - 2025/08/16 23:19:20
Table 'RushAndCash1075509' 6-max Seat #1 is the button
Seat 1: ff997675 ($5.5 in chips)
Seat 2: a23a7275 ($8.83 in chips)
Seat 3: Hero ($8.18 in chips)
Seat 4: e58c1646 ($15.63 in chips)
Seat 5: b0d59a0f ($5.14 in chips)
Seat 6: 420c080f ($5 in chips)
a23a7275: posts small blind $0.02
Hero: posts big blind $0.05
*** HOLE CARDS ***
Dealt to ff997675 
Dealt to a23a7275 
Dealt to Hero [Jd Ks]
Dealt to e58c1646 
Dealt to b0d59a0f 
Dealt to 420c080f 
e58c1646: folds
b0d59a0f: folds
420c080f: raises $0.07 to $0.12
ff997675: folds
a23a7275: folds
Hero: calls $0.07
*** FLOP *** [Kc 4h 4d]
Hero: checks
420c080f: bets $0.08
Hero: calls $0.08
*** TURN *** [Kc 4h 4d] [As]
Hero: checks
420c080f: checks
*** RIVER *** [Kc 4h 4d As] [2d]
Hero: checks
420c080f: bets $0.14
Hero: calls $0.14
420c080f: shows [Js Kd] (two pair, Kings and Fours)
Hero: shows [Jd Ks] (two pair, Kings and Fours)
*** SHOWDOWN ***
Hero collected $0.34 from pot
420c080f collected $0.34 from pot
*** SUMMARY ***
Total pot $0.7 | Rake $0.02 | Jackpot $0 | Bingo $0 | Fortune $0 | Tax $0
Board [Kc 4h 4d As 2d]
Seat 1: ff997675 (button) folded before Flop (didn't bet)
Seat 2: a23a7275 (small blind) folded before Flop
Seat 3: Hero (big blind) showed [Jd Ks] and won ($0.34) with two pair, Kings and Fours
Seat 4: e58c1646 folded before Flop (didn't bet)
Seat 5: b0d59a0f folded before Flop (didn't bet)
Seat 6: 420c080f showed [Js Kd] and won ($0.34) with two pair, Kings and Fours


Poker Hand #RC3812420170: Hold'em No Limit ($0.02/$0.05) - 2025/08/16 23:19:09
Table 'RushAndCash1075430' 6-max Seat #1 is the button
Seat 1: 39960ef2 ($2 in chips)
Seat 2: Hero ($8.13 in chips)
Seat 3: 6c196a1f ($22.65 in chips)
Seat 4: 80837687 ($5.77 in chips)
Seat 5: 5ad17830 ($4.54 in chips)
Seat 6: 90083bbe ($5.07 in chips)
Hero: posts small blind $0.02
6c196a1f: posts big blind $0.05
*** HOLE CARDS ***
Dealt to 39960ef2 
Dealt to Hero [Kc 5h]
Dealt to 6c196a1f 
Dealt to 80837687 
Dealt to 5ad17830 
Dealt to 90083bbe 
80837687: folds
5ad17830: folds
90083bbe: folds
39960ef2: folds
Hero: calls $0.03
6c196a1f: checks
*** FLOP *** [Ad As Td]
Hero: bets $0.05
6c196a1f: folds
Uncalled bet ($0.05) returned to Hero
*** SHOWDOWN ***
Hero collected $0.1 from pot
*** SUMMARY ***
Total pot $0.1 | Rake $0 | Jackpot $0 | Bingo $0 | Fortune $0 | Tax $0
Board [Ad As Td]
Seat 1: 39960ef2 (button) folded before Flop (didn't bet)
Seat 2: Hero (small blind) won ($0.1)
Seat 3: 6c196a1f (big blind) folded on the Flop
Seat 4: 80837687 folded before Flop (didn't bet)
Seat 5: 5ad17830 folded before Flop (didn't bet)
Seat 6: 90083bbe folded before Flop (didn't bet)


Poker Hand #RC3812420140: Hold'em No Limit ($0.02/$0.05) - 2025/08/16 23:19:05
Table 'RushAndCash1075400' 6-max Seat #1 is the button
Seat 1: 6c196a1f ($22.65 in chips)
Seat 2: aa8bc92 ($5.45 in chips)
Seat 3: 81672ce3 ($6.15 in chips)
Seat 4: fed1995e ($2.56 in chips)
Seat 5: Hero ($8.13 in chips)
Seat 6: d140874d ($17.77 in chips)
aa8bc92: posts small blind $0.02
81672ce3: posts big blind $0.05
*** HOLE CARDS ***
Dealt to 6c196a1f 
Dealt to aa8bc92 
Dealt to 81672ce3 
Dealt to fed1995e 
Dealt to Hero [9s Qh]
Dealt to d140874d 
fed1995e: folds
Hero: folds
d140874d: folds
6c196a1f: folds
aa8bc92: raises $0.05 to $0.1
81672ce3: raises $0.25 to $0.35
aa8bc92: folds
Uncalled bet ($0.25) returned to 81672ce3
*** SHOWDOWN ***
81672ce3 collected $0.19 from pot
*** SUMMARY ***
Total pot $0.2 | Rake $0.01 | Jackpot $0 | Bingo $0 | Fortune $0 | Tax $0
Seat 1: 6c196a1f (button) folded before Flop (didn't bet)
Seat 2: aa8bc92 (small blind) folded before Flop
Seat 3: 81672ce3 (big blind) collected ($0.19)
Seat 4: fed1995e folded before Flop (didn't bet)
Seat 5: Hero folded before Flop (didn't bet)
Seat 6: d140874d folded before Flop (didn't bet)


Poker Hand #RC3812420057: Hold'em No Limit ($0.02/$0.05) - 2025/08/16 23:18:53
Table 'RushAndCash1075317' 6-max Seat #1 is the button
Seat 1: 603f89e1 ($5.26 in chips)
Seat 2: 61fde3d6 ($14.29 in chips)
Seat 3: a4c0e017 ($14.62 in chips)
Seat 4: de500ce ($8.79 in chips)
Seat 5: Hero ($8.06 in chips)
Seat 6: 95472d3b ($6.45 in chips)
61fde3d6: posts small blind $0.02
a4c0e017: posts big blind $0.05
*** HOLE CARDS ***
Dealt to 603f89e1 
Dealt to 61fde3d6 
Dealt to a4c0e017 
Dealt to de500ce 
Dealt to Hero [Kh Qh]
Dealt to 95472d3b 
de500ce: folds
Hero: raises $0.05 to $0.1
95472d3b: folds
603f89e1: folds
61fde3d6: folds
a4c0e017: folds
Uncalled bet ($0.05) returned to Hero
*** SHOWDOWN ***
Hero collected $0.12 from pot
*** SUMMARY ***
Total pot $0.12 | Rake $0 | Jackpot $0 | Bingo $0 | Fortune $0 | Tax $0
Seat 1: 603f89e1 (button) folded before Flop (didn't bet)
Seat 2: 61fde3d6 (small blind) folded before Flop
Seat 3: a4c0e017 (big blind) folded before Flop
Seat 4: de500ce folded before Flop (didn't bet)
Seat 5: Hero collected ($0.12)
Seat 6: 95472d3b folded before Flop (didn't bet)


Poker Hand #RC3812419654: Hold'em No Limit ($0.02/$0.05) - 2025/08/16 23:17:55
Table 'RushAndCash1074914' 6-max Seat #1 is the button
Seat 1: f32f0af0 ($5.84 in chips)
Seat 2: a4c0e017 ($14.85 in chips)
Seat 3: Hero ($7.85 in chips)
Seat 4: a575ad76 ($10.38 in chips)
Seat 5: 6070afca ($1.89 in chips)
Seat 6: fb3f4029 ($5 in chips)
a4c0e017: posts small blind $0.02
Hero: posts big blind $0.05
*** HOLE CARDS ***
Dealt to f32f0af0 
Dealt to a4c0e017 
Dealt to Hero [3c 7c]
Dealt to a575ad76 
Dealt to 6070afca 
Dealt to fb3f4029 
a575ad76: folds
6070afca: folds
fb3f4029: folds
f32f0af0: folds
a4c0e017: raises $0.08 to $0.13
Hero: calls $0.08
*** FLOP *** [Jc Jh 3d]
a4c0e017: checks
Hero: bets $0.1
a4c0e017: calls $0.1
*** TURN *** [Jc Jh 3d] [2h]
a4c0e017: checks
Hero: bets $0.23
a4c0e017: folds
Uncalled bet ($0.23) returned to Hero
*** SHOWDOWN ***
Hero collected $0.44 from pot
*** SUMMARY ***
Total pot $0.46 | Rake $0.02 | Jackpot $0 | Bingo $0 | Fortune $0 | Tax $0
Board [Jc Jh 3d 2h]
Seat 1: f32f0af0 (button) folded before Flop (didn't bet)
Seat 2: a4c0e017 (small blind) folded on the Turn
Seat 3: Hero (big blind) won ($0.44)
Seat 4: a575ad76 folded before Flop (didn't bet)
Seat 5: 6070afca folded before Flop (didn't bet)
Seat 6: fb3f4029 folded before Flop (didn't bet)


Poker Hand #RC3812419380: Hold'em No Limit ($0.02/$0.05) - 2025/08/16 23:17:14
Table 'RushAndCash1074640' 6-max Seat #1 is the button
Seat 1: 862cd8a9 ($5.41 in chips)
Seat 2: Hero ($7.76 in chips)
Seat 3: f32f0af0 ($5.94 in chips)
Seat 4: af0142ec ($5.04 in chips)
Seat 5: 3101bb8a ($9.02 in chips)
Seat 6: 5de00f9 ($4.77 in chips)
Hero: posts small blind $0.02
f32f0af0: posts big blind $0.05
*** HOLE CARDS ***
Dealt to 862cd8a9 
Dealt to Hero [Kh 2c]
Dealt to f32f0af0 
Dealt to af0142ec 
Dealt to 3101bb8a 
Dealt to 5de00f9 
af0142ec: folds
3101bb8a: folds
5de00f9: folds
862cd8a9: folds
Hero: raises $0.05 to $0.1
f32f0af0: calls $0.05
*** FLOP *** [Ah Kc 4d]
Hero: checks
f32f0af0: checks
*** TURN *** [Ah Kc 4d] [6d]
Hero: checks
f32f0af0: checks
*** RIVER *** [Ah Kc 4d 6d] [4s]
Hero: bets $0.05
f32f0af0: folds
Uncalled bet ($0.05) returned to Hero
*** SHOWDOWN ***
Hero collected $0.19 from pot
*** SUMMARY ***
Total pot $0.2 | Rake $0.01 | Jackpot $0 | Bingo $0 | Fortune $0 | Tax $0
Board [Ah Kc 4d 6d 4s]
Seat 1: 862cd8a9 (button) folded before Flop (didn't bet)
Seat 2: Hero (small blind) won ($0.19)
Seat 3: f32f0af0 (big blind) folded on the River
Seat 4: af0142ec folded before Flop (didn't bet)
Seat 5: 3101bb8a folded before Flop (didn't bet)
Seat 6: 5de00f9 folded before Flop (didn't bet)


Poker Hand #RC3812419360: Hold'em No Limit ($0.02/$0.05) - 2025/08/16 23:17:10
Table 'RushAndCash1074620' 6-max Seat #1 is the button
Seat 1: ca6a4ee8 ($5.02 in chips)
Seat 2: e937107e ($9.47 in chips)
Seat 3: 11d83172 ($5.23 in chips)
Seat 4: bc48ac64 ($5.4 in chips)
Seat 5: Hero ($7.76 in chips)
Seat 6: fbfae31e ($9.83 in chips)
e937107e: posts small blind $0.02
11d83172: posts big blind $0.05
*** HOLE CARDS ***
Dealt to ca6a4ee8 
Dealt to e937107e 
Dealt to 11d83172 
Dealt to bc48ac64 
Dealt to Hero [8c Ts]
Dealt to fbfae31e 
bc48ac64: raises $0.05 to $0.1
Hero: folds
fbfae31e: folds
ca6a4ee8: folds
e937107e: raises $0.5 to $0.6
11d83172: folds
bc48ac64: folds
Uncalled bet ($0.5) returned to e937107e
*** SHOWDOWN ***
e937107e collected $0.24 from pot
*** SUMMARY ***
Total pot $0.25 | Rake $0.01 | Jackpot $0 | Bingo $0 | Fortune $0 | Tax $0
Seat 1: ca6a4ee8 (button) folded before Flop (didn't bet)
Seat 2: e937107e (small blind) collected ($0.24)
Seat 3: 11d83172 (big blind) folded before Flop
Seat 4: bc48ac64 folded before Flop
Seat 5: Hero folded before Flop (didn't bet)
Seat 6: fbfae31e folded before Flop (didn't bet)


Poker Hand #RC3812419339: Hold'em No Limit ($0.02/$0.05) - 2025/08/16 23:17:07
Table 'RushAndCash1074599' 6-max Seat #1 is the button
Seat 1: 1a6a9f96 ($5.04 in chips)
Seat 2: 1656660f ($5.96 in chips)
Seat 3: 3262d7c9 ($10.24 in chips)
Seat 4: Hero ($7.76 in chips)
Seat 5: a84e9def ($4.92 in chips)
Seat 6: e8f3d79 ($6.86 in chips)
1656660f: posts small blind $0.02
3262d7c9: posts big blind $0.05
*** HOLE CARDS ***
Dealt to 1a6a9f96 
Dealt to 1656660f 
Dealt to 3262d7c9 
Dealt to Hero [6s 9s]
Dealt to a84e9def 
Dealt to e8f3d79 
Hero: folds
a84e9def: raises $0.05 to $0.1
e8f3d79: folds
1a6a9f96: folds
1656660f: folds
3262d7c9: calls $0.05
*** FLOP *** [4s 8s 8d]
3262d7c9: checks
a84e9def: checks
*** TURN *** [4s 8s 8d] [2c]
3262d7c9: bets $0.2
a84e9def: calls $0.2
*** RIVER *** [4s 8s 8d 2c] [5s]
3262d7c9: checks
a84e9def: bets $0.5
3262d7c9: folds
Uncalled bet ($0.5) returned to a84e9def
*** SHOWDOWN ***
a84e9def collected $0.59 from pot
*** SUMMARY ***
Total pot $0.62 | Rake $0.03 | Jackpot $0 | Bingo $0 | Fortune $0 | Tax $0
Board [4s 8s 8d 2c 5s]
Seat 1: 1a6a9f96 (button) folded before Flop (didn't bet)
Seat 2: 1656660f (small blind) folded before Flop
Seat 3: 3262d7c9 (big blind) folded on the River
Seat 4: Hero folded before Flop (didn't bet)
Seat 5: a84e9def won ($0.59)
Seat 6: e8f3d79 folded before Flop (didn't bet)


Poker Hand #RC3812418999: Hold'em No Limit ($0.02/$0.05) - 2025/08/16 23:16:18
Table 'RushAndCash1074259' 6-max Seat #1 is the button
Seat 1: Hero ($7.46 in chips)
Seat 2: 4878e795 ($6.37 in chips)
Seat 3: d2729de0 ($9.43 in chips)
Seat 4: 32856fe4 ($2.04 in chips)
Seat 5: 671d6bd3 ($5.09 in chips)
Seat 6: 3262d7c9 ($10.49 in chips)
4878e795: posts small blind $0.02
d2729de0: posts big blind $0.05
*** HOLE CARDS ***
Dealt to Hero [8d 9s]
Dealt to 4878e795 
Dealt to d2729de0 
Dealt to 32856fe4 
Dealt to 671d6bd3 
Dealt to 3262d7c9 
32856fe4: folds
671d6bd3: folds
3262d7c9: raises $0.06 to $0.11
Hero: calls $0.11
4878e795: folds
d2729de0: folds
*** FLOP *** [Ah 5c Ts]
3262d7c9: checks
Hero: bets $0.14
3262d7c9: calls $0.14
*** TURN *** [Ah 5c Ts] [Ac]
3262d7c9: checks
Hero: bets $0.32
3262d7c9: folds
Uncalled bet ($0.32) returned to Hero
*** SHOWDOWN ***
Hero collected $0.55 from pot
*** SUMMARY ***
Total pot $0.57 | Rake $0.02 | Jackpot $0 | Bingo $0 | Fortune $0 | Tax $0
Board [Ah 5c Ts Ac]
Seat 1: Hero (button) won ($0.55)
Seat 2: 4878e795 (small blind) folded before Flop
Seat 3: d2729de0 (big blind) folded before Flop
Seat 4: 32856fe4 folded before Flop (didn't bet)
Seat 5: 671d6bd3 folded before Flop (didn't bet)
Seat 6: 3262d7c9 folded on the Turn


Poker Hand #RC3812418974: Hold'em No Limit ($0.02/$0.05) - 2025/08/16 23:16:15
Table 'RushAndCash1074234' 6-max Seat #1 is the button
Seat 1: 5141cdce ($5.27 in chips)
Seat 2: 87a7dca3 ($3.48 in chips)
Seat 3: 5e99a7b5 ($3.51 in chips)
Seat 4: 11a1276 ($4.94 in chips)
Seat 5: Hero ($7.46 in chips)
Seat 6: 4878e795 ($6.37 in chips)
87a7dca3: posts small blind $0.02
5e99a7b5: posts big blind $0.05
*** HOLE CARDS ***
Dealt to 5141cdce 
Dealt to 87a7dca3 
Dealt to 5e99a7b5 
Dealt to 11a1276 
Dealt to Hero [5s 9c]
Dealt to 4878e795 
11a1276: folds
Hero: folds
4878e795: folds
5141cdce: raises $0.08 to $0.13
87a7dca3: folds
5e99a7b5: folds
Uncalled bet ($0.08) returned to 5141cdce
*** SHOWDOWN ***
5141cdce collected $0.12 from pot
*** SUMMARY ***
Total pot $0.12 | Rake $0 | Jackpot $0 | Bingo $0 | Fortune $0 | Tax $0
Seat 1: 5141cdce (button) collected ($0.12)
Seat 2: 87a7dca3 (small blind) folded before Flop
Seat 3: 5e99a7b5 (big blind) folded before Flop
Seat 4: 11a1276 folded before Flop (didn't bet)
Seat 5: Hero folded before Flop (didn't bet)
Seat 6: 4878e795 folded before Flop (didn't bet)


Poker Hand #RC3812418946: Hold'em No Limit ($0.02/$0.05) - 2025/08/16 23:16:11
Table 'RushAndCash1074206' 6-max Seat #1 is the button
Seat 1: 84283a66 ($4.22 in chips)
Seat 2: 7b8cef20 ($10.9 in chips)
Seat 3: f1ee4b08 ($9.98 in chips)
Seat 4: Hero ($7.46 in chips)
Seat 5: a4c0e017 ($15.2 in chips)
Seat 6: b7fa0280 ($5.04 in chips)
7b8cef20: posts small blind $0.02
f1ee4b08: posts big blind $0.05
*** HOLE CARDS ***
Dealt to 84283a66 
Dealt to 7b8cef20 
Dealt to f1ee4b08 
Dealt to Hero [2c As]
Dealt to a4c0e017 
Dealt to b7fa0280 
Hero: folds
a4c0e017: folds
b7fa0280: folds
84283a66: folds
7b8cef20: folds
Uncalled bet ($0.03) returned to f1ee4b08
*** SHOWDOWN ***
f1ee4b08 collected $0.04 from pot
*** SUMMARY ***
Total pot $0.04 | Rake $0 | Jackpot $0 | Bingo $0 | Fortune $0 | Tax $0
Seat 1: 84283a66 (button) folded before Flop (didn't bet)
Seat 2: 7b8cef20 (small blind) folded before Flop
Seat 3: f1ee4b08 (big blind) collected ($0.04)
Seat 4: Hero folded before Flop (didn't bet)
Seat 5: a4c0e017 folded before Flop (didn't bet)
Seat 6: b7fa0280 folded before Flop (didn't bet)


Poker Hand #RC3812418647: Hold'em No Limit ($0.02/$0.05) - 2025/08/16 23:15:24
Table 'RushAndCash1073907' 6-max Seat #1 is the button
Seat 1: 7b8cef20 ($11.26 in chips)
Seat 2: 11d83172 ($5.25 in chips)
Seat 3: b9218ab2 ($11.2 in chips)
Seat 4: ea5d2dc9 ($4.08 in chips)
Seat 5: 1d91ed09 ($8.51 in chips)
Seat 6: Hero ($7.07 in chips)
11d83172: posts small blind $0.02
b9218ab2: posts big blind $0.05
*** HOLE CARDS ***
Dealt to 7b8cef20 
Dealt to 11d83172 
Dealt to b9218ab2 
Dealt to ea5d2dc9 
Dealt to 1d91ed09 
Dealt to Hero [Kh Kd]
ea5d2dc9: folds
1d91ed09: folds
Hero: raises $0.05 to $0.1
7b8cef20: raises $0.26 to $0.36
11d83172: folds
b9218ab2: folds
Hero: raises $0.5 to $0.86
7b8cef20: folds
Uncalled bet ($0.5) returned to Hero
*** SHOWDOWN ***
Hero collected $0.75 from pot
*** SUMMARY ***
Total pot $0.79 | Rake $0.04 | Jackpot $0 | Bingo $0 | Fortune $0 | Tax $0
Seat 1: 7b8cef20 (button) folded before Flop
Seat 2: 11d83172 (small blind) folded before Flop
Seat 3: b9218ab2 (big blind) folded before Flop
Seat 4: ea5d2dc9 folded before Flop (didn't bet)
Seat 5: 1d91ed09 folded before Flop (didn't bet)
Seat 6: Hero collected ($0.75)


Poker Hand #RC3812418578: Hold'em No Limit ($0.02/$0.05) - 2025/08/16 23:15:12
Table 'RushAndCash1073838' 6-max Seat #1 is the button
Seat 1: Hero ($7.07 in chips)
Seat 2: c46c7d3e ($5 in chips)
Seat 3: cee7325a ($5.32 in chips)
Seat 4: 30a7bd78 ($7.71 in chips)
Seat 5: 80a546d4 ($5.43 in chips)
Seat 6: 490139dc ($7.85 in chips)
c46c7d3e: posts small blind $0.02
cee7325a: posts big blind $0.05
*** HOLE CARDS ***
Dealt to Hero [4d Ks]
Dealt to c46c7d3e 
Dealt to cee7325a 
Dealt to 30a7bd78 
Dealt to 80a546d4 
Dealt to 490139dc 
30a7bd78: folds
80a546d4: folds
490139dc: folds
Hero: folds
c46c7d3e: raises $0.13 to $0.18
cee7325a: folds
Uncalled bet ($0.13) returned to c46c7d3e
*** SHOWDOWN ***
c46c7d3e collected $0.1 from pot
*** SUMMARY ***
Total pot $0.1 | Rake $0 | Jackpot $0 | Bingo $0 | Fortune $0 | Tax $0
Seat 1: Hero (button) folded before Flop (didn't bet)
Seat 2: c46c7d3e (small blind) collected ($0.1)
Seat 3: cee7325a (big blind) folded before Flop
Seat 4: 30a7bd78 folded before Flop (didn't bet)
Seat 5: 80a546d4 folded before Flop (didn't bet)
Seat 6: 490139dc folded before Flop (didn't bet)


Poker Hand #RC3812418522: Hold'em No Limit ($0.02/$0.05) - 2025/08/16 23:15:03
Table 'RushAndCash1073782' 6-max Seat #1 is the button
Seat 1: Hero ($7.07 in chips)
Seat 2: e285be9a ($14.52 in chips)
Seat 3: 6e8d17ab ($5.12 in chips)
Seat 4: 3262d7c9 ($10.82 in chips)
Seat 5: d2b3159e ($5 in chips)
Seat 6: d6b9968d ($6.02 in chips)
e285be9a: posts small blind $0.02
6e8d17ab: posts big blind $0.05
*** HOLE CARDS ***
Dealt to Hero [7d Js]
Dealt to e285be9a 
Dealt to 6e8d17ab 
Dealt to 3262d7c9 
Dealt to d2b3159e 
Dealt to d6b9968d 
3262d7c9: folds
d2b3159e: folds
d6b9968d: raises $0.08 to $0.13
Hero: folds
e285be9a: folds
6e8d17ab: calls $0.08
*** FLOP *** [6d Th Kd]
6e8d17ab: checks
d6b9968d: checks
*** TURN *** [6d Th Kd] [Jd]
6e8d17ab: checks
d6b9968d: checks
*** RIVER *** [6d Th Kd Jd] [Qs]
6e8d17ab: checks
d6b9968d: checks
6e8d17ab: shows [9s 9d] (a straight, King to Nine)
d6b9968d: shows [4s As] (a straight, Ace to Ten)
*** SHOWDOWN ***
d6b9968d collected $0.27 from pot
*** SUMMARY ***
Total pot $0.28 | Rake $0.01 | Jackpot $0 | Bingo $0 | Fortune $0 | Tax $0
Board [6d Th Kd Jd Qs]
Seat 1: Hero (button) folded before Flop (didn't bet)
Seat 2: e285be9a (small blind) folded before Flop
Seat 3: 6e8d17ab (big blind) showed [9s 9d] and lost with a straight, King to Nine
Seat 4: 3262d7c9 folded before Flop (didn't bet)
Seat 5: d2b3159e folded before Flop (didn't bet)
Seat 6: d6b9968d showed [4s As] and won ($0.27) with a straight, Ace to Ten


Poker Hand #RC3812418498: Hold'em No Limit ($0.02/$0.05) - 2025/08/16 23:15:00
Table 'RushAndCash1073758' 6-max Seat #1 is the button
Seat 1: d6b9968d ($6.02 in chips)
Seat 2: f26a9f66 ($12.6 in chips)
Seat 3: Hero ($7.12 in chips)
Seat 4: 11a1276 ($4.57 in chips)
Seat 5: 3262d7c9 ($10.82 in chips)
Seat 6: d2b3159e ($5 in chips)
f26a9f66: posts small blind $0.02
Hero: posts big blind $0.05
*** HOLE CARDS ***
Dealt to d6b9968d 
Dealt to f26a9f66 
Dealt to Hero [Ks 2s]
Dealt to 11a1276 
Dealt to 3262d7c9 
Dealt to d2b3159e 
11a1276: raises $0.05 to $0.1
3262d7c9: folds
d2b3159e: folds
d6b9968d: folds
f26a9f66: folds
Hero: folds
Uncalled bet ($0.05) returned to 11a1276
*** SHOWDOWN ***
11a1276 collected $0.12 from pot
*** SUMMARY ***
Total pot $0.12 | Rake $0 | Jackpot $0 | Bingo $0 | Fortune $0 | Tax $0
Seat 1: d6b9968d (button) folded before Flop (didn't bet)
Seat 2: f26a9f66 (small blind) folded before Flop
Seat 3: Hero (big blind) folded before Flop
Seat 4: 11a1276 collected ($0.12)
Seat 5: 3262d7c9 folded before Flop (didn't bet)
Seat 6: d2b3159e folded before Flop (didn't bet)


Poker Hand #RC3812418051: Hold'em No Limit ($0.02/$0.05) - 2025/08/16 23:13:52
Table 'RushAndCash1073311' 6-max Seat #1 is the button
Seat 1: 3812131a ($6.86 in chips)
Seat 2: Hero ($4.93 in chips)
Seat 3: d53969aa ($5 in chips)
Seat 4: d03f1112 ($5.42 in chips)
Seat 5: 3bb4dc6e ($5.83 in chips)
Seat 6: caabc696 ($10.32 in chips)
Hero: posts small blind $0.02
d53969aa: posts big blind $0.05
*** HOLE CARDS ***
Dealt to 3812131a 
Dealt to Hero [Kc Kd]
Dealt to d53969aa 
Dealt to d03f1112 
Dealt to 3bb4dc6e 
Dealt to caabc696 
d03f1112: folds
3bb4dc6e: folds
caabc696: raises $0.05 to $0.1
3812131a: folds
Hero: raises $0.4 to $0.5
d53969aa: folds
caabc696: calls $0.4
*** FLOP *** [As 3d Tc]
Hero: bets $0.24
caabc696: raises $0.34 to $0.58
Hero: calls $0.34
*** TURN *** [As 3d Tc] [5c]
Hero: checks
caabc696: bets $1.28
Hero: raises $2.57 to $3.85 and is all-in
caabc696: folds
Uncalled bet ($2.57) returned to Hero
*** SHOWDOWN ***
Hero collected $4.55 from pot
*** SUMMARY ***
Total pot $4.77 | Rake $0.15 | Jackpot $0.07 | Bingo $0 | Fortune $0 | Tax $0
Board [As 3d Tc 5c]
Seat 1: 3812131a (button) folded before Flop (didn't bet)
Seat 2: Hero (small blind) won ($4.55)
Seat 3: d53969aa (big blind) folded before Flop
Seat 4: d03f1112 folded before Flop (didn't bet)
Seat 5: 3bb4dc6e folded before Flop (didn't bet)
Seat 6: caabc696 folded on the Turn


Poker Hand #RC3812417881: Hold'em No Limit ($0.02/$0.05) - 2025/08/16 23:13:24
Table 'RushAndCash1073141' 6-max Seat #1 is the button
Seat 1: a31b8b26 ($6.62 in chips)
Seat 2: Hero ($4.77 in chips)
Seat 3: 856daff0 ($5.29 in chips)
Seat 4: 4640fcc3 ($5 in chips)
Seat 5: 7278ff9d ($7.79 in chips)
Seat 6: 3bb4dc6e ($5.95 in chips)
Hero: posts small blind $0.02
856daff0: posts big blind $0.05
*** HOLE CARDS ***
Dealt to a31b8b26 
Dealt to Hero [6d 6s]
Dealt to 856daff0 
Dealt to 4640fcc3 
Dealt to 7278ff9d 
Dealt to 3bb4dc6e 
4640fcc3: folds
7278ff9d: folds
3bb4dc6e: raises $0.07 to $0.12
a31b8b26: folds
Hero: raises $0.35 to $0.47
856daff0: folds
3bb4dc6e: folds
Uncalled bet ($0.35) returned to Hero
*** SHOWDOWN ***
Hero collected $0.28 from pot
*** SUMMARY ***
Total pot $0.29 | Rake $0.01 | Jackpot $0 | Bingo $0 | Fortune $0 | Tax $0
Seat 1: a31b8b26 (button) folded before Flop (didn't bet)
Seat 2: Hero (small blind) collected ($0.28)
Seat 3: 856daff0 (big blind) folded before Flop
Seat 4: 4640fcc3 folded before Flop (didn't bet)
Seat 5: 7278ff9d folded before Flop (didn't bet)
Seat 6: 3bb4dc6e folded before Flop


Poker Hand #RC3812417332: Hold'em No Limit ($0.02/$0.05) - 2025/08/16 23:12:02
Table 'RushAndCash1072592' 6-max Seat #1 is the button
Seat 1: a296c73a ($13.4 in chips)
Seat 2: a31b8b26 ($6.72 in chips)
Seat 3: 348f2571 ($5.06 in chips)
Seat 4: Hero ($4.63 in chips)
Seat 5: 8f89befa ($11.2 in chips)
Seat 6: a23a7275 ($15.8 in chips)
a31b8b26: posts small blind $0.02
348f2571: posts big blind $0.05
*** HOLE CARDS ***
Dealt to a296c73a 
Dealt to a31b8b26 
Dealt to 348f2571 
Dealt to Hero [9s As]
Dealt to 8f89befa 
Dealt to a23a7275 
Hero: raises $0.05 to $0.1
8f89befa: folds
a23a7275: folds
a296c73a: folds
a31b8b26: calls $0.08
348f2571: folds
*** FLOP *** [9c 5c Jd]
a31b8b26: checks
Hero: checks
*** TURN *** [9c 5c Jd] [4d]
a31b8b26: checks
Hero: checks
*** RIVER *** [9c 5c Jd 4d] [8d]
a31b8b26: checks
Hero: checks
a31b8b26: shows [Qh Kh] (King high)
Hero: shows [9s As] (a pair of Nines)
*** SHOWDOWN ***
Hero collected $0.24 from pot
*** SUMMARY ***
Total pot $0.25 | Rake $0.01 | Jackpot $0 | Bingo $0 | Fortune $0 | Tax $0
Board [9c 5c Jd 4d 8d]
Seat 1: a296c73a (button) folded before Flop (didn't bet)
Seat 2: a31b8b26 (small blind) showed [Qh Kh] and lost with King high
Seat 3: 348f2571 (big blind) folded before Flop
Seat 4: Hero showed [9s As] and won ($0.24) with a pair of Nines
Seat 5: 8f89befa folded before Flop (didn't bet)
Seat 6: a23a7275 folded before Flop (didn't bet)


Poker Hand #RC3812416947: Hold'em No Limit ($0.02/$0.05) - 2025/08/16 23:11:03
Table 'RushAndCash1072207' 6-max Seat #1 is the button
Seat 1: a6549da3 ($4.79 in chips)
Seat 2: 1cc531b8 ($4.41 in chips)
Seat 3: Hero ($4.86 in chips)
Seat 4: 2b893e7f ($11.27 in chips)
Seat 5: 8f89befa ($10.97 in chips)
Seat 6: f26a9f66 ($10.53 in chips)
1cc531b8: posts small blind $0.02
Hero: posts big blind $0.05
*** HOLE CARDS ***
Dealt to a6549da3 
Dealt to 1cc531b8 
Dealt to Hero [9d 9h]
Dealt to 2b893e7f 
Dealt to 8f89befa 
Dealt to f26a9f66 
2b893e7f: folds
8f89befa: raises $0.06 to $0.11
f26a9f66: folds
a6549da3: folds
1cc531b8: folds
Hero: calls $0.06
*** FLOP *** [Js 6h Qs]
Hero: checks
8f89befa: checks
*** TURN *** [Js 6h Qs] [Qh]
Hero: checks
8f89befa: bets $0.12
Hero: calls $0.12
*** RIVER *** [Js 6h Qs Qh] [Jh]
Hero: checks
8f89befa: checks
Hero: shows [9d 9h] (two pair, Queens and Jacks)
8f89befa: shows [Ah 4h] (a flush Ace high)
*** SHOWDOWN ***
8f89befa collected $0.46 from pot
*** SUMMARY ***
Total pot $0.48 | Rake $0.02 | Jackpot $0 | Bingo $0 | Fortune $0 | Tax $0
Board [Js 6h Qs Qh Jh]
Seat 1: a6549da3 (button) folded before Flop (didn't bet)
Seat 2: 1cc531b8 (small blind) folded before Flop
Seat 3: Hero (big blind) showed [9d 9h] and lost with two pair, Queens and Jacks
Seat 4: 2b893e7f folded before Flop (didn't bet)
Seat 5: 8f89befa showed [Ah 4h] and won ($0.46) with a flush Ace high
Seat 6: f26a9f66 folded before Flop (didn't bet)


Poker Hand #RC3812416924: Hold'em No Limit ($0.02/$0.05) - 2025/08/16 23:10:59
Table 'RushAndCash1072184' 6-max Seat #1 is the button
Seat 1: b36b4da8 ($7.05 in chips)
Seat 2: a6549da3 ($4.81 in chips)
Seat 3: fe7b6407 ($5.88 in chips)
Seat 4: Hero ($4.86 in chips)
Seat 5: a533daa9 ($5 in chips)
Seat 6: 5163d6d4 ($10.63 in chips)
a6549da3: posts small blind $0.02
fe7b6407: posts big blind $0.05
*** HOLE CARDS ***
Dealt to b36b4da8 
Dealt to a6549da3 
Dealt to fe7b6407 
Dealt to Hero [6h 9h]
Dealt to a533daa9 
Dealt to 5163d6d4 
Hero: folds
a533daa9: folds
5163d6d4: folds
b36b4da8: raises $0.06 to $0.11
a6549da3: folds
fe7b6407: calls $0.06
*** FLOP *** [3s 5d Kc]
fe7b6407: checks
b36b4da8: bets $0.08
fe7b6407: calls $0.08
*** TURN *** [3s 5d Kc] [Ac]
fe7b6407: checks
b36b4da8: bets $0.2
fe7b6407: calls $0.2
*** RIVER *** [3s 5d Kc Ac] [Qd]
fe7b6407: checks
b36b4da8: checks
fe7b6407: shows [Ks Th] (a pair of Kings)
b36b4da8: shows [Ad 9d] (a pair of Aces)
*** SHOWDOWN ***
b36b4da8 collected $0.76 from pot
*** SUMMARY ***
Total pot $0.8 | Rake $0.04 | Jackpot $0 | Bingo $0 | Fortune $0 | Tax $0
Board [3s 5d Kc Ac Qd]
Seat 1: b36b4da8 (button) showed [Ad 9d] and won ($0.76) with a pair of Aces
Seat 2: a6549da3 (small blind) folded before Flop
Seat 3: fe7b6407 (big blind) showed [Ks Th] and lost with a pair of Kings
Seat 4: Hero folded before Flop (didn't bet)
Seat 5: a533daa9 folded before Flop (didn't bet)
Seat 6: 5163d6d4 folded before Flop (didn't bet)


Poker Hand #RC3812416900: Hold'em No Limit ($0.02/$0.05) - 2025/08/16 23:10:55
Table 'RushAndCash1072160' 6-max Seat #1 is the button
Seat 1: dbc4d1cb ($6.89 in chips)
Seat 2: dd4d4fb6 ($5.11 in chips)
Seat 3: 27a68c75 ($6.32 in chips)
Seat 4: 491638ed ($8.86 in chips)
Seat 5: f56337ba ($8.99 in chips)
Seat 6: Hero ($4.86 in chips)
dd4d4fb6: posts small blind $0.02
27a68c75: posts big blind $0.05
*** HOLE CARDS ***
Dealt to dbc4d1cb 
Dealt to dd4d4fb6 
Dealt to 27a68c75 
Dealt to 491638ed 
Dealt to f56337ba 
Dealt to Hero [2d 9c]
491638ed: folds
f56337ba: folds
Hero: folds
dbc4d1cb: folds
dd4d4fb6: folds
Uncalled bet ($0.03) returned to 27a68c75
*** SHOWDOWN ***
27a68c75 collected $0.04 from pot
*** SUMMARY ***
Total pot $0.04 | Rake $0 | Jackpot $0 | Bingo $0 | Fortune $0 | Tax $0
Seat 1: dbc4d1cb (button) folded before Flop (didn't bet)
Seat 2: dd4d4fb6 (small blind) folded before Flop
Seat 3: 27a68c75 (big blind) collected ($0.04)
Seat 4: 491638ed folded before Flop (didn't bet)
Seat 5: f56337ba folded before Flop (didn't bet)
Seat 6: Hero folded before Flop (didn't bet)


Poker Hand #RC3812416874: Hold'em No Limit ($0.02/$0.05) - 2025/08/16 23:10:52
Table 'RushAndCash1072134' 6-max Seat #1 is the button
Seat 1: 7a0fa ($5.68 in chips)
Seat 2: e8f3d79 ($7.22 in chips)
Seat 3: aae2e126 ($9.6 in chips)
Seat 4: ebd061d5 ($4.35 in chips)
Seat 5: Hero ($4.86 in chips)
Seat 6: 6e8d17ab ($5.17 in chips)
e8f3d79: posts small blind $0.02
aae2e126: posts big blind $0.05
*** HOLE CARDS ***
Dealt to 7a0fa 
Dealt to e8f3d79 
Dealt to aae2e126 
Dealt to ebd061d5 
Dealt to Hero [3s Th]
Dealt to 6e8d17ab 
ebd061d5: folds
Hero: folds
6e8d17ab: folds
7a0fa: raises $0.05 to $0.1
e8f3d79: folds
aae2e126: calls $0.05
*** FLOP *** [Js Ah 6h]
aae2e126: checks
7a0fa: checks
*** TURN *** [Js Ah 6h] [2h]
aae2e126: checks
7a0fa: checks
*** RIVER *** [Js Ah 6h 2h] [2s]
aae2e126: checks
7a0fa: checks
aae2e126: shows [Kc Tc] (a pair of Twos)
7a0fa: shows [5h 5c] (two pair, Fives and Twos)
*** SHOWDOWN ***
7a0fa collected $0.21 from pot
*** SUMMARY ***
Total pot $0.22 | Rake $0.01 | Jackpot $0 | Bingo $0 | Fortune $0 | Tax $0
Board [Js Ah 6h 2h 2s]
Seat 1: 7a0fa (button) showed [5h 5c] and won ($0.21) with two pair, Fives and Twos
Seat 2: e8f3d79 (small blind) folded before Flop
Seat 3: aae2e126 (big blind) showed [Kc Tc] and lost with a pair of Twos
Seat 4: ebd061d5 folded before Flop (didn't bet)
Seat 5: Hero folded before Flop (didn't bet)
Seat 6: 6e8d17ab folded before Flop (didn't bet)


Poker Hand #RC3812416502: Hold'em No Limit ($0.02/$0.05) - 2025/08/16 23:09:58
Table 'RushAndCash1071762' 6-max Seat #1 is the button
Seat 1: Hero ($4.97 in chips)
Seat 2: 2b54e7a1 ($5 in chips)
Seat 3: f7cd282c ($8.4 in chips)
Seat 4: a5d049cd ($6.15 in chips)
Seat 5: 4565e75f ($7.41 in chips)
Seat 6: 2cd181a6 ($7.38 in chips)
2b54e7a1: posts small blind $0.02
f7cd282c: posts big blind $0.05
*** HOLE CARDS ***
Dealt to Hero [5c 5d]
Dealt to 2b54e7a1 
Dealt to f7cd282c 
Dealt to a5d049cd 
Dealt to 4565e75f 
Dealt to 2cd181a6 
a5d049cd: raises $0.06 to $0.11
4565e75f: calls $0.11
2cd181a6: folds
Hero: calls $0.11
2b54e7a1: folds
f7cd282c: folds
*** FLOP *** [7h Kh 3s]
a5d049cd: checks
4565e75f: checks
Hero: checks
*** TURN *** [7h Kh 3s] [Ah]
a5d049cd: bets $0.11
4565e75f: folds
Hero: folds
Uncalled bet ($0.11) returned to a5d049cd
*** SHOWDOWN ***
a5d049cd collected $0.38 from pot
*** SUMMARY ***
Total pot $0.4 | Rake $0.02 | Jackpot $0 | Bingo $0 | Fortune $0 | Tax $0
Board [7h Kh 3s Ah]
Seat 1: Hero (button) folded on the Turn
Seat 2: 2b54e7a1 (small blind) folded before Flop
Seat 3: f7cd282c (big blind) folded before Flop
Seat 4: a5d049cd won ($0.38)
Seat 5: 4565e75f folded on the Turn
Seat 6: 2cd181a6 folded before Flop (didn't bet)


Poker Hand #RC3812416158: Hold'em No Limit ($0.02/$0.05) - 2025/08/16 23:09:09
Table 'RushAndCash1071418' 6-max Seat #1 is the button
Seat 1: 6f4f7d9c ($3.33 in chips)
Seat 2: Hero ($5.07 in chips)
Seat 3: 2a8cf5cb ($4.15 in chips)
Seat 4: 91ca5189 ($5.07 in chips)
Seat 5: 2cd181a6 ($7.24 in chips)
Seat 6: aa25214e ($5.15 in chips)
Hero: posts small blind $0.02
2a8cf5cb: posts big blind $0.05
*** HOLE CARDS ***
Dealt to 6f4f7d9c 
Dealt to Hero [Qc Ks]
Dealt to 2a8cf5cb 
Dealt to 91ca5189 
Dealt to 2cd181a6 
Dealt to aa25214e 
91ca5189: folds
2cd181a6: raises $0.05 to $0.1
aa25214e: folds
6f4f7d9c: folds
Hero: calls $0.08
2a8cf5cb: folds
*** FLOP *** [5d 8d 9c]
Hero: checks
2cd181a6: bets $0.12
Hero: folds
Uncalled bet ($0.12) returned to 2cd181a6
*** SHOWDOWN ***
2cd181a6 collected $0.24 from pot
*** SUMMARY ***
Total pot $0.25 | Rake $0.01 | Jackpot $0 | Bingo $0 | Fortune $0 | Tax $0
Board [5d 8d 9c]
Seat 1: 6f4f7d9c (button) folded before Flop (didn't bet)
Seat 2: Hero (small blind) folded on the Flop
Seat 3: 2a8cf5cb (big blind) folded before Flop
Seat 4: 91ca5189 folded before Flop (didn't bet)
Seat 5: 2cd181a6 won ($0.24)
Seat 6: aa25214e folded before Flop (didn't bet)


Poker Hand #RC3812416102: Hold'em No Limit ($0.02/$0.05) - 2025/08/16 23:09:00
Table 'RushAndCash1071362' 6-max Seat #1 is the button
Seat 1: 1d14101c ($9.8 in chips)
Seat 2: b40689b1 ($5.34 in chips)
Seat 3: Hero ($5.05 in chips)
Seat 4: cc382367 ($4.98 in chips)
Seat 5: 5709dbcd ($5.2 in chips)
Seat 6: 4bde28e1 ($5.9 in chips)
b40689b1: posts small blind $0.02
Hero: posts big blind $0.05
*** HOLE CARDS ***
Dealt to 1d14101c 
Dealt to b40689b1 
Dealt to Hero [Qh 9h]
Dealt to cc382367 
Dealt to 5709dbcd 
Dealt to 4bde28e1 
cc382367: folds
5709dbcd: folds
4bde28e1: folds
1d14101c: folds
b40689b1: folds
Uncalled bet ($0.03) returned to Hero
*** SHOWDOWN ***
Hero collected $0.04 from pot
*** SUMMARY ***
Total pot $0.04 | Rake $0 | Jackpot $0 | Bingo $0 | Fortune $0 | Tax $0
Seat 1: 1d14101c (button) folded before Flop (didn't bet)
Seat 2: b40689b1 (small blind) folded before Flop
Seat 3: Hero (big blind) collected ($0.04)
Seat 4: cc382367 folded before Flop (didn't bet)
Seat 5: 5709dbcd folded before Flop (didn't bet)
Seat 6: 4bde28e1 folded before Flop (didn't bet)


Poker Hand #RC3812415970: Hold'em No Limit ($0.02/$0.05) - 2025/08/16 23:08:40
Table 'RushAndCash1071230' 6-max Seat #1 is the button
Seat 1: 490139dc ($9.55 in chips)
Seat 2: d3d9e1af ($5 in chips)
Seat 3: 4543d70c ($5.89 in chips)
Seat 4: 5a08e89d ($5 in chips)
Seat 5: 1436e805 ($11.15 in chips)
Seat 6: Hero ($4.98 in chips)
d3d9e1af: posts small blind $0.02
4543d70c: posts big blind $0.05
*** HOLE CARDS ***
Dealt to 490139dc 
Dealt to d3d9e1af 
Dealt to 4543d70c 
Dealt to 5a08e89d 
Dealt to 1436e805 
Dealt to Hero [Ac Js]
5a08e89d: folds
1436e805: folds
Hero: raises $0.05 to $0.1
490139dc: folds
d3d9e1af: folds
4543d70c: folds
Uncalled bet ($0.05) returned to Hero
*** SHOWDOWN ***
Hero collected $0.12 from pot
*** SUMMARY ***
Total pot $0.12 | Rake $0 | Jackpot $0 | Bingo $0 | Fortune $0 | Tax $0
Seat 1: 490139dc (button) folded before Flop (didn't bet)
Seat 2: d3d9e1af (small blind) folded before Flop
Seat 3: 4543d70c (big blind) folded before Flop
Seat 4: 5a08e89d folded before Flop (didn't bet)
Seat 5: 1436e805 folded before Flop (didn't bet)
Seat 6: Hero collected ($0.12)


Poker Hand #RC3812415947: Hold'em No Limit ($0.02/$0.05) - 2025/08/16 23:08:36
Table 'RushAndCash1071207' 6-max Seat #1 is the button
Seat 1: 8f89befa ($10.41 in chips)
Seat 2: 7efb9933 ($7.79 in chips)
Seat 3: 2b54e7a1 ($5.01 in chips)
Seat 4: d3d9e1af ($5 in chips)
Seat 5: Hero ($4.98 in chips)
Seat 6: d6781ef3 ($5.12 in chips)
7efb9933: posts small blind $0.02
2b54e7a1: posts big blind $0.05
*** HOLE CARDS ***
Dealt to 8f89befa 
Dealt to 7efb9933 
Dealt to 2b54e7a1 
Dealt to d3d9e1af 
Dealt to Hero [6h 2s]
Dealt to d6781ef3 
d3d9e1af: folds
Hero: folds
d6781ef3: folds
8f89befa: folds
7efb9933: raises $0.12 to $0.17
2b54e7a1: calls $0.12
*** FLOP *** [Ac 4c 8d]
7efb9933: bets $0.12
2b54e7a1: folds
Uncalled bet ($0.12) returned to 7efb9933
*** SHOWDOWN ***
7efb9933 collected $0.33 from pot
*** SUMMARY ***
Total pot $0.34 | Rake $0.01 | Jackpot $0 | Bingo $0 | Fortune $0 | Tax $0
Board [Ac 4c 8d]
Seat 1: 8f89befa (button) folded before Flop (didn't bet)
Seat 2: 7efb9933 (small blind) won ($0.33)
Seat 3: 2b54e7a1 (big blind) folded on the Flop
Seat 4: d3d9e1af folded before Flop (didn't bet)
Seat 5: Hero folded before Flop (didn't bet)
Seat 6: d6781ef3 folded before Flop (didn't bet)


Poker Hand #RC3812415903: Hold'em No Limit ($0.02/$0.05) - 2025/08/16 23:08:31
Table 'RushAndCash1071163' 6-max Seat #1 is the button
Seat 1: b7bc755f ($6.31 in chips)
Seat 2: 15a1df95 ($3.03 in chips)
Seat 3: 7efb9933 ($7.84 in chips)
Seat 4: 93e88315 ($5.11 in chips)
Seat 5: Hero ($4.98 in chips)
Seat 6: cc839719 ($5 in chips)
15a1df95: posts small blind $0.02
7efb9933: posts big blind $0.05
*** HOLE CARDS ***
Dealt to b7bc755f 
Dealt to 15a1df95 
Dealt to 7efb9933 
Dealt to 93e88315 
Dealt to Hero [4c Kc]
Dealt to cc839719 
93e88315: folds
Hero: folds
cc839719: folds
b7bc755f: raises $0.08 to $0.13
15a1df95: raises $0.24 to $0.37
7efb9933: folds
b7bc755f: raises $5.18 to $5.55
15a1df95: calls $2.66 and is all-in
Uncalled bet ($2.52) returned to b7bc755f
b7bc755f: shows [Ac Ks]
15a1df95: shows [As Kd]
*** FLOP *** [Tc 2h 9d]
*** TURN *** [Tc 2h 9d] [2d]
*** RIVER *** [Tc 2h 9d 2d] [7s]
*** SHOWDOWN ***
b7bc755f collected $2.95 from pot
15a1df95 collected $2.95 from pot
*** SUMMARY ***
Total pot $6.11 | Rake $0.14 | Jackpot $0.07 | Bingo $0 | Fortune $0 | Tax $0
Board [Tc 2h 9d 2d 7s]
Seat 1: b7bc755f (button) showed [Ac Ks] and won ($2.95) with a pair of Twos
Seat 2: 15a1df95 (small blind) showed [As Kd] and won ($2.95) with a pair of Twos
Seat 3: 7efb9933 (big blind) folded before Flop
Seat 4: 93e88315 folded before Flop (didn't bet)
Seat 5: Hero folded before Flop (didn't bet)
Seat 6: cc839719 folded before Flop (didn't bet)


Poker Hand #RC3812415742: Hold'em No Limit ($0.02/$0.05) - 2025/08/16 23:08:07
Table 'RushAndCash1071002' 6-max Seat #1 is the button
Seat 1: e285be9a ($13.67 in chips)
Seat 2: Hero ($5 in chips)
Seat 3: c0db0245 ($5.16 in chips)
Seat 4: bab6154f ($22.36 in chips)
Seat 5: 920cd971 ($5.01 in chips)
Seat 6: 9e633559 ($6.84 in chips)
Hero: posts small blind $0.02
c0db0245: posts big blind $0.05
*** HOLE CARDS ***
Dealt to e285be9a 
Dealt to Hero [6s Ah]
Dealt to c0db0245 
Dealt to bab6154f 
Dealt to 920cd971 
Dealt to 9e633559 
bab6154f: folds
920cd971: folds
9e633559: folds
e285be9a: folds
Hero: folds
Uncalled bet ($0.03) returned to c0db0245
*** SHOWDOWN ***
c0db0245 collected $0.04 from pot
*** SUMMARY ***
Total pot $0.04 | Rake $0 | Jackpot $0 | Bingo $0 | Fortune $0 | Tax $0
Seat 1: e285be9a (button) folded before Flop (didn't bet)
Seat 2: Hero (small blind) folded before Flop
Seat 3: c0db0245 (big blind) collected ($0.04)
Seat 4: bab6154f folded before Flop (didn't bet)
Seat 5: 920cd971 folded before Flop (didn't bet)
Seat 6: 9e633559 folded before Flop (didn't bet)


Poker Hand #RC3812415085: Hold'em No Limit ($0.02/$0.05) - 2025/08/16 23:06:32
Table 'RushAndCash1070345' 6-max Seat #1 is the button
Seat 1: fe7b6407 ($5 in chips)
Seat 2: d171b62f ($5.72 in chips)
Seat 3: Hero ($6.97 in chips)
Seat 4: a296c73a ($6.78 in chips)
Seat 5: 36652e67 ($5.89 in chips)
Seat 6: 8a5d6444 ($5.38 in chips)
d171b62f: posts small blind $0.02
Hero: posts big blind $0.05
*** HOLE CARDS ***
Dealt to fe7b6407 
Dealt to d171b62f 
Dealt to Hero [Ac 7c]
Dealt to a296c73a 
Dealt to 36652e67 
Dealt to 8a5d6444 
a296c73a: raises $0.05 to $0.1
36652e67: folds
8a5d6444: folds
fe7b6407: folds
d171b62f: folds
Hero: calls $0.05
*** FLOP *** [9h 2c Kc]
Hero: checks
a296c73a: bets $0.11
Hero: raises $0.29 to $0.4
a296c73a: calls $0.29
*** TURN *** [9h 2c Kc] [Jd]
Hero: bets $0.84
a296c73a: raises $1.56 to $2.4
Hero: calls $1.56
*** RIVER *** [9h 2c Kc Jd] [Qd]
Hero: bets $4.07 and is all-in
a296c73a: calls $3.88 and is all-in
Uncalled bet ($0.19) returned to Hero
Hero: shows [Ac 7c] (Ace high)
a296c73a: shows [Kh Jh] (two pair, Kings and Jacks)
*** SHOWDOWN ***
a296c73a collected $13.36 from pot
*** SUMMARY ***
Total pot $13.58 | Rake $0.15 | Jackpot $0.07 | Bingo $0 | Fortune $0 | Tax $0
Board [9h 2c Kc Jd Qd]
Seat 1: fe7b6407 (button) folded before Flop (didn't bet)
Seat 2: d171b62f (small blind) folded before Flop
Seat 3: Hero (big blind) showed [Ac 7c] and lost with Ace high
Seat 4: a296c73a showed [Kh Jh] and won ($13.36) with two pair, Kings and Jacks
Seat 5: 36652e67 folded before Flop (didn't bet)
Seat 6: 8a5d6444 folded before Flop (didn't bet)


Poker Hand #RC3812414873: Hold'em No Limit ($0.02/$0.05) - 2025/08/16 23:06:01
Table 'RushAndCash1070133' 6-max Seat #1 is the button
Seat 1: 61fde3d6 ($8.18 in chips)
Seat 2: c4704ea4 ($5.47 in chips)
Seat 3: a354ad0d ($6.48 in chips)
Seat 4: c3bc454f ($18.23 in chips)
Seat 5: 3186442b ($4.83 in chips)
Seat 6: Hero ($6.81 in chips)
c4704ea4: posts small blind $0.02
a354ad0d: posts big blind $0.05
*** HOLE CARDS ***
Dealt to 61fde3d6 
Dealt to c4704ea4 
Dealt to a354ad0d 
Dealt to c3bc454f 
Dealt to 3186442b 
Dealt to Hero [Jh Kc]
c3bc454f: folds
3186442b: folds
Hero: raises $0.05 to $0.1
61fde3d6: calls $0.1
c4704ea4: folds
a354ad0d: folds
*** FLOP *** [Kd 8d Qh]
Hero: bets $0.05
61fde3d6: folds
Uncalled bet ($0.05) returned to Hero
*** SHOWDOWN ***
Hero collected $0.26 from pot
*** SUMMARY ***
Total pot $0.27 | Rake $0.01 | Jackpot $0 | Bingo $0 | Fortune $0 | Tax $0
Board [Kd 8d Qh]
Seat 1: 61fde3d6 (button) folded on the Flop
Seat 2: c4704ea4 (small blind) folded before Flop
Seat 3: a354ad0d (big blind) folded before Flop
Seat 4: c3bc454f folded before Flop (didn't bet)
Seat 5: 3186442b folded before Flop (didn't bet)
Seat 6: Hero won ($0.26)


Poker Hand #RC3812414819: Hold'em No Limit ($0.02/$0.05) - 2025/08/16 23:05:54
Table 'RushAndCash1070079' 6-max Seat #1 is the button
Seat 1: Hero ($6.81 in chips)
Seat 2: b3777e32 ($6.65 in chips)
Seat 3: 5a9324a6 ($5.02 in chips)
Seat 4: 3101bb8a ($9.21 in chips)
Seat 5: 8ff382fa ($5.52 in chips)
Seat 6: bab6154f ($22.37 in chips)
b3777e32: posts small blind $0.02
5a9324a6: posts big blind $0.05
*** HOLE CARDS ***
Dealt to Hero [Jd 7s]
Dealt to b3777e32 
Dealt to 5a9324a6 
Dealt to 3101bb8a 
Dealt to 8ff382fa 
Dealt to bab6154f 
3101bb8a: folds
8ff382fa: folds
bab6154f: raises $0.05 to $0.1
Hero: folds
b3777e32: folds
5a9324a6: folds
Uncalled bet ($0.05) returned to bab6154f
*** SHOWDOWN ***
bab6154f collected $0.12 from pot
*** SUMMARY ***
Total pot $0.12 | Rake $0 | Jackpot $0 | Bingo $0 | Fortune $0 | Tax $0
Seat 1: Hero (button) folded before Flop (didn't bet)
Seat 2: b3777e32 (small blind) folded before Flop
Seat 3: 5a9324a6 (big blind) folded before Flop
Seat 4: 3101bb8a folded before Flop (didn't bet)
Seat 5: 8ff382fa folded before Flop (didn't bet)
Seat 6: bab6154f collected ($0.12)


Poker Hand #RC3812414792: Hold'em No Limit ($0.02/$0.05) - 2025/08/16 23:05:50
Table 'RushAndCash1070052' 6-max Seat #1 is the button
Seat 1: fbfae31e ($8.04 in chips)
Seat 2: 60d16038 ($8.56 in chips)
Seat 3: f3461c88 ($12.69 in chips)
Seat 4: Hero ($6.81 in chips)
Seat 5: c9717df4 ($11.9 in chips)
Seat 6: bab6154f ($22.37 in chips)
60d16038: posts small blind $0.02
f3461c88: posts big blind $0.05
*** HOLE CARDS ***
Dealt to fbfae31e 
Dealt to 60d16038 
Dealt to f3461c88 
Dealt to Hero [8d Ks]
Dealt to c9717df4 
Dealt to bab6154f 
Hero: folds
c9717df4: folds
bab6154f: folds
fbfae31e: folds
60d16038: raises $0.07 to $0.12
f3461c88: raises $0.18 to $0.3
60d16038: raises $0.63 to $0.93
f3461c88: calls $0.63
*** FLOP *** [7h Td 7c]
60d16038: bets $0.93
f3461c88: raises $2.05 to $2.98
60d16038: folds
Uncalled bet ($2.05) returned to f3461c88
*** SHOWDOWN ***
f3461c88 collected $3.5 from pot
*** SUMMARY ***
Total pot $3.72 | Rake $0.15 | Jackpot $0.07 | Bingo $0 | Fortune $0 | Tax $0
Board [7h Td 7c]
Seat 1: fbfae31e (button) folded before Flop (didn't bet)
Seat 2: 60d16038 (small blind) folded on the Flop
Seat 3: f3461c88 (big blind) won ($3.5)
Seat 4: Hero folded before Flop (didn't bet)
Seat 5: c9717df4 folded before Flop (didn't bet)
Seat 6: bab6154f folded before Flop (didn't bet)


Poker Hand #RC3812414765: Hold'em No Limit ($0.02/$0.05) - 2025/08/16 23:05:46
Table 'RushAndCash1070025' 6-max Seat #1 is the button
Seat 1: 27a68c75 ($6.97 in chips)
Seat 2: 2a8cf5cb ($4.63 in chips)
Seat 3: bab6154f ($22.42 in chips)
Seat 4: c2ca82e4 ($5.18 in chips)
Seat 5: 677d66f ($5.37 in chips)
Seat 6: Hero ($6.81 in chips)
2a8cf5cb: posts small blind $0.02
bab6154f: posts big blind $0.05
*** HOLE CARDS ***
Dealt to 27a68c75 
Dealt to 2a8cf5cb 
Dealt to bab6154f 
Dealt to c2ca82e4 
Dealt to 677d66f 
Dealt to Hero [Ts 6d]
c2ca82e4: folds
677d66f: folds
Hero: folds
27a68c75: raises $0.08 to $0.13
2a8cf5cb: raises $0.27 to $0.4
bab6154f: folds
27a68c75: folds
Uncalled bet ($0.27) returned to 2a8cf5cb
*** SHOWDOWN ***
2a8cf5cb collected $0.3 from pot
*** SUMMARY ***
Total pot $0.31 | Rake $0.01 | Jackpot $0 | Bingo $0 | Fortune $0 | Tax $0
Seat 1: 27a68c75 (button) folded before Flop
Seat 2: 2a8cf5cb (small blind) collected ($0.3)
Seat 3: bab6154f (big blind) folded before Flop
Seat 4: c2ca82e4 folded before Flop (didn't bet)
Seat 5: 677d66f folded before Flop (didn't bet)
Seat 6: Hero folded before Flop (didn't bet)


Poker Hand #RC3812374388: Hold'em No Limit ($0.02/$0.05) - 2025/08/16 23:04:55
Table 'RushAndCash1069648' 6-max Seat #1 is the button
Seat 1: 10dff872 ($7.54 in chips)
Seat 2: e937107e ($7.43 in chips)
Seat 3: c2ca82e4 ($5.07 in chips)
Seat 4: 9a17a103 ($5.1 in chips)
Seat 5: Hero ($6.91 in chips)
Seat 6: b7dc32d3 ($5.17 in chips)
e937107e: posts small blind $0.02
c2ca82e4: posts big blind $0.05
*** HOLE CARDS ***
Dealt to 10dff872 
Dealt to e937107e 
Dealt to c2ca82e4 
Dealt to 9a17a103 
Dealt to Hero [Th Ks]
Dealt to b7dc32d3 
9a17a103: folds
Hero: raises $0.05 to $0.1
b7dc32d3: folds
10dff872: folds
e937107e: folds
c2ca82e4: calls $0.05
*** FLOP *** [Ac 8s 4s]
c2ca82e4: checks
Hero: checks
*** TURN *** [Ac 8s 4s] [8c]
c2ca82e4: bets $0.1
Hero: folds
Uncalled bet ($0.1) returned to c2ca82e4
*** SHOWDOWN ***
c2ca82e4 collected $0.21 from pot
*** SUMMARY ***
Total pot $0.22 | Rake $0.01 | Jackpot $0 | Bingo $0 | Fortune $0 | Tax $0
Board [Ac 8s 4s 8c]
Seat 1: 10dff872 (button) folded before Flop (didn't bet)
Seat 2: e937107e (small blind) folded before Flop
Seat 3: c2ca82e4 (big blind) won ($0.21)
Seat 4: 9a17a103 folded before Flop (didn't bet)
Seat 5: Hero folded on the Turn
Seat 6: b7dc32d3 folded before Flop (didn't bet)


Poker Hand #RC3812374275: Hold'em No Limit ($0.02/$0.05) - 2025/08/16 23:04:39
Table 'RushAndCash1069535' 6-max Seat #1 is the button
Seat 1: 61515699 ($5.05 in chips)
Seat 2: 5f1dba5d ($1.99 in chips)
Seat 3: Hero ($6.96 in chips)
Seat 4: d43ea0aa ($5.48 in chips)
Seat 5: bd1c70d5 ($3.82 in chips)
Seat 6: 490139dc ($8.62 in chips)
5f1dba5d: posts small blind $0.02
Hero: posts big blind $0.05
*** HOLE CARDS ***
Dealt to 61515699 
Dealt to 5f1dba5d 
Dealt to Hero [4d 8h]
Dealt to d43ea0aa 
Dealt to bd1c70d5 
Dealt to 490139dc 
d43ea0aa: folds
bd1c70d5: folds
490139dc: folds
61515699: raises $0.05 to $0.1
5f1dba5d: folds
Hero: folds
Uncalled bet ($0.05) returned to 61515699
*** SHOWDOWN ***
61515699 collected $0.12 from pot
*** SUMMARY ***
Total pot $0.12 | Rake $0 | Jackpot $0 | Bingo $0 | Fortune $0 | Tax $0
Seat 1: 61515699 (button) collected ($0.12)
Seat 2: 5f1dba5d (small blind) folded before Flop
Seat 3: Hero (big blind) folded before Flop
Seat 4: d43ea0aa folded before Flop (didn't bet)
Seat 5: bd1c70d5 folded before Flop (didn't bet)
Seat 6: 490139dc folded before Flop (didn't bet)


Poker Hand #RC3812374235: Hold'em No Limit ($0.02/$0.05) - 2025/08/16 23:04:34
Table 'RushAndCash1069495' 6-max Seat #1 is the button
Seat 1: 9743cff4 ($5.07 in chips)
Seat 2: Hero ($6.98 in chips)
Seat 3: db82a614 ($5.33 in chips)
Seat 4: 78083b4e ($9.69 in chips)
Seat 5: 4565e75f ($6.17 in chips)
Seat 6: 906765d0 ($19.58 in chips)
Hero: posts small blind $0.02
db82a614: posts big blind $0.05
*** HOLE CARDS ***
Dealt to 9743cff4 
Dealt to Hero [7h 9c]
Dealt to db82a614 
Dealt to 78083b4e 
Dealt to 4565e75f 
Dealt to 906765d0 
78083b4e: folds
4565e75f: folds
906765d0: raises $0.05 to $0.1
9743cff4: folds
Hero: folds
db82a614: folds
Uncalled bet ($0.05) returned to 906765d0
*** SHOWDOWN ***
906765d0 collected $0.12 from pot
*** SUMMARY ***
Total pot $0.12 | Rake $0 | Jackpot $0 | Bingo $0 | Fortune $0 | Tax $0
Seat 1: 9743cff4 (button) folded before Flop (didn't bet)
Seat 2: Hero (small blind) folded before Flop
Seat 3: db82a614 (big blind) folded before Flop
Seat 4: 78083b4e folded before Flop (didn't bet)
Seat 5: 4565e75f folded before Flop (didn't bet)
Seat 6: 906765d0 collected ($0.12)


Poker Hand #RC3812374124: Hold'em No Limit ($0.02/$0.05) - 2025/08/16 23:04:17
Table 'RushAndCash1069384' 6-max Seat #1 is the button
Seat 1: Hero ($6.91 in chips)
Seat 2: cca18c03 ($5.78 in chips)
Seat 3: ff779fac ($5.74 in chips)
Seat 4: 51a675e3 ($4.93 in chips)
Seat 5: 2b54e7a1 ($5.32 in chips)
Seat 6: dde5d1b0 ($3.53 in chips)
cca18c03: posts small blind $0.02
ff779fac: posts big blind $0.05
*** HOLE CARDS ***
Dealt to Hero [Kh Th]
Dealt to cca18c03 
Dealt to ff779fac 
Dealt to 51a675e3 
Dealt to 2b54e7a1 
Dealt to dde5d1b0 
51a675e3: folds
2b54e7a1: folds
dde5d1b0: folds
Hero: raises $0.1 to $0.15
cca18c03: folds
ff779fac: folds
Uncalled bet ($0.1) returned to Hero
*** SHOWDOWN ***
Hero collected $0.12 from pot
*** SUMMARY ***
Total pot $0.12 | Rake $0 | Jackpot $0 | Bingo $0 | Fortune $0 | Tax $0
Seat 1: Hero (button) collected ($0.12)
Seat 2: cca18c03 (small blind) folded before Flop
Seat 3: ff779fac (big blind) folded before Flop
Seat 4: 51a675e3 folded before Flop (didn't bet)
Seat 5: 2b54e7a1 folded before Flop (didn't bet)
Seat 6: dde5d1b0 folded before Flop (didn't bet)


Poker Hand #RC3812374100: Hold'em No Limit ($0.02/$0.05) - 2025/08/16 23:04:14
Table 'RushAndCash1069360' 6-max Seat #1 is the button
Seat 1: 491638ed ($4.97 in chips)
Seat 2: cc382367 ($4.83 in chips)
Seat 3: b61e58e4 ($5 in chips)
Seat 4: Hero ($6.91 in chips)
Seat 5: 250edbf5 ($9.67 in chips)
Seat 6: dde5d1b0 ($3.53 in chips)
cc382367: posts small blind $0.02
b61e58e4: posts big blind $0.05
*** HOLE CARDS ***
Dealt to 491638ed 
Dealt to cc382367 
Dealt to b61e58e4 
Dealt to Hero [4s Td]
Dealt to 250edbf5 
Dealt to dde5d1b0 
Hero: folds
250edbf5: folds
dde5d1b0: folds
491638ed: folds
cc382367: folds
Uncalled bet ($0.03) returned to b61e58e4
*** SHOWDOWN ***
b61e58e4 collected $0.04 from pot
*** SUMMARY ***
Total pot $0.04 | Rake $0 | Jackpot $0 | Bingo $0 | Fortune $0 | Tax $0
Seat 1: 491638ed (button) folded before Flop (didn't bet)
Seat 2: cc382367 (small blind) folded before Flop
Seat 3: b61e58e4 (big blind) collected ($0.04)
Seat 4: Hero folded before Flop (didn't bet)
Seat 5: 250edbf5 folded before Flop (didn't bet)
Seat 6: dde5d1b0 folded before Flop (didn't bet)


Poker Hand #RC3812374079: Hold'em No Limit ($0.02/$0.05) - 2025/08/16 23:04:10
Table 'RushAndCash1069339' 6-max Seat #1 is the button
Seat 1: 5d791f1e ($5.53 in chips)
Seat 2: 684baffd ($5.83 in chips)
Seat 3: 3812131a ($11.74 in chips)
Seat 4: Hero ($6.91 in chips)
Seat 5: 5a08e89d ($5.19 in chips)
Seat 6: 250edbf5 ($9.67 in chips)
684baffd: posts small blind $0.02
3812131a: posts big blind $0.05
*** HOLE CARDS ***
Dealt to 5d791f1e 
Dealt to 684baffd 
Dealt to 3812131a 
Dealt to Hero [4h Qc]
Dealt to 5a08e89d 
Dealt to 250edbf5 
Hero: folds
5a08e89d: folds
250edbf5: folds
5d791f1e: raises $0.06 to $0.11
684baffd: folds
3812131a: folds
Uncalled bet ($0.06) returned to 5d791f1e
*** SHOWDOWN ***
5d791f1e collected $0.12 from pot
*** SUMMARY ***
Total pot $0.12 | Rake $0 | Jackpot $0 | Bingo $0 | Fortune $0 | Tax $0
Seat 1: 5d791f1e (button) collected ($0.12)
Seat 2: 684baffd (small blind) folded before Flop
Seat 3: 3812131a (big blind) folded before Flop
Seat 4: Hero folded before Flop (didn't bet)
Seat 5: 5a08e89d folded before Flop (didn't bet)
Seat 6: 250edbf5 folded before Flop (didn't bet)


Poker Hand #RC3812374057: Hold'em No Limit ($0.02/$0.05) - 2025/08/16 23:04:07
Table 'RushAndCash1069317' 6-max Seat #1 is the button
Seat 1: fe2e39a0 ($13.51 in chips)
Seat 2: 499896b8 ($5 in chips)
Seat 3: 61515699 ($5.17 in chips)
Seat 4: cd48acda ($5.68 in chips)
Seat 5: Hero ($6.91 in chips)
Seat 6: 5a08e89d ($5.19 in chips)
499896b8: posts small blind $0.02
61515699: posts big blind $0.05
*** HOLE CARDS ***
Dealt to fe2e39a0 
Dealt to 499896b8 
Dealt to 61515699 
Dealt to cd48acda 
Dealt to Hero [3s 2h]
Dealt to 5a08e89d 
cd48acda: raises $0.06 to $0.11
Hero: folds
5a08e89d: folds
fe2e39a0: folds
499896b8: raises $0.34 to $0.45
61515699: folds
cd48acda: raises $0.72 to $1.17
499896b8: calls $0.72
*** FLOP *** [4d 3c Td]
499896b8: checks
cd48acda: bets $0.79
499896b8: calls $0.79
*** TURN *** [4d 3c Td] [Jh]
499896b8: checks
cd48acda: bets $2.98
499896b8: raises $0.06 to $3.04 and is all-in
cd48acda: calls $0.06
499896b8: shows [As Ad] (a pair of Aces)
cd48acda: shows [2c Ac] (Ace high)
*** RIVER *** [4d 3c Td Jh] [8h]
*** SHOWDOWN ***
499896b8 collected $9.83 from pot
*** SUMMARY ***
Total pot $10.05 | Rake $0.15 | Jackpot $0.07 | Bingo $0 | Fortune $0 | Tax $0
Board [4d 3c Td Jh 8h]
Seat 1: fe2e39a0 (button) folded before Flop (didn't bet)
Seat 2: 499896b8 (small blind) showed [As Ad] and won ($9.83) with a pair of Aces
Seat 3: 61515699 (big blind) folded before Flop
Seat 4: cd48acda showed [2c Ac] and lost with Ace high
Seat 5: Hero folded before Flop (didn't bet)
Seat 6: 5a08e89d folded before Flop (didn't bet)


Poker Hand #RC3812373636: Hold'em No Limit ($0.02/$0.05) - 2025/08/16 23:03:08
Table 'RushAndCash1068896' 6-max Seat #1 is the button
Seat 1: Hero ($7.12 in chips)
Seat 2: acc3e15d ($3.45 in chips)
Seat 3: cd48acda ($5.47 in chips)
Seat 4: 84412c1e ($6.71 in chips)
Seat 5: 19c34900 ($5.07 in chips)
Seat 6: 6c196a1f ($22.19 in chips)
acc3e15d: posts small blind $0.02
cd48acda: posts big blind $0.05
*** HOLE CARDS ***
Dealt to Hero [Ad Ks]
Dealt to acc3e15d 
Dealt to cd48acda 
Dealt to 84412c1e 
Dealt to 19c34900 
Dealt to 6c196a1f 
84412c1e: folds
19c34900: folds
6c196a1f: folds
Hero: raises $0.05 to $0.1
acc3e15d: folds
cd48acda: calls $0.05
*** FLOP *** [3c 5s 5c]
cd48acda: checks
Hero: checks
*** TURN *** [3c 5s 5c] [4s]
cd48acda: checks
Hero: bets $0.11
cd48acda: calls $0.11
*** RIVER *** [3c 5s 5c 4s] [9d]
cd48acda: checks
Hero: checks
cd48acda: shows [2h 2c] (two pair, Fives and Twos)
Hero: shows [Ad Ks] (a pair of Fives)
*** SHOWDOWN ***
cd48acda collected $0.42 from pot
*** SUMMARY ***
Total pot $0.44 | Rake $0.02 | Jackpot $0 | Bingo $0 | Fortune $0 | Tax $0
Board [3c 5s 5c 4s 9d]
Seat 1: Hero (button) showed [Ad Ks] and lost with a pair of Fives
Seat 2: acc3e15d (small blind) folded before Flop
Seat 3: cd48acda (big blind) showed [2h 2c] and won ($0.42) with two pair, Fives and Twos
Seat 4: 84412c1e folded before Flop (didn't bet)
Seat 5: 19c34900 folded before Flop (didn't bet)
Seat 6: 6c196a1f folded before Flop (didn't bet)


Poker Hand #RC3812373246: Hold'em No Limit ($0.02/$0.05) - 2025/08/16 23:02:12
Table 'RushAndCash1068506' 6-max Seat #1 is the button
Seat 1: 61515699 ($5 in chips)
Seat 2: 84412c1e ($7.06 in chips)
Seat 3: Hero ($6.8 in chips)
Seat 4: 45c2636a ($5.1 in chips)
Seat 5: 6a13208a ($11.7 in chips)
Seat 6: 779626ea ($5.41 in chips)
84412c1e: posts small blind $0.02
Hero: posts big blind $0.05
*** HOLE CARDS ***
Dealt to 61515699 
Dealt to 84412c1e 
Dealt to Hero [Kh 9h]
Dealt to 45c2636a 
Dealt to 6a13208a 
Dealt to 779626ea 
45c2636a: folds
6a13208a: folds
779626ea: folds
61515699: folds
84412c1e: raises $0.09 to $0.14
Hero: calls $0.09
*** FLOP *** [2c 6c 9c]
84412c1e: checks
Hero: checks
*** TURN *** [2c 6c 9c] [Jh]
84412c1e: bets $0.21
Hero: calls $0.21
*** RIVER *** [2c 6c 9c Jh] [5c]
84412c1e: checks
Hero: checks
84412c1e: shows [8d Ad] (Ace high)
Hero: shows [Kh 9h] (a pair of Nines)
*** SHOWDOWN ***
Hero collected $0.67 from pot
*** SUMMARY ***
Total pot $0.7 | Rake $0.03 | Jackpot $0 | Bingo $0 | Fortune $0 | Tax $0
Board [2c 6c 9c Jh 5c]
Seat 1: 61515699 (button) folded before Flop (didn't bet)
Seat 2: 84412c1e (small blind) showed [8d Ad] and lost with Ace high
Seat 3: Hero (big blind) showed [Kh 9h] and won ($0.67) with a pair of Nines
Seat 4: 45c2636a folded before Flop (didn't bet)
Seat 5: 6a13208a folded before Flop (didn't bet)
Seat 6: 779626ea folded before Flop (didn't bet)


Poker Hand #RC3812373039: Hold'em No Limit ($0.02/$0.05) - 2025/08/16 23:01:44
Table 'RushAndCash1068299' 6-max Seat #1 is the button
Seat 1: 6a13208a ($11.8 in chips)
Seat 2: Hero ($6.66 in chips)
Seat 3: 1319708a ($16 in chips)
Seat 4: da06bbfc ($5 in chips)
Seat 5: 1d91ed09 ($5.2 in chips)
Seat 6: 645c1c8a ($5.74 in chips)
Hero: posts small blind $0.02
1319708a: posts big blind $0.05
*** HOLE CARDS ***
Dealt to 6a13208a 
Dealt to Hero [Jc Jd]
Dealt to 1319708a 
Dealt to da06bbfc 
Dealt to 1d91ed09 
Dealt to 645c1c8a 
da06bbfc: folds
1d91ed09: folds
645c1c8a: folds
6a13208a: raises $0.05 to $0.1
Hero: raises $0.32 to $0.42
1319708a: folds
6a13208a: folds
Uncalled bet ($0.32) returned to Hero
*** SHOWDOWN ***
Hero collected $0.24 from pot
*** SUMMARY ***
Total pot $0.25 | Rake $0.01 | Jackpot $0 | Bingo $0 | Fortune $0 | Tax $0
Seat 1: 6a13208a (button) folded before Flop
Seat 2: Hero (small blind) collected ($0.24)
Seat 3: 1319708a (big blind) folded before Flop
Seat 4: da06bbfc folded before Flop (didn't bet)
Seat 5: 1d91ed09 folded before Flop (didn't bet)
Seat 6: 645c1c8a folded before Flop (didn't bet)


Poker Hand #RC3812373012: Hold'em No Limit ($0.02/$0.05) - 2025/08/16 23:01:40
Table 'RushAndCash1068272' 6-max Seat #1 is the button
Seat 1: 15d2b261 ($6.28 in chips)
Seat 2: 4878e795 ($5.15 in chips)
Seat 3: e96405cf ($9.37 in chips)
Seat 4: 4565e75f ($6.98 in chips)
Seat 5: 617766ca ($26.36 in chips)
Seat 6: Hero ($6.66 in chips)
4878e795: posts small blind $0.02
e96405cf: posts big blind $0.05
*** HOLE CARDS ***
Dealt to 15d2b261 
Dealt to 4878e795 
Dealt to e96405cf 
Dealt to 4565e75f 
Dealt to 617766ca 
Dealt to Hero [Ks 3c]
4565e75f: folds
617766ca: raises $0.05 to $0.1
Hero: folds
15d2b261: folds
4878e795: folds
e96405cf: calls $0.05
*** FLOP *** [Jc 6c 2c]
e96405cf: checks
617766ca: bets $0.08
e96405cf: calls $0.08
*** TURN *** [Jc 6c 2c] [Kh]
e96405cf: checks
617766ca: checks
*** RIVER *** [Jc 6c 2c Kh] [4s]
e96405cf: checks
617766ca: checks
e96405cf: shows [5d 5s] (a pair of Fives)
617766ca: shows [Td As] (Ace high)
*** SHOWDOWN ***
e96405cf collected $0.36 from pot
*** SUMMARY ***
Total pot $0.38 | Rake $0.02 | Jackpot $0 | Bingo $0 | Fortune $0 | Tax $0
Board [Jc 6c 2c Kh 4s]
Seat 1: 15d2b261 (button) folded before Flop (didn't bet)
Seat 2: 4878e795 (small blind) folded before Flop
Seat 3: e96405cf (big blind) showed [5d 5s] and won ($0.36) with a pair of Fives
Seat 4: 4565e75f folded before Flop (didn't bet)
Seat 5: 617766ca showed [Td As] and lost with Ace high
Seat 6: Hero folded before Flop (didn't bet)


Poker Hand #RC3812372979: Hold'em No Limit ($0.02/$0.05) - 2025/08/16 23:01:35
Table 'RushAndCash1068239' 6-max Seat #1 is the button
Seat 1: 6c6a6600 ($10.23 in chips)
Seat 2: 272a417f ($4.2 in chips)
Seat 3: e9bbdd74 ($5.54 in chips)
Seat 4: Hero ($6.66 in chips)
Seat 5: 47431e8a ($4.8 in chips)
Seat 6: f5c9cae3 ($5.67 in chips)
272a417f: posts small blind $0.02
e9bbdd74: posts big blind $0.05
*** HOLE CARDS ***
Dealt to 6c6a6600 
Dealt to 272a417f 
Dealt to e9bbdd74 
Dealt to Hero [Ts Ah]
Dealt to 47431e8a 
Dealt to f5c9cae3 
Hero: folds
47431e8a: raises $0.07 to $0.12
f5c9cae3: folds
6c6a6600: calls $0.12
272a417f: folds
e9bbdd74: folds
*** FLOP *** [3d 3c 7s]
47431e8a: checks
6c6a6600: checks
*** TURN *** [3d 3c 7s] [5c]
47431e8a: checks
6c6a6600: bets $0.25
47431e8a: folds
Uncalled bet ($0.25) returned to 6c6a6600
*** SHOWDOWN ***
6c6a6600 collected $0.3 from pot
*** SUMMARY ***
Total pot $0.31 | Rake $0.01 | Jackpot $0 | Bingo $0 | Fortune $0 | Tax $0
Board [3d 3c 7s 5c]
Seat 1: 6c6a6600 (button) won ($0.3)
Seat 2: 272a417f (small blind) folded before Flop
Seat 3: e9bbdd74 (big blind) folded before Flop
Seat 4: Hero folded before Flop (didn't bet)
Seat 5: 47431e8a folded on the Turn
Seat 6: f5c9cae3 folded before Flop (didn't bet)


Poker Hand #RC3812372921: Hold'em No Limit ($0.02/$0.05) - 2025/08/16 23:01:27
Table 'RushAndCash1068181' 6-max Seat #1 is the button
Seat 1: d2d7795b ($1.71 in chips)
Seat 2: 198a273d ($5.07 in chips)
Seat 3: Hero ($6.71 in chips)
Seat 4: aae2e126 ($6.75 in chips)
Seat 5: 713988c4 ($5 in chips)
Seat 6: dd6b7fe5 ($5 in chips)
198a273d: posts small blind $0.02
Hero: posts big blind $0.05
*** HOLE CARDS ***
Dealt to d2d7795b 
Dealt to 198a273d 
Dealt to Hero [4s 2c]
Dealt to aae2e126 
Dealt to 713988c4 
Dealt to dd6b7fe5 
aae2e126: raises $0.1 to $0.15
713988c4: folds
dd6b7fe5: folds
d2d7795b: folds
198a273d: folds
Hero: folds
Uncalled bet ($0.1) returned to aae2e126
*** SHOWDOWN ***
aae2e126 collected $0.12 from pot
*** SUMMARY ***
Total pot $0.12 | Rake $0 | Jackpot $0 | Bingo $0 | Fortune $0 | Tax $0
Seat 1: d2d7795b (button) folded before Flop (didn't bet)
Seat 2: 198a273d (small blind) folded before Flop
Seat 3: Hero (big blind) folded before Flop
Seat 4: aae2e126 collected ($0.12)
Seat 5: 713988c4 folded before Flop (didn't bet)
Seat 6: dd6b7fe5 folded before Flop (didn't bet)


Poker Hand #RC3812372774: Hold'em No Limit ($0.02/$0.05) - 2025/08/16 23:01:06
Table 'RushAndCash1068034' 6-max Seat #1 is the button
Seat 1: 36652e67 ($8.73 in chips)
Seat 2: Hero ($6.73 in chips)
Seat 3: e8f3d79 ($8.51 in chips)
Seat 4: 5a36c01d ($9.02 in chips)
Seat 5: 686bd7b8 ($6.29 in chips)
Seat 6: 617766ca ($26.19 in chips)
Hero: posts small blind $0.02
e8f3d79: posts big blind $0.05
*** HOLE CARDS ***
Dealt to 36652e67 
Dealt to Hero [6h Qs]
Dealt to e8f3d79 
Dealt to 5a36c01d 
Dealt to 686bd7b8 
Dealt to 617766ca 
5a36c01d: raises $0.06 to $0.11
686bd7b8: folds
617766ca: raises $0.23 to $0.34
36652e67: folds
Hero: folds
e8f3d79: folds
5a36c01d: folds
Uncalled bet ($0.23) returned to 617766ca
*** SHOWDOWN ***
617766ca collected $0.28 from pot
*** SUMMARY ***
Total pot $0.29 | Rake $0.01 | Jackpot $0 | Bingo $0 | Fortune $0 | Tax $0
Seat 1: 36652e67 (button) folded before Flop (didn't bet)
Seat 2: Hero (small blind) folded before Flop
Seat 3: e8f3d79 (big blind) folded before Flop
Seat 4: 5a36c01d folded before Flop
Seat 5: 686bd7b8 folded before Flop (didn't bet)
Seat 6: 617766ca collected ($0.28)


Poker Hand #RC3812372338: Hold'em No Limit ($0.02/$0.05) - 2025/08/16 23:00:06
Table 'RushAndCash1067598' 6-max Seat #1 is the button
Seat 1: 7691efea ($6.11 in chips)
Seat 2: abe8529b ($5 in chips)
Seat 3: 5a36c01d ($8.81 in chips)
Seat 4: Hero ($6.94 in chips)
Seat 5: e7605546 ($5.37 in chips)
Seat 6: 60d16038 ($8.77 in chips)
abe8529b: posts small blind $0.02
5a36c01d: posts big blind $0.05
*** HOLE CARDS ***
Dealt to 7691efea 
Dealt to abe8529b 
Dealt to 5a36c01d 
Dealt to Hero [As Kh]
Dealt to e7605546 
Dealt to 60d16038 
Hero: raises $0.05 to $0.1
e7605546: folds
60d16038: folds
7691efea: folds
abe8529b: folds
5a36c01d: calls $0.05
*** FLOP *** [2d Jc 3d]
5a36c01d: checks
Hero: checks
*** TURN *** [2d Jc 3d] [9s]
5a36c01d: checks
Hero: bets $0.11
5a36c01d: calls $0.11
*** RIVER *** [2d Jc 3d 9s] [Js]
5a36c01d: checks
Hero: checks
5a36c01d: shows [9c 8c] (two pair, Jacks and Nines)
Hero: shows [As Kh] (a pair of Jacks)
*** SHOWDOWN ***
5a36c01d collected $0.42 from pot
*** SUMMARY ***
Total pot $0.44 | Rake $0.02 | Jackpot $0 | Bingo $0 | Fortune $0 | Tax $0
Board [2d Jc 3d 9s Js]
Seat 1: 7691efea (button) folded before Flop (didn't bet)
Seat 2: abe8529b (small blind) folded before Flop
Seat 3: 5a36c01d (big blind) showed [9c 8c] and won ($0.42) with two pair, Jacks and Nines
Seat 4: Hero showed [As Kh] and lost with a pair of Jacks
Seat 5: e7605546 folded before Flop (didn't bet)
Seat 6: 60d16038 folded before Flop (didn't bet)


Poker Hand #RC3812372308: Hold'em No Limit ($0.02/$0.05) - 2025/08/16 23:00:02
Table 'RushAndCash1067568' 6-max Seat #1 is the button
Seat 1: Hero ($6.94 in chips)
Seat 2: 1179fe80 ($5.31 in chips)
Seat 3: 4cb3ecf8 ($5.17 in chips)
Seat 4: 657ae2a ($6.53 in chips)
Seat 5: 199614a7 ($14.9 in chips)
Seat 6: e937107e ($6.54 in chips)
1179fe80: posts small blind $0.02
4cb3ecf8: posts big blind $0.05
*** HOLE CARDS ***
Dealt to Hero [2d 5s]
Dealt to 1179fe80 
Dealt to 4cb3ecf8 
Dealt to 657ae2a 
Dealt to 199614a7 
Dealt to e937107e 
657ae2a: folds
199614a7: raises $0.05 to $0.1
e937107e: folds
Hero: folds
1179fe80: folds
4cb3ecf8: calls $0.05
*** FLOP *** [4s 5h 3h]
4cb3ecf8: checks
199614a7: bets $0.17
4cb3ecf8: calls $0.17
*** TURN *** [4s 5h 3h] [Td]
4cb3ecf8: checks
199614a7: bets $0.81
4cb3ecf8: folds
Uncalled bet ($0.81) returned to 199614a7
*** SHOWDOWN ***
199614a7 collected $0.54 from pot
*** SUMMARY ***
Total pot $0.56 | Rake $0.02 | Jackpot $0 | Bingo $0 | Fortune $0 | Tax $0
Board [4s 5h 3h Td]
Seat 1: Hero (button) folded before Flop (didn't bet)
Seat 2: 1179fe80 (small blind) folded before Flop
Seat 3: 4cb3ecf8 (big blind) folded on the Turn
Seat 4: 657ae2a folded before Flop (didn't bet)
Seat 5: 199614a7 won ($0.54)
Seat 6: e937107e folded before Flop (didn't bet)


Poker Hand #RC3812372285: Hold'em No Limit ($0.02/$0.05) - 2025/08/16 22:59:58
Table 'RushAndCash1067545' 6-max Seat #1 is the button
Seat 1: 76544cdd ($5.81 in chips)
Seat 2: feb5f59b ($8.06 in chips)
Seat 3: 6c196a1f ($22.84 in chips)
Seat 4: d091c702 ($5 in chips)
Seat 5: Hero ($6.94 in chips)
Seat 6: 51ef1bde ($6 in chips)
feb5f59b: posts small blind $0.02
6c196a1f: posts big blind $0.05
*** HOLE CARDS ***
Dealt to 76544cdd 
Dealt to feb5f59b 
Dealt to 6c196a1f 
Dealt to d091c702 
Dealt to Hero [4d 8h]
Dealt to 51ef1bde 
d091c702: raises $0.08 to $0.13
Hero: folds
51ef1bde: folds
76544cdd: folds
feb5f59b: folds
6c196a1f: folds
Uncalled bet ($0.08) returned to d091c702
*** SHOWDOWN ***
d091c702 collected $0.12 from pot
*** SUMMARY ***
Total pot $0.12 | Rake $0 | Jackpot $0 | Bingo $0 | Fortune $0 | Tax $0
Seat 1: 76544cdd (button) folded before Flop (didn't bet)
Seat 2: feb5f59b (small blind) folded before Flop
Seat 3: 6c196a1f (big blind) folded before Flop
Seat 4: d091c702 collected ($0.12)
Seat 5: Hero folded before Flop (didn't bet)
Seat 6: 51ef1bde folded before Flop (didn't bet)


Poker Hand #RC3812372259: Hold'em No Limit ($0.02/$0.05) - 2025/08/16 22:59:55
Table 'RushAndCash1067519' 6-max Seat #1 is the button
Seat 1: 272a417f ($4.2 in chips)
Seat 2: 46068b1c ($7.6 in chips)
Seat 3: 215a37ea ($5.77 in chips)
Seat 4: Hero ($6.94 in chips)
Seat 5: 428bf7ae ($9.38 in chips)
Seat 6: 14de49ca ($6.68 in chips)
46068b1c: posts small blind $0.02
215a37ea: posts big blind $0.05
*** HOLE CARDS ***
Dealt to 272a417f 
Dealt to 46068b1c 
Dealt to 215a37ea 
Dealt to Hero [Kh 8c]
Dealt to 428bf7ae 
Dealt to 14de49ca 
Hero: folds
428bf7ae: folds
14de49ca: folds
272a417f: raises $0.05 to $0.1
46068b1c: folds
215a37ea: folds
Uncalled bet ($0.05) returned to 272a417f
*** SHOWDOWN ***
272a417f collected $0.12 from pot
*** SUMMARY ***
Total pot $0.12 | Rake $0 | Jackpot $0 | Bingo $0 | Fortune $0 | Tax $0
Seat 1: 272a417f (button) collected ($0.12)
Seat 2: 46068b1c (small blind) folded before Flop
Seat 3: 215a37ea (big blind) folded before Flop
Seat 4: Hero folded before Flop (didn't bet)
Seat 5: 428bf7ae folded before Flop (didn't bet)
Seat 6: 14de49ca folded before Flop (didn't bet)


Poker Hand #RC3812372216: Hold'em No Limit ($0.02/$0.05) - 2025/08/16 22:59:49
Table 'RushAndCash1067476' 6-max Seat #1 is the button
Seat 1: 428bf7ae ($9.38 in chips)
Seat 2: 23bf44f5 ($27.72 in chips)
Seat 3: e285be9a ($13.79 in chips)
Seat 4: bfe17af2 ($5.21 in chips)
Seat 5: cd335107 ($15.4 in chips)
Seat 6: Hero ($6.94 in chips)
23bf44f5: posts small blind $0.02
e285be9a: posts big blind $0.05
*** HOLE CARDS ***
Dealt to 428bf7ae 
Dealt to 23bf44f5 
Dealt to e285be9a 
Dealt to bfe17af2 
Dealt to cd335107 
Dealt to Hero [Qh Td]
bfe17af2: folds
cd335107: folds
Hero: folds
428bf7ae: folds
23bf44f5: folds
Uncalled bet ($0.03) returned to e285be9a
*** SHOWDOWN ***
e285be9a collected $0.04 from pot
*** SUMMARY ***
Total pot $0.04 | Rake $0 | Jackpot $0 | Bingo $0 | Fortune $0 | Tax $0
Seat 1: 428bf7ae (button) folded before Flop (didn't bet)
Seat 2: 23bf44f5 (small blind) folded before Flop
Seat 3: e285be9a (big blind) collected ($0.04)
Seat 4: bfe17af2 folded before Flop (didn't bet)
Seat 5: cd335107 folded before Flop (didn't bet)
Seat 6: Hero folded before Flop (didn't bet)


Poker Hand #RC3812372129: Hold'em No Limit ($0.02/$0.05) - 2025/08/16 22:59:37
Table 'RushAndCash1067389' 6-max Seat #1 is the button
Seat 1: c9717df4 ($11.88 in chips)
Seat 2: Hero ($6.96 in chips)
Seat 3: f6838f11 ($6.21 in chips)
Seat 4: 8237129d ($11.22 in chips)
Seat 5: 2b893e7f ($12.74 in chips)
Seat 6: d6b9968d ($5.16 in chips)
Hero: posts small blind $0.02
f6838f11: posts big blind $0.05
*** HOLE CARDS ***
Dealt to c9717df4 
Dealt to Hero [Ks Td]
Dealt to f6838f11 
Dealt to 8237129d 
Dealt to 2b893e7f 
Dealt to d6b9968d 
8237129d: raises $0.08 to $0.13
2b893e7f: folds
d6b9968d: folds
c9717df4: folds
Hero: folds
f6838f11: folds
Uncalled bet ($0.08) returned to 8237129d
*** SHOWDOWN ***
8237129d collected $0.12 from pot
*** SUMMARY ***
Total pot $0.12 | Rake $0 | Jackpot $0 | Bingo $0 | Fortune $0 | Tax $0
Seat 1: c9717df4 (button) folded before Flop (didn't bet)
Seat 2: Hero (small blind) folded before Flop
Seat 3: f6838f11 (big blind) folded before Flop
Seat 4: 8237129d collected ($0.12)
Seat 5: 2b893e7f folded before Flop (didn't bet)
Seat 6: d6b9968d folded before Flop (didn't bet)


Poker Hand #RC3812372030: Hold'em No Limit ($0.02/$0.05) - 2025/08/16 22:59:23
Table 'RushAndCash1067290' 6-max Seat #1 is the button
Seat 1: 8033f052 ($5.27 in chips)
Seat 2: 17d650ae ($6.19 in chips)
Seat 3: Hero ($7.01 in chips)
Seat 4: 370bf11f ($5.07 in chips)
Seat 5: 95828e0c ($5.4 in chips)
Seat 6: f60f421b ($1.66 in chips)
17d650ae: posts small blind $0.02
Hero: posts big blind $0.05
*** HOLE CARDS ***
Dealt to 8033f052 
Dealt to 17d650ae 
Dealt to Hero [5d Js]
Dealt to 370bf11f 
Dealt to 95828e0c 
Dealt to f60f421b 
370bf11f: folds
95828e0c: folds
f60f421b: folds
8033f052: raises $0.08 to $0.13
17d650ae: folds
Hero: folds
Uncalled bet ($0.08) returned to 8033f052
*** SHOWDOWN ***
8033f052 collected $0.12 from pot
*** SUMMARY ***
Total pot $0.12 | Rake $0 | Jackpot $0 | Bingo $0 | Fortune $0 | Tax $0
Seat 1: 8033f052 (button) collected ($0.12)
Seat 2: 17d650ae (small blind) folded before Flop
Seat 3: Hero (big blind) folded before Flop
Seat 4: 370bf11f folded before Flop (didn't bet)
Seat 5: 95828e0c folded before Flop (didn't bet)
Seat 6: f60f421b folded before Flop (didn't bet)


Poker Hand #RC3812372001: Hold'em No Limit ($0.02/$0.05) - 2025/08/16 22:59:19
Table 'RushAndCash1067261' 6-max Seat #1 is the button
Seat 1: 5c8e0ee9 ($27.55 in chips)
Seat 2: 981343cc ($5.52 in chips)
Seat 3: 59b21473 ($5.16 in chips)
Seat 4: Hero ($7.01 in chips)
Seat 5: 3cd91877 ($4.47 in chips)
Seat 6: b0432c89 ($5.83 in chips)
981343cc: posts small blind $0.02
59b21473: posts big blind $0.05
*** HOLE CARDS ***
Dealt to 5c8e0ee9 
Dealt to 981343cc 
Dealt to 59b21473 
Dealt to Hero [8s 2s]
Dealt to 3cd91877 
Dealt to b0432c89 
Hero: folds
3cd91877: folds
b0432c89: raises $0.08 to $0.13
5c8e0ee9: folds
981343cc: folds
59b21473: folds
Uncalled bet ($0.08) returned to b0432c89
*** SHOWDOWN ***
b0432c89 collected $0.12 from pot
*** SUMMARY ***
Total pot $0.12 | Rake $0 | Jackpot $0 | Bingo $0 | Fortune $0 | Tax $0
Seat 1: 5c8e0ee9 (button) folded before Flop (didn't bet)
Seat 2: 981343cc (small blind) folded before Flop
Seat 3: 59b21473 (big blind) folded before Flop
Seat 4: Hero folded before Flop (didn't bet)
Seat 5: 3cd91877 folded before Flop (didn't bet)
Seat 6: b0432c89 collected ($0.12)


Poker Hand #RC3812371711: Hold'em No Limit ($0.02/$0.05) - 2025/08/16 22:58:38
Table 'RushAndCash1066971' 6-max Seat #1 is the button
Seat 1: Hero ($7.33 in chips)
Seat 2: 55a8ddb9 ($5.16 in chips)
Seat 3: 981343cc ($5.16 in chips)
Seat 4: 3441b4ed ($5.48 in chips)
Seat 5: 3cd91877 ($4.52 in chips)
Seat 6: da900d7a ($5 in chips)
55a8ddb9: posts small blind $0.02
981343cc: posts big blind $0.05
*** HOLE CARDS ***
Dealt to Hero [Qs Kh]
Dealt to 55a8ddb9 
Dealt to 981343cc 
Dealt to 3441b4ed 
Dealt to 3cd91877 
Dealt to da900d7a 
3441b4ed: folds
3cd91877: calls $0.05
da900d7a: folds
Hero: raises $0.27 to $0.32
55a8ddb9: folds
981343cc: raises $0.71 to $1.03
3cd91877: folds
Hero: folds
Uncalled bet ($0.71) returned to 981343cc
*** SHOWDOWN ***
981343cc collected $0.68 from pot
*** SUMMARY ***
Total pot $0.71 | Rake $0.03 | Jackpot $0 | Bingo $0 | Fortune $0 | Tax $0
Seat 1: Hero (button) folded before Flop
Seat 2: 55a8ddb9 (small blind) folded before Flop
Seat 3: 981343cc (big blind) collected ($0.68)
Seat 4: 3441b4ed folded before Flop (didn't bet)
Seat 5: 3cd91877 folded before Flop
Seat 6: da900d7a folded before Flop (didn't bet)


Poker Hand #RC3812371610: Hold'em No Limit ($0.02/$0.05) - 2025/08/16 22:58:23
Table 'RushAndCash1066870' 6-max Seat #1 is the button
Seat 1: 438815e7 ($6.06 in chips)
Seat 2: f3461c88 ($4.68 in chips)
Seat 3: 2e10c05e ($2.57 in chips)
Seat 4: 491638ed ($4.78 in chips)
Seat 5: Hero ($7.26 in chips)
Seat 6: e8f3d79 ($9.06 in chips)
f3461c88: posts small blind $0.02
2e10c05e: posts big blind $0.05
*** HOLE CARDS ***
Dealt to 438815e7 
Dealt to f3461c88 
Dealt to 2e10c05e 
Dealt to 491638ed 
Dealt to Hero [Jc 8c]
Dealt to e8f3d79 
491638ed: folds
Hero: raises $0.05 to $0.1
e8f3d79: folds
438815e7: folds
f3461c88: folds
2e10c05e: folds
Uncalled bet ($0.05) returned to Hero
*** SHOWDOWN ***
Hero collected $0.12 from pot
*** SUMMARY ***
Total pot $0.12 | Rake $0 | Jackpot $0 | Bingo $0 | Fortune $0 | Tax $0
Seat 1: 438815e7 (button) folded before Flop (didn't bet)
Seat 2: f3461c88 (small blind) folded before Flop
Seat 3: 2e10c05e (big blind) folded before Flop
Seat 4: 491638ed folded before Flop (didn't bet)
Seat 5: Hero collected ($0.12)
Seat 6: e8f3d79 folded before Flop (didn't bet)


Poker Hand #RC3812371557: Hold'em No Limit ($0.02/$0.05) - 2025/08/16 22:58:16
Table 'RushAndCash1066817' 6-max Seat #1 is the button
Seat 1: Hero ($7.26 in chips)
Seat 2: c540fed0 ($5.11 in chips)
Seat 3: 31826f62 ($10.6 in chips)
Seat 4: 23bf44f5 ($28.58 in chips)
Seat 5: 15d2b261 ($6.46 in chips)
Seat 6: e8f3d79 ($9.11 in chips)
c540fed0: posts small blind $0.02
31826f62: posts big blind $0.05
*** HOLE CARDS ***
Dealt to Hero [Jd 5s]
Dealt to c540fed0 
Dealt to 31826f62 
Dealt to 23bf44f5 
Dealt to 15d2b261 
Dealt to e8f3d79 
23bf44f5: folds
15d2b261: folds
e8f3d79: folds
Hero: folds
c540fed0: folds
Uncalled bet ($0.03) returned to 31826f62
*** SHOWDOWN ***
31826f62 collected $0.04 from pot
*** SUMMARY ***
Total pot $0.04 | Rake $0 | Jackpot $0 | Bingo $0 | Fortune $0 | Tax $0
Seat 1: Hero (button) folded before Flop (didn't bet)
Seat 2: c540fed0 (small blind) folded before Flop
Seat 3: 31826f62 (big blind) collected ($0.04)
Seat 4: 23bf44f5 folded before Flop (didn't bet)
Seat 5: 15d2b261 folded before Flop (didn't bet)
Seat 6: e8f3d79 folded before Flop (didn't bet)


Poker Hand #RC3812371512: Hold'em No Limit ($0.02/$0.05) - 2025/08/16 22:58:10
Table 'RushAndCash1066772' 6-max Seat #1 is the button
Seat 1: a354ad0d ($5.61 in chips)
Seat 2: fc36e8f5 ($5.02 in chips)
Seat 3: 153c5bb8 ($5.29 in chips)
Seat 4: da900d7a ($5.07 in chips)
Seat 5: Hero ($7.26 in chips)
Seat 6: 1e601c85 ($2.11 in chips)
fc36e8f5: posts small blind $0.02
153c5bb8: posts big blind $0.05
*** HOLE CARDS ***
Dealt to a354ad0d 
Dealt to fc36e8f5 
Dealt to 153c5bb8 
Dealt to da900d7a 
Dealt to Hero [Ks 9s]
Dealt to 1e601c85 
da900d7a: folds
Hero: folds
1e601c85: folds
a354ad0d: raises $0.08 to $0.13
fc36e8f5: folds
153c5bb8: folds
Uncalled bet ($0.08) returned to a354ad0d
*** SHOWDOWN ***
a354ad0d collected $0.12 from pot
*** SUMMARY ***
Total pot $0.12 | Rake $0 | Jackpot $0 | Bingo $0 | Fortune $0 | Tax $0
Seat 1: a354ad0d (button) collected ($0.12)
Seat 2: fc36e8f5 (small blind) folded before Flop
Seat 3: 153c5bb8 (big blind) folded before Flop
Seat 4: da900d7a folded before Flop (didn't bet)
Seat 5: Hero folded before Flop (didn't bet)
Seat 6: 1e601c85 folded before Flop (didn't bet)


Poker Hand #RC3812371087: Hold'em No Limit ($0.02/$0.05) - 2025/08/16 22:57:11
Table 'RushAndCash1066347' 6-max Seat #1 is the button
Seat 1: d49b581 ($6.73 in chips)
Seat 2: 46855ff4 ($8.31 in chips)
Seat 3: Hero ($7.12 in chips)
Seat 4: 61515699 ($5.79 in chips)
Seat 5: a354ad0d ($5.74 in chips)
Seat 6: af6c7fdd ($5.09 in chips)
46855ff4: posts small blind $0.02
Hero: posts big blind $0.05
*** HOLE CARDS ***
Dealt to d49b581 
Dealt to 46855ff4 
Dealt to Hero [Th Kd]
Dealt to 61515699 
Dealt to a354ad0d 
Dealt to af6c7fdd 
61515699: folds
a354ad0d: raises $0.08 to $0.13
af6c7fdd: folds
d49b581: folds
46855ff4: folds
Hero: calls $0.08
*** FLOP *** [4d Jd Qh]
Hero: checks
a354ad0d: checks
*** TURN *** [4d Jd Qh] [Ts]
Hero: checks
a354ad0d: checks
*** RIVER *** [4d Jd Qh Ts] [Kh]
Hero: bets $0.08
a354ad0d: folds
Uncalled bet ($0.08) returned to Hero
*** SHOWDOWN ***
Hero collected $0.27 from pot
*** SUMMARY ***
Total pot $0.28 | Rake $0.01 | Jackpot $0 | Bingo $0 | Fortune $0 | Tax $0
Board [4d Jd Qh Ts Kh]
Seat 1: d49b581 (button) folded before Flop (didn't bet)
Seat 2: 46855ff4 (small blind) folded before Flop
Seat 3: Hero (big blind) won ($0.27)
Seat 4: 61515699 folded before Flop (didn't bet)
Seat 5: a354ad0d folded on the River
Seat 6: af6c7fdd folded before Flop (didn't bet)


Poker Hand #RC3812370808: Hold'em No Limit ($0.02/$0.05) - 2025/08/16 22:56:30
Table 'RushAndCash1066068' 6-max Seat #1 is the button
Seat 1: 9c769eb1 ($13.12 in chips)
Seat 2: Hero ($7.17 in chips)
Seat 3: af6c7fdd ($5.04 in chips)
Seat 4: 2185ef51 ($4.67 in chips)
Seat 5: fb9e8fdb ($5.95 in chips)
Seat 6: c46c7d3e ($5.26 in chips)
Hero: posts small blind $0.02
af6c7fdd: posts big blind $0.05
*** HOLE CARDS ***
Dealt to 9c769eb1 
Dealt to Hero [Jh Qc]
Dealt to af6c7fdd 
Dealt to 2185ef51 
Dealt to fb9e8fdb 
Dealt to c46c7d3e 
2185ef51: folds
fb9e8fdb: folds
c46c7d3e: folds
9c769eb1: folds
Hero: calls $0.03
af6c7fdd: raises $0.15 to $0.2
Hero: folds
Uncalled bet ($0.15) returned to af6c7fdd
*** SHOWDOWN ***
af6c7fdd collected $0.1 from pot
*** SUMMARY ***
Total pot $0.1 | Rake $0 | Jackpot $0 | Bingo $0 | Fortune $0 | Tax $0
Seat 1: 9c769eb1 (button) folded before Flop (didn't bet)
Seat 2: Hero (small blind) folded before Flop
Seat 3: af6c7fdd (big blind) collected ($0.1)
Seat 4: 2185ef51 folded before Flop (didn't bet)
Seat 5: fb9e8fdb folded before Flop (didn't bet)
Seat 6: c46c7d3e folded before Flop (didn't bet)


Poker Hand #RC3812370788: Hold'em No Limit ($0.02/$0.05) - 2025/08/16 22:56:27
Table 'RushAndCash1066048' 6-max Seat #1 is the button
Seat 1: 3583deda ($7.34 in chips)
Seat 2: 2e36f00d ($8.85 in chips)
Seat 3: 3e11087b ($3.47 in chips)
Seat 4: 2185ef51 ($4.67 in chips)
Seat 5: Hero ($7.17 in chips)
Seat 6: 9ebcede2 ($5.3 in chips)
2e36f00d: posts small blind $0.02
3e11087b: posts big blind $0.05
*** HOLE CARDS ***
Dealt to 3583deda 
Dealt to 2e36f00d 
Dealt to 3e11087b 
Dealt to 2185ef51 
Dealt to Hero [8h Js]
Dealt to 9ebcede2 
2185ef51: folds
Hero: folds
9ebcede2: folds
3583deda: raises $0.1 to $0.15
2e36f00d: folds
3e11087b: folds
Uncalled bet ($0.1) returned to 3583deda
*** SHOWDOWN ***
3583deda collected $0.12 from pot
*** SUMMARY ***
Total pot $0.12 | Rake $0 | Jackpot $0 | Bingo $0 | Fortune $0 | Tax $0
Seat 1: 3583deda (button) collected ($0.12)
Seat 2: 2e36f00d (small blind) folded before Flop
Seat 3: 3e11087b (big blind) folded before Flop
Seat 4: 2185ef51 folded before Flop (didn't bet)
Seat 5: Hero folded before Flop (didn't bet)
Seat 6: 9ebcede2 folded before Flop (didn't bet)


Poker Hand #RC3812370766: Hold'em No Limit ($0.02/$0.05) - 2025/08/16 22:56:23
Table 'RushAndCash1066026' 6-max Seat #1 is the button
Seat 1: 18484d0a ($5 in chips)
Seat 2: 8665b694 ($5.38 in chips)
Seat 3: b75bcd72 ($5.68 in chips)
Seat 4: Hero ($7.17 in chips)
Seat 5: e2097390 ($4.88 in chips)
Seat 6: 32ee1ac3 ($10.58 in chips)
8665b694: posts small blind $0.02
b75bcd72: posts big blind $0.05
*** HOLE CARDS ***
Dealt to 18484d0a 
Dealt to 8665b694 
Dealt to b75bcd72 
Dealt to Hero [4d 6h]
Dealt to e2097390 
Dealt to 32ee1ac3 
Hero: folds
e2097390: raises $0.1 to $0.15
32ee1ac3: folds
18484d0a: folds
8665b694: folds
b75bcd72: folds
Uncalled bet ($0.1) returned to e2097390
*** SHOWDOWN ***
e2097390 collected $0.12 from pot
*** SUMMARY ***
Total pot $0.12 | Rake $0 | Jackpot $0 | Bingo $0 | Fortune $0 | Tax $0
Seat 1: 18484d0a (button) folded before Flop (didn't bet)
Seat 2: 8665b694 (small blind) folded before Flop
Seat 3: b75bcd72 (big blind) folded before Flop
Seat 4: Hero folded before Flop (didn't bet)
Seat 5: e2097390 collected ($0.12)
Seat 6: 32ee1ac3 folded before Flop (didn't bet)


Poker Hand #RC3812370742: Hold'em No Limit ($0.02/$0.05) - 2025/08/16 22:56:19
Table 'RushAndCash1066002' 6-max Seat #1 is the button
Seat 1: 14de49ca ($6.22 in chips)
Seat 2: 63eb852 ($5 in chips)
Seat 3: b76cb406 ($3.11 in chips)
Seat 4: Hero ($7.17 in chips)
Seat 5: 659e76bd ($5.29 in chips)
Seat 6: e1303a7d ($26.96 in chips)
63eb852: posts small blind $0.02
b76cb406: posts big blind $0.05
*** HOLE CARDS ***
Dealt to 14de49ca 
Dealt to 63eb852 
Dealt to b76cb406 
Dealt to Hero [3c 8s]
Dealt to 659e76bd 
Dealt to e1303a7d 
Hero: folds
659e76bd: folds
e1303a7d: folds
14de49ca: raises $0.08 to $0.13
63eb852: folds
b76cb406: calls $0.08
*** FLOP *** [7h Td Jh]
b76cb406: bets $0.14
14de49ca: raises $0.26 to $0.4
b76cb406: calls $0.26
*** TURN *** [7h Td Jh] [Ah]
b76cb406: checks
14de49ca: checks
*** RIVER *** [7h Td Jh Ah] [5h]
b76cb406: checks
14de49ca: bets $0.36
b76cb406: calls $0.36
14de49ca: shows [Th Js] (a flush Ace high)
b76cb406: shows [Tc 8h] (a flush Ace high)
*** SHOWDOWN ***
14de49ca collected $1.65 from pot
*** SUMMARY ***
Total pot $1.8 | Rake $0.08 | Jackpot $0.07 | Bingo $0 | Fortune $0 | Tax $0
Board [7h Td Jh Ah 5h]
Seat 1: 14de49ca (button) showed [Th Js] and won ($1.65) with a flush Ace high
Seat 2: 63eb852 (small blind) folded before Flop
Seat 3: b76cb406 (big blind) showed [Tc 8h] and lost with a flush Ace high
Seat 4: Hero folded before Flop (didn't bet)
Seat 5: 659e76bd folded before Flop (didn't bet)
Seat 6: e1303a7d folded before Flop (didn't bet)


Poker Hand #RC3812370415: Hold'em No Limit ($0.02/$0.05) - 2025/08/16 22:55:33
Table 'RushAndCash1065675' 6-max Seat #1 is the button
Seat 1: ba885c24 ($5.09 in chips)
Seat 2: 281a8acb ($2.82 in chips)
Seat 3: Hero ($7.3 in chips)
Seat 4: 153c5bb8 ($5 in chips)
Seat 5: 14de49ca ($6.35 in chips)
Seat 6: 659e76bd ($5.03 in chips)
281a8acb: posts small blind $0.02
Hero: posts big blind $0.05
*** HOLE CARDS ***
Dealt to ba885c24 
Dealt to 281a8acb 
Dealt to Hero [6h 2h]
Dealt to 153c5bb8 
Dealt to 14de49ca 
Dealt to 659e76bd 
153c5bb8: folds
14de49ca: raises $0.08 to $0.13
659e76bd: calls $0.13
ba885c24: folds
281a8acb: folds
Hero: calls $0.08
*** FLOP *** [Qc Qs 5c]
Hero: checks
14de49ca: checks
659e76bd: bets $0.14
Hero: folds
14de49ca: folds
Uncalled bet ($0.14) returned to 659e76bd
*** SHOWDOWN ***
659e76bd collected $0.39 from pot
*** SUMMARY ***
Total pot $0.41 | Rake $0.02 | Jackpot $0 | Bingo $0 | Fortune $0 | Tax $0
Board [Qc Qs 5c]
Seat 1: ba885c24 (button) folded before Flop (didn't bet)
Seat 2: 281a8acb (small blind) folded before Flop
Seat 3: Hero (big blind) folded on the Flop
Seat 4: 153c5bb8 folded before Flop (didn't bet)
Seat 5: 14de49ca folded on the Flop
Seat 6: 659e76bd won ($0.39)


Poker Hand #RC3812370307: Hold'em No Limit ($0.02/$0.05) - 2025/08/16 22:55:18
Table 'RushAndCash1065567' 6-max Seat #1 is the button
Seat 1: dccb32d0 ($11.22 in chips)
Seat 2: Hero ($7.32 in chips)
Seat 3: 7092f48b ($5.16 in chips)
Seat 4: 683193fd ($5.3 in chips)
Seat 5: c9696527 ($5.07 in chips)
Seat 6: c9717df4 ($11.76 in chips)
Hero: posts small blind $0.02
7092f48b: posts big blind $0.05
*** HOLE CARDS ***
Dealt to dccb32d0 
Dealt to Hero [4h As]
Dealt to 7092f48b 
Dealt to 683193fd 
Dealt to c9696527 
Dealt to c9717df4 
683193fd: folds
c9696527: folds
c9717df4: folds
dccb32d0: raises $0.05 to $0.1
Hero: folds
7092f48b: folds
Uncalled bet ($0.05) returned to dccb32d0
*** SHOWDOWN ***
dccb32d0 collected $0.12 from pot
*** SUMMARY ***
Total pot $0.12 | Rake $0 | Jackpot $0 | Bingo $0 | Fortune $0 | Tax $0
Seat 1: dccb32d0 (button) collected ($0.12)
Seat 2: Hero (small blind) folded before Flop
Seat 3: 7092f48b (big blind) folded before Flop
Seat 4: 683193fd folded before Flop (didn't bet)
Seat 5: c9696527 folded before Flop (didn't bet)
Seat 6: c9717df4 folded before Flop (didn't bet)


Poker Hand #RC3812370270: Hold'em No Limit ($0.02/$0.05) - 2025/08/16 22:55:13
Table 'RushAndCash1065530' 6-max Seat #1 is the button
Seat 1: Hero ($7.32 in chips)
Seat 2: af6c7fdd ($6.01 in chips)
Seat 3: 5917f0c8 ($5.25 in chips)
Seat 4: 7a25f030 ($3.07 in chips)
Seat 5: 37ae15a4 ($11.57 in chips)
Seat 6: 24d280ec ($5.23 in chips)
af6c7fdd: posts small blind $0.02
5917f0c8: posts big blind $0.05
*** HOLE CARDS ***
Dealt to Hero [7s Qd]
Dealt to af6c7fdd 
Dealt to 5917f0c8 
Dealt to 7a25f030 
Dealt to 37ae15a4 
Dealt to 24d280ec 
7a25f030: raises $0.1 to $0.15
37ae15a4: folds
24d280ec: folds
Hero: folds
af6c7fdd: calls $0.13
5917f0c8: folds
*** FLOP *** [2c Qc 9s]
af6c7fdd: checks
7a25f030: bets $0.14
af6c7fdd: calls $0.14
*** TURN *** [2c Qc 9s] [2h]
af6c7fdd: checks
7a25f030: bets $0.51
af6c7fdd: folds
Uncalled bet ($0.51) returned to 7a25f030
*** SHOWDOWN ***
7a25f030 collected $0.6 from pot
*** SUMMARY ***
Total pot $0.63 | Rake $0.03 | Jackpot $0 | Bingo $0 | Fortune $0 | Tax $0
Board [2c Qc 9s 2h]
Seat 1: Hero (button) folded before Flop (didn't bet)
Seat 2: af6c7fdd (small blind) folded on the Turn
Seat 3: 5917f0c8 (big blind) folded before Flop
Seat 4: 7a25f030 won ($0.6)
Seat 5: 37ae15a4 folded before Flop (didn't bet)
Seat 6: 24d280ec folded before Flop (didn't bet)


Poker Hand #RC3812370240: Hold'em No Limit ($0.02/$0.05) - 2025/08/16 22:55:10
Table 'RushAndCash1065500' 6-max Seat #1 is the button
Seat 1: af6c7fdd ($6.01 in chips)
Seat 2: 8a793499 ($7.6 in chips)
Seat 3: 856daff0 ($6.27 in chips)
Seat 4: Hero ($7.32 in chips)
Seat 5: 1e601c85 ($2.32 in chips)
Seat 6: d77bfcba ($6.37 in chips)
8a793499: posts small blind $0.02
856daff0: posts big blind $0.05
*** HOLE CARDS ***
Dealt to af6c7fdd 
Dealt to 8a793499 
Dealt to 856daff0 
Dealt to Hero [8h 6d]
Dealt to 1e601c85 
Dealt to d77bfcba 
Hero: folds
1e601c85: folds
d77bfcba: folds
af6c7fdd: folds
8a793499: folds
Uncalled bet ($0.03) returned to 856daff0
*** SHOWDOWN ***
856daff0 collected $0.04 from pot
*** SUMMARY ***
Total pot $0.04 | Rake $0 | Jackpot $0 | Bingo $0 | Fortune $0 | Tax $0
Seat 1: af6c7fdd (button) folded before Flop (didn't bet)
Seat 2: 8a793499 (small blind) folded before Flop
Seat 3: 856daff0 (big blind) collected ($0.04)
Seat 4: Hero folded before Flop (didn't bet)
Seat 5: 1e601c85 folded before Flop (didn't bet)
Seat 6: d77bfcba folded before Flop (didn't bet)


Poker Hand #RC3812370213: Hold'em No Limit ($0.02/$0.05) - 2025/08/16 22:55:07
Table 'RushAndCash1065473' 6-max Seat #1 is the button
Seat 1: 603f89e1 ($5.2 in chips)
Seat 2: 7ce12b39 ($4.78 in chips)
Seat 3: 7393bc1b ($5.17 in chips)
Seat 4: 6ce0e31c ($9.67 in chips)
Seat 5: 356b7f15 ($5.16 in chips)
Seat 6: Hero ($7.32 in chips)
7ce12b39: posts small blind $0.02
7393bc1b: posts big blind $0.05
*** HOLE CARDS ***
Dealt to 603f89e1 
Dealt to 7ce12b39 
Dealt to 7393bc1b 
Dealt to 6ce0e31c 
Dealt to 356b7f15 
Dealt to Hero [7s 4c]
6ce0e31c: folds
356b7f15: folds
Hero: folds
603f89e1: raises $0.06 to $0.11
7ce12b39: calls $0.09
7393bc1b: folds
*** FLOP *** [6d Js 9d]
7ce12b39: checks
603f89e1: bets $0.09
7ce12b39: calls $0.09
*** TURN *** [6d Js 9d] [5d]
7ce12b39: checks
603f89e1: checks
*** RIVER *** [6d Js 9d 5d] [9s]
7ce12b39: checks
603f89e1: checks
7ce12b39: shows [8h 8c] (two pair, Nines and Eights)
603f89e1: shows [Ac 3c] (a pair of Nines)
*** SHOWDOWN ***
7ce12b39 collected $0.43 from pot
*** SUMMARY ***
Total pot $0.45 | Rake $0.02 | Jackpot $0 | Bingo $0 | Fortune $0 | Tax $0
Board [6d Js 9d 5d 9s]
Seat 1: 603f89e1 (button) showed [Ac 3c] and lost with a pair of Nines
Seat 2: 7ce12b39 (small blind) showed [8h 8c] and won ($0.43) with two pair, Nines and Eights
Seat 3: 7393bc1b (big blind) folded before Flop
Seat 4: 6ce0e31c folded before Flop (didn't bet)
Seat 5: 356b7f15 folded before Flop (didn't bet)
Seat 6: Hero folded before Flop (didn't bet)


Poker Hand #RC3812370183: Hold'em No Limit ($0.02/$0.05) - 2025/08/16 22:55:03
Table 'RushAndCash1065443' 6-max Seat #1 is the button
Seat 1: 43fb7813 ($5.44 in chips)
Seat 2: cd335107 ($14.18 in chips)
Seat 3: c1a9eea7 ($5.53 in chips)
Seat 4: Hero ($7.32 in chips)
Seat 5: 6ce0e31c ($9.67 in chips)
Seat 6: 356b7f15 ($5.16 in chips)
cd335107: posts small blind $0.02
c1a9eea7: posts big blind $0.05
*** HOLE CARDS ***
Dealt to 43fb7813 
Dealt to cd335107 
Dealt to c1a9eea7 
Dealt to Hero [7h Ad]
Dealt to 6ce0e31c 
Dealt to 356b7f15 
Hero: folds
6ce0e31c: folds
356b7f15: folds
43fb7813: folds
cd335107: folds
Uncalled bet ($0.03) returned to c1a9eea7
*** SHOWDOWN ***
c1a9eea7 collected $0.04 from pot
*** SUMMARY ***
Total pot $0.04 | Rake $0 | Jackpot $0 | Bingo $0 | Fortune $0 | Tax $0
Seat 1: 43fb7813 (button) folded before Flop (didn't bet)
Seat 2: cd335107 (small blind) folded before Flop
Seat 3: c1a9eea7 (big blind) collected ($0.04)
Seat 4: Hero folded before Flop (didn't bet)
Seat 5: 6ce0e31c folded before Flop (didn't bet)
Seat 6: 356b7f15 folded before Flop (didn't bet)


Poker Hand #RC3812369787: Hold'em No Limit ($0.02/$0.05) - 2025/08/16 22:54:11
Table 'RushAndCash1065047' 6-max Seat #1 is the button
Seat 1: 71be7765 ($8.75 in chips)
Seat 2: 356b7f15 ($5 in chips)
Seat 3: Hero ($7.42 in chips)
Seat 4: bb84a78f ($10.4 in chips)
Seat 5: 32856fe4 ($0.83 in chips)
Seat 6: 42ef9b6b ($5.33 in chips)
356b7f15: posts small blind $0.02
Hero: posts big blind $0.05
*** HOLE CARDS ***
Dealt to 71be7765 
Dealt to 356b7f15 
Dealt to Hero [9s 8s]
Dealt to bb84a78f 
Dealt to 32856fe4 
Dealt to 42ef9b6b 
bb84a78f: folds
32856fe4: folds
42ef9b6b: folds
71be7765: folds
356b7f15: calls $0.03
Hero: checks
*** FLOP *** [2c Jc Qs]
356b7f15: bets $0.05
Hero: calls $0.05
*** TURN *** [2c Jc Qs] [7d]
356b7f15: bets $0.05
Hero: folds
Uncalled bet ($0.05) returned to 356b7f15
*** SHOWDOWN ***
356b7f15 collected $0.19 from pot
*** SUMMARY ***
Total pot $0.2 | Rake $0.01 | Jackpot $0 | Bingo $0 | Fortune $0 | Tax $0
Board [2c Jc Qs 7d]
Seat 1: 71be7765 (button) folded before Flop (didn't bet)
Seat 2: 356b7f15 (small blind) won ($0.19)
Seat 3: Hero (big blind) folded on the Turn
Seat 4: bb84a78f folded before Flop (didn't bet)
Seat 5: 32856fe4 folded before Flop (didn't bet)
Seat 6: 42ef9b6b folded before Flop (didn't bet)


Poker Hand #RC3812369380: Hold'em No Limit ($0.02/$0.05) - 2025/08/16 22:53:18
Table 'RushAndCash1064640' 6-max Seat #1 is the button
Seat 1: Hero ($6.88 in chips)
Seat 2: abe8529b ($6.79 in chips)
Seat 3: dec4e165 ($6.34 in chips)
Seat 4: dd2211d8 ($5.28 in chips)
Seat 5: 215a37ea ($6 in chips)
Seat 6: 42ef9b6b ($5.85 in chips)
abe8529b: posts small blind $0.02
dec4e165: posts big blind $0.05
*** HOLE CARDS ***
Dealt to Hero [8h 8c]
Dealt to abe8529b 
Dealt to dec4e165 
Dealt to dd2211d8 
Dealt to 215a37ea 
Dealt to 42ef9b6b 
dd2211d8: folds
215a37ea: folds
42ef9b6b: raises $0.1 to $0.15
Hero: raises $0.37 to $0.52
abe8529b: folds
dec4e165: folds
42ef9b6b: calls $0.37
*** FLOP *** [2d Js Qh]
42ef9b6b: checks
Hero: checks
*** TURN *** [2d Js Qh] [Qc]
42ef9b6b: checks
Hero: bets $0.05
42ef9b6b: folds
Uncalled bet ($0.05) returned to Hero
*** SHOWDOWN ***
Hero collected $1.06 from pot
*** SUMMARY ***
Total pot $1.11 | Rake $0.05 | Jackpot $0 | Bingo $0 | Fortune $0 | Tax $0
Board [2d Js Qh Qc]
Seat 1: Hero (button) won ($1.06)
Seat 2: abe8529b (small blind) folded before Flop
Seat 3: dec4e165 (big blind) folded before Flop
Seat 4: dd2211d8 folded before Flop (didn't bet)
Seat 5: 215a37ea folded before Flop (didn't bet)
Seat 6: 42ef9b6b folded on the Turn


Poker Hand #RC3812369243: Hold'em No Limit ($0.02/$0.05) - 2025/08/16 22:53:01
Table 'RushAndCash1064503' 6-max Seat #1 is the button
Seat 1: 761d22e0 ($4.93 in chips)
Seat 2: Hero ($6.9 in chips)
Seat 3: d6b9968d ($5 in chips)
Seat 4: 86e97b9e ($6.38 in chips)
Seat 5: 683193fd ($5.06 in chips)
Seat 6: ab208b11 ($6.02 in chips)
Hero: posts small blind $0.02
d6b9968d: posts big blind $0.05
*** HOLE CARDS ***
Dealt to 761d22e0 
Dealt to Hero [4d 3d]
Dealt to d6b9968d 
Dealt to 86e97b9e 
Dealt to 683193fd 
Dealt to ab208b11 
86e97b9e: folds
683193fd: folds
ab208b11: folds
761d22e0: raises $0.05 to $0.1
Hero: folds
d6b9968d: folds
Uncalled bet ($0.05) returned to 761d22e0
*** SHOWDOWN ***
761d22e0 collected $0.12 from pot
*** SUMMARY ***
Total pot $0.12 | Rake $0 | Jackpot $0 | Bingo $0 | Fortune $0 | Tax $0
Seat 1: 761d22e0 (button) collected ($0.12)
Seat 2: Hero (small blind) folded before Flop
Seat 3: d6b9968d (big blind) folded before Flop
Seat 4: 86e97b9e folded before Flop (didn't bet)
Seat 5: 683193fd folded before Flop (didn't bet)
Seat 6: ab208b11 folded before Flop (didn't bet)


Poker Hand #RC3812369214: Hold'em No Limit ($0.02/$0.05) - 2025/08/16 22:52:58
Table 'RushAndCash1064474' 6-max Seat #1 is the button
Seat 1: 972ad98c ($3.52 in chips)
Seat 2: 5b9fdf0d ($3.14 in chips)
Seat 3: fbae7f64 ($22.74 in chips)
Seat 4: ee2ff185 ($5 in chips)
Seat 5: Hero ($6.9 in chips)
Seat 6: a23a7275 ($11.43 in chips)
5b9fdf0d: posts small blind $0.02
fbae7f64: posts big blind $0.05
*** HOLE CARDS ***
Dealt to 972ad98c 
Dealt to 5b9fdf0d 
Dealt to fbae7f64 
Dealt to ee2ff185 
Dealt to Hero [3s 2s]
Dealt to a23a7275 
ee2ff185: folds
Hero: folds
a23a7275: raises $0.06 to $0.11
972ad98c: folds
5b9fdf0d: raises $0.21 to $0.32
fbae7f64: folds
a23a7275: calls $0.21
*** FLOP *** [7d 8h 3h]
5b9fdf0d: bets $0.23
a23a7275: folds
Uncalled bet ($0.23) returned to 5b9fdf0d
*** SHOWDOWN ***
5b9fdf0d collected $0.66 from pot
*** SUMMARY ***
Total pot $0.69 | Rake $0.03 | Jackpot $0 | Bingo $0 | Fortune $0 | Tax $0
Board [7d 8h 3h]
Seat 1: 972ad98c (button) folded before Flop (didn't bet)
Seat 2: 5b9fdf0d (small blind) won ($0.66)
Seat 3: fbae7f64 (big blind) folded before Flop
Seat 4: ee2ff185 folded before Flop (didn't bet)
Seat 5: Hero folded before Flop (didn't bet)
Seat 6: a23a7275 folded on the Flop


Poker Hand #RC3812369189: Hold'em No Limit ($0.02/$0.05) - 2025/08/16 22:52:54
Table 'RushAndCash1064449' 6-max Seat #1 is the button
Seat 1: f7cd282c ($5.44 in chips)
Seat 2: 356b7f15 ($5.02 in chips)
Seat 3: 348f2571 ($5.16 in chips)
Seat 4: Hero ($6.9 in chips)
Seat 5: 2626bad4 ($5.12 in chips)
Seat 6: 73547c73 ($4.48 in chips)
356b7f15: posts small blind $0.02
348f2571: posts big blind $0.05
*** HOLE CARDS ***
Dealt to f7cd282c 
Dealt to 356b7f15 
Dealt to 348f2571 
Dealt to Hero [4d 8c]
Dealt to 2626bad4 
Dealt to 73547c73 
Hero: folds
2626bad4: folds
73547c73: folds
f7cd282c: raises $0.07 to $0.12
356b7f15: folds
348f2571: raises $0.33 to $0.45
f7cd282c: folds
Uncalled bet ($0.33) returned to 348f2571
*** SHOWDOWN ***
348f2571 collected $0.25 from pot
*** SUMMARY ***
Total pot $0.26 | Rake $0.01 | Jackpot $0 | Bingo $0 | Fortune $0 | Tax $0
Seat 1: f7cd282c (button) folded before Flop
Seat 2: 356b7f15 (small blind) folded before Flop
Seat 3: 348f2571 (big blind) collected ($0.25)
Seat 4: Hero folded before Flop (didn't bet)
Seat 5: 2626bad4 folded before Flop (didn't bet)
Seat 6: 73547c73 folded before Flop (didn't bet)


Poker Hand #RC3812369161: Hold'em No Limit ($0.02/$0.05) - 2025/08/16 22:52:51
Table 'RushAndCash1064421' 6-max Seat #1 is the button
Seat 1: 33f3a84f ($11.19 in chips)
Seat 2: 356b7f15 ($5.04 in chips)
Seat 3: 4a3e59cc ($5.25 in chips)
Seat 4: Hero ($6.9 in chips)
Seat 5: a354ad0d ($5.23 in chips)
Seat 6: da13d992 ($19.58 in chips)
356b7f15: posts small blind $0.02
4a3e59cc: posts big blind $0.05
*** HOLE CARDS ***
Dealt to 33f3a84f 
Dealt to 356b7f15 
Dealt to 4a3e59cc 
Dealt to Hero [8d Ac]
Dealt to a354ad0d 
Dealt to da13d992 
Hero: folds
a354ad0d: folds
da13d992: folds
33f3a84f: raises $0.05 to $0.1
356b7f15: folds
4a3e59cc: calls $0.05
*** FLOP *** [Tc Ah 9s]
4a3e59cc: bets $0.13
33f3a84f: folds
Uncalled bet ($0.13) returned to 4a3e59cc
*** SHOWDOWN ***
4a3e59cc collected $0.21 from pot
*** SUMMARY ***
Total pot $0.22 | Rake $0.01 | Jackpot $0 | Bingo $0 | Fortune $0 | Tax $0
Board [Tc Ah 9s]
Seat 1: 33f3a84f (button) folded on the Flop
Seat 2: 356b7f15 (small blind) folded before Flop
Seat 3: 4a3e59cc (big blind) won ($0.21)
Seat 4: Hero folded before Flop (didn't bet)
Seat 5: a354ad0d folded before Flop (didn't bet)
Seat 6: da13d992 folded before Flop (didn't bet)


Poker Hand #RC3812369090: Hold'em No Limit ($0.02/$0.05) - 2025/08/16 22:52:41
Table 'RushAndCash1064350' 6-max Seat #1 is the button
Seat 1: 45e92a55 ($6.24 in chips)
Seat 2: ef14735a ($5.09 in chips)
Seat 3: Hero ($6.88 in chips)
Seat 4: a3f81842 ($6.63 in chips)
Seat 5: 7f8b168e ($4.38 in chips)
Seat 6: a94954ef ($9.22 in chips)
ef14735a: posts small blind $0.02
Hero: posts big blind $0.05
*** HOLE CARDS ***
Dealt to 45e92a55 
Dealt to ef14735a 
Dealt to Hero [Jh Kd]
Dealt to a3f81842 
Dealt to 7f8b168e 
Dealt to a94954ef 
a3f81842: folds
7f8b168e: folds
a94954ef: folds
45e92a55: folds
ef14735a: folds
Uncalled bet ($0.03) returned to Hero
*** SHOWDOWN ***
Hero collected $0.04 from pot
*** SUMMARY ***
Total pot $0.04 | Rake $0 | Jackpot $0 | Bingo $0 | Fortune $0 | Tax $0
Seat 1: 45e92a55 (button) folded before Flop (didn't bet)
Seat 2: ef14735a (small blind) folded before Flop
Seat 3: Hero (big blind) collected ($0.04)
Seat 4: a3f81842 folded before Flop (didn't bet)
Seat 5: 7f8b168e folded before Flop (didn't bet)
Seat 6: a94954ef folded before Flop (didn't bet)


Poker Hand #RC3812368830: Hold'em No Limit ($0.02/$0.05) - 2025/08/16 22:52:09
Table 'RushAndCash1064090' 6-max Seat #1 is the button
Seat 1: bc8d0f53 ($9.89 in chips)
Seat 2: Hero ($6.98 in chips)
Seat 3: ef14735a ($5 in chips)
Seat 4: c9696527 ($5.33 in chips)
Seat 5: 22631fec ($4.32 in chips)
Seat 6: 6c3973b1 ($6.12 in chips)
Hero: posts small blind $0.02
ef14735a: posts big blind $0.05
*** HOLE CARDS ***
Dealt to bc8d0f53 
Dealt to Hero [5c 8s]
Dealt to ef14735a 
Dealt to c9696527 
Dealt to 22631fec 
Dealt to 6c3973b1 
c9696527: folds
22631fec: folds
6c3973b1: folds
bc8d0f53: folds
Hero: raises $0.05 to $0.1
ef14735a: raises $0.2 to $0.3
Hero: folds
Uncalled bet ($0.2) returned to ef14735a
*** SHOWDOWN ***
ef14735a collected $0.19 from pot
*** SUMMARY ***
Total pot $0.2 | Rake $0.01 | Jackpot $0 | Bingo $0 | Fortune $0 | Tax $0
Seat 1: bc8d0f53 (button) folded before Flop (didn't bet)
Seat 2: Hero (small blind) folded before Flop
Seat 3: ef14735a (big blind) collected ($0.19)
Seat 4: c9696527 folded before Flop (didn't bet)
Seat 5: 22631fec folded before Flop (didn't bet)
Seat 6: 6c3973b1 folded before Flop (didn't bet)


Poker Hand #RC3812368804: Hold'em No Limit ($0.02/$0.05) - 2025/08/16 22:52:05
Table 'RushAndCash1064064' 6-max Seat #1 is the button
Seat 1: 153c5bb8 ($5.44 in chips)
Seat 2: 3fd3624c ($5 in chips)
Seat 3: 9928c113 ($15.24 in chips)
Seat 4: Hero ($6.98 in chips)
Seat 5: cd335107 ($14.78 in chips)
Seat 6: 721c9358 ($5 in chips)
3fd3624c: posts small blind $0.02
9928c113: posts big blind $0.05
*** HOLE CARDS ***
Dealt to 153c5bb8 
Dealt to 3fd3624c 
Dealt to 9928c113 
Dealt to Hero [6h Kc]
Dealt to cd335107 
Dealt to 721c9358 
Hero: folds
cd335107: raises $0.05 to $0.1
721c9358: folds
153c5bb8: folds
3fd3624c: folds
9928c113: calls $0.05
*** FLOP *** [Jh 5d 2h]
9928c113: checks
cd335107: bets $0.11
9928c113: calls $0.11
*** TURN *** [Jh 5d 2h] [Kh]
9928c113: checks
cd335107: checks
*** RIVER *** [Jh 5d 2h Kh] [Tc]
9928c113: checks
cd335107: checks
9928c113: shows [Ac 2c] (a pair of Twos)
cd335107: shows [8c Jc] (a pair of Jacks)
*** SHOWDOWN ***
cd335107 collected $0.42 from pot
*** SUMMARY ***
Total pot $0.44 | Rake $0.02 | Jackpot $0 | Bingo $0 | Fortune $0 | Tax $0
Board [Jh 5d 2h Kh Tc]
Seat 1: 153c5bb8 (button) folded before Flop (didn't bet)
Seat 2: 3fd3624c (small blind) folded before Flop
Seat 3: 9928c113 (big blind) showed [Ac 2c] and lost with a pair of Twos
Seat 4: Hero folded before Flop (didn't bet)
Seat 5: cd335107 showed [8c Jc] and won ($0.42) with a pair of Jacks
Seat 6: 721c9358 folded before Flop (didn't bet)


Poker Hand #RC3812368327: Hold'em No Limit ($0.02/$0.05) - 2025/08/16 22:50:56
Table 'RushAndCash1063587' 6-max Seat #1 is the button
Seat 1: Hero ($7.13 in chips)
Seat 2: 35a3a69f ($11.96 in chips)
Seat 3: cd335107 ($15.09 in chips)
Seat 4: 153c5bb8 ($5 in chips)
Seat 5: 20af24a9 ($5.19 in chips)
Seat 6: bd225855 ($4.09 in chips)
35a3a69f: posts small blind $0.02
cd335107: posts big blind $0.05
*** HOLE CARDS ***
Dealt to Hero [Ts Kh]
Dealt to 35a3a69f 
Dealt to cd335107 
Dealt to 153c5bb8 
Dealt to 20af24a9 
Dealt to bd225855 
153c5bb8: raises $0.1 to $0.15
20af24a9: folds
bd225855: folds
Hero: calls $0.15
35a3a69f: folds
cd335107: calls $0.1
*** FLOP *** [Ad 7s 3s]
cd335107: checks
153c5bb8: bets $0.16
Hero: folds
cd335107: calls $0.16
*** TURN *** [Ad 7s 3s] [8c]
cd335107: checks
153c5bb8: bets $0.6
cd335107: folds
Uncalled bet ($0.6) returned to 153c5bb8
*** SHOWDOWN ***
153c5bb8 collected $0.75 from pot
*** SUMMARY ***
Total pot $0.79 | Rake $0.04 | Jackpot $0 | Bingo $0 | Fortune $0 | Tax $0
Board [Ad 7s 3s 8c]
Seat 1: Hero (button) folded on the Flop
Seat 2: 35a3a69f (small blind) folded before Flop
Seat 3: cd335107 (big blind) folded on the Turn
Seat 4: 153c5bb8 won ($0.75)
Seat 5: 20af24a9 folded before Flop (didn't bet)
Seat 6: bd225855 folded before Flop (didn't bet)


Poker Hand #RC3812368299: Hold'em No Limit ($0.02/$0.05) - 2025/08/16 22:50:53
Table 'RushAndCash1063559' 6-max Seat #1 is the button
Seat 1: fb9e8fdb ($5.25 in chips)
Seat 2: 7c8547fc ($20.67 in chips)
Seat 3: bc8d0f53 ($10.11 in chips)
Seat 4: 46068b1c ($5 in chips)
Seat 5: Hero ($7.13 in chips)
Seat 6: 8abadc69 ($2.74 in chips)
7c8547fc: posts small blind $0.02
bc8d0f53: posts big blind $0.05
*** HOLE CARDS ***
Dealt to fb9e8fdb 
Dealt to 7c8547fc 
Dealt to bc8d0f53 
Dealt to 46068b1c 
Dealt to Hero [As 9c]
Dealt to 8abadc69 
46068b1c: folds
Hero: folds
8abadc69: folds
fb9e8fdb: folds
7c8547fc: raises $0.1 to $0.15
bc8d0f53: folds
Uncalled bet ($0.1) returned to 7c8547fc
*** SHOWDOWN ***
7c8547fc collected $0.1 from pot
*** SUMMARY ***
Total pot $0.1 | Rake $0 | Jackpot $0 | Bingo $0 | Fortune $0 | Tax $0
Seat 1: fb9e8fdb (button) folded before Flop (didn't bet)
Seat 2: 7c8547fc (small blind) collected ($0.1)
Seat 3: bc8d0f53 (big blind) folded before Flop
Seat 4: 46068b1c folded before Flop (didn't bet)
Seat 5: Hero folded before Flop (didn't bet)
Seat 6: 8abadc69 folded before Flop (didn't bet)


Poker Hand #RC3812368102: Hold'em No Limit ($0.02/$0.05) - 2025/08/16 22:50:26
Table 'RushAndCash1063362' 6-max Seat #1 is the button
Seat 1: Hero ($7.13 in chips)
Seat 2: b9c219d6 ($5.48 in chips)
Seat 3: b9a67513 ($6.31 in chips)
Seat 4: 3dabf495 ($7.01 in chips)
Seat 5: 8cfdd388 ($4.53 in chips)
Seat 6: 2b893e7f ($12.79 in chips)
b9c219d6: posts small blind $0.02
b9a67513: posts big blind $0.05
*** HOLE CARDS ***
Dealt to Hero [Th Js]
Dealt to b9c219d6 
Dealt to b9a67513 
Dealt to 3dabf495 
Dealt to 8cfdd388 
Dealt to 2b893e7f 
3dabf495: folds
8cfdd388: folds
2b893e7f: raises $0.05 to $0.1
Hero: folds
b9c219d6: folds
b9a67513: folds
Uncalled bet ($0.05) returned to 2b893e7f
*** SHOWDOWN ***
2b893e7f collected $0.12 from pot
*** SUMMARY ***
Total pot $0.12 | Rake $0 | Jackpot $0 | Bingo $0 | Fortune $0 | Tax $0
Seat 1: Hero (button) folded before Flop (didn't bet)
Seat 2: b9c219d6 (small blind) folded before Flop
Seat 3: b9a67513 (big blind) folded before Flop
Seat 4: 3dabf495 folded before Flop (didn't bet)
Seat 5: 8cfdd388 folded before Flop (didn't bet)
Seat 6: 2b893e7f collected ($0.12)


Poker Hand #RC3812368057: Hold'em No Limit ($0.02/$0.05) - 2025/08/16 22:50:20
Table 'RushAndCash1063317' 6-max Seat #1 is the button
Seat 1: 5bbfa748 ($5.92 in chips)
Seat 2: Hero ($7.15 in chips)
Seat 3: 2c704e54 ($9.97 in chips)
Seat 4: 9ebcede2 ($5 in chips)
Seat 5: 3dc9b1ad ($13.58 in chips)
Seat 6: 40a92532 ($7.2 in chips)
Hero: posts small blind $0.02
2c704e54: posts big blind $0.05
*** HOLE CARDS ***
Dealt to 5bbfa748 
Dealt to Hero [Th 5c]
Dealt to 2c704e54 
Dealt to 9ebcede2 
Dealt to 3dc9b1ad 
Dealt to 40a92532 
9ebcede2: raises $0.07 to $0.12
3dc9b1ad: folds
40a92532: folds
5bbfa748: calls $0.12
Hero: folds
2c704e54: folds
*** FLOP *** [9s Ks 2d]
9ebcede2: bets $0.12
5bbfa748: calls $0.12
*** TURN *** [9s Ks 2d] [5s]
9ebcede2: checks
5bbfa748: checks
*** RIVER *** [9s Ks 2d 5s] [7s]
9ebcede2: bets $0.2
5bbfa748: folds
Uncalled bet ($0.2) returned to 9ebcede2
*** SHOWDOWN ***
9ebcede2 collected $0.53 from pot
*** SUMMARY ***
Total pot $0.55 | Rake $0.02 | Jackpot $0 | Bingo $0 | Fortune $0 | Tax $0
Board [9s Ks 2d 5s 7s]
Seat 1: 5bbfa748 (button) folded on the River
Seat 2: Hero (small blind) folded before Flop
Seat 3: 2c704e54 (big blind) folded before Flop
Seat 4: 9ebcede2 won ($0.53)
Seat 5: 3dc9b1ad folded before Flop (didn't bet)
Seat 6: 40a92532 folded before Flop (didn't bet)


Poker Hand #RC3812367999: Hold'em No Limit ($0.02/$0.05) - 2025/08/16 22:50:11
Table 'RushAndCash1063259' 6-max Seat #1 is the button
Seat 1: fdbdecff ($5 in chips)
Seat 2: d1b03e51 ($6.41 in chips)
Seat 3: Hero ($7.13 in chips)
Seat 4: 4c91f7e2 ($5.85 in chips)
Seat 5: e7605546 ($4.82 in chips)
Seat 6: 7b205a6f ($4.85 in chips)
d1b03e51: posts small blind $0.02
Hero: posts big blind $0.05
*** HOLE CARDS ***
Dealt to fdbdecff 
Dealt to d1b03e51 
Dealt to Hero [9d Jh]
Dealt to 4c91f7e2 
Dealt to e7605546 
Dealt to 7b205a6f 
4c91f7e2: folds
e7605546: folds
7b205a6f: folds
fdbdecff: folds
d1b03e51: folds
Uncalled bet ($0.03) returned to Hero
*** SHOWDOWN ***
Hero collected $0.04 from pot
*** SUMMARY ***
Total pot $0.04 | Rake $0 | Jackpot $0 | Bingo $0 | Fortune $0 | Tax $0
Seat 1: fdbdecff (button) folded before Flop (didn't bet)
Seat 2: d1b03e51 (small blind) folded before Flop
Seat 3: Hero (big blind) collected ($0.04)
Seat 4: 4c91f7e2 folded before Flop (didn't bet)
Seat 5: e7605546 folded before Flop (didn't bet)
Seat 6: 7b205a6f folded before Flop (didn't bet)


Poker Hand #RC3812367973: Hold'em No Limit ($0.02/$0.05) - 2025/08/16 22:50:08
Table 'RushAndCash1063233' 6-max Seat #1 is the button
Seat 1: 1319708a ($16.63 in chips)
Seat 2: 4d5acc21 ($5.92 in chips)
Seat 3: 491638ed ($4.98 in chips)
Seat 4: 94e4c2f ($5.83 in chips)
Seat 5: 46855ff4 ($6.65 in chips)
Seat 6: Hero ($7.13 in chips)
4d5acc21: posts small blind $0.02
491638ed: posts big blind $0.05
*** HOLE CARDS ***
Dealt to 1319708a 
Dealt to 4d5acc21 
Dealt to 491638ed 
Dealt to 94e4c2f 
Dealt to 46855ff4 
Dealt to Hero [2d 2c]
94e4c2f: folds
46855ff4: folds
Hero: folds
1319708a: raises $0.08 to $0.13
4d5acc21: folds
491638ed: calls $0.08
*** FLOP *** [3s 6c 9s]
491638ed: checks
1319708a: bets $0.21
491638ed: raises $0.47 to $0.68
1319708a: folds
Uncalled bet ($0.47) returned to 491638ed
*** SHOWDOWN ***
491638ed collected $0.67 from pot
*** SUMMARY ***
Total pot $0.7 | Rake $0.03 | Jackpot $0 | Bingo $0 | Fortune $0 | Tax $0
Board [3s 6c 9s]
Seat 1: 1319708a (button) folded on the Flop
Seat 2: 4d5acc21 (small blind) folded before Flop
Seat 3: 491638ed (big blind) won ($0.67)
Seat 4: 94e4c2f folded before Flop (didn't bet)
Seat 5: 46855ff4 folded before Flop (didn't bet)
Seat 6: Hero folded before Flop (didn't bet)


Poker Hand #RC3812367941: Hold'em No Limit ($0.02/$0.05) - 2025/08/16 22:50:04
Table 'RushAndCash1063201' 6-max Seat #1 is the button
Seat 1: 20fc3118 ($5 in chips)
Seat 2: 3a5dfcb7 ($5.3 in chips)
Seat 3: cf396bf7 ($8.1 in chips)
Seat 4: 24ccb1c2 ($6.86 in chips)
Seat 5: Hero ($7.13 in chips)
Seat 6: 370bf11f ($5.32 in chips)
3a5dfcb7: posts small blind $0.02
cf396bf7: posts big blind $0.05
*** HOLE CARDS ***
Dealt to 20fc3118 
Dealt to 3a5dfcb7 
Dealt to cf396bf7 
Dealt to 24ccb1c2 
Dealt to Hero [2h 2c]
Dealt to 370bf11f 
24ccb1c2: folds
Hero: folds
370bf11f: folds
20fc3118: raises $0.05 to $0.1
3a5dfcb7: folds
cf396bf7: folds
Uncalled bet ($0.05) returned to 20fc3118
*** SHOWDOWN ***
20fc3118 collected $0.12 from pot
*** SUMMARY ***
Total pot $0.12 | Rake $0 | Jackpot $0 | Bingo $0 | Fortune $0 | Tax $0
Seat 1: 20fc3118 (button) collected ($0.12)
Seat 2: 3a5dfcb7 (small blind) folded before Flop
Seat 3: cf396bf7 (big blind) folded before Flop
Seat 4: 24ccb1c2 folded before Flop (didn't bet)
Seat 5: Hero folded before Flop (didn't bet)
Seat 6: 370bf11f folded before Flop (didn't bet)


Poker Hand #RC3812367914: Hold'em No Limit ($0.02/$0.05) - 2025/08/16 22:50:00
Table 'RushAndCash1063174' 6-max Seat #1 is the button
Seat 1: a9c3d1f3 ($7.88 in chips)
Seat 2: 73def96f ($7.56 in chips)
Seat 3: a801bbc4 ($6.36 in chips)
Seat 4: Hero ($7.13 in chips)
Seat 5: 3a07b8f2 ($5.68 in chips)
Seat 6: abe74b79 ($5.04 in chips)
73def96f: posts small blind $0.02
a801bbc4: posts big blind $0.05
*** HOLE CARDS ***
Dealt to a9c3d1f3 
Dealt to 73def96f 
Dealt to a801bbc4 
Dealt to Hero [Ah 2s]
Dealt to 3a07b8f2 
Dealt to abe74b79 
Hero: folds
3a07b8f2: folds
abe74b79: folds
a9c3d1f3: folds
73def96f: raises $0.1 to $0.15
a801bbc4: raises $0.35 to $0.5
73def96f: calls $0.35
*** FLOP *** [6s As 8h]
73def96f: checks
a801bbc4: bets $0.32
73def96f: calls $0.32
*** TURN *** [6s As 8h] [Th]
73def96f: checks
a801bbc4: checks
*** RIVER *** [6s As 8h Th] [9h]
73def96f: bets $0.55
a801bbc4: folds
Uncalled bet ($0.55) returned to 73def96f
*** SHOWDOWN ***
73def96f collected $1.5 from pot
*** SUMMARY ***
Total pot $1.64 | Rake $0.07 | Jackpot $0.07 | Bingo $0 | Fortune $0 | Tax $0
Board [6s As 8h Th 9h]
Seat 1: a9c3d1f3 (button) folded before Flop (didn't bet)
Seat 2: 73def96f (small blind) won ($1.5)
Seat 3: a801bbc4 (big blind) folded on the River
Seat 4: Hero folded before Flop (didn't bet)
Seat 5: 3a07b8f2 folded before Flop (didn't bet)
Seat 6: abe74b79 folded before Flop (didn't bet)


Poker Hand #RC3812367874: Hold'em No Limit ($0.02/$0.05) - 2025/08/16 22:49:55
Table 'RushAndCash1063134' 6-max Seat #1 is the button
Seat 1: c5fb4aae ($4.82 in chips)
Seat 2: e285be9a ($12.59 in chips)
Seat 3: 82170b33 ($19.86 in chips)
Seat 4: 37ae15a4 ($6.6 in chips)
Seat 5: Hero ($7.13 in chips)
Seat 6: a821c381 ($4.93 in chips)
e285be9a: posts small blind $0.02
82170b33: posts big blind $0.05
*** HOLE CARDS ***
Dealt to c5fb4aae 
Dealt to e285be9a 
Dealt to 82170b33 
Dealt to 37ae15a4 
Dealt to Hero [Ts 4d]
Dealt to a821c381 
37ae15a4: folds
Hero: folds
a821c381: folds
c5fb4aae: folds
e285be9a: folds
Uncalled bet ($0.03) returned to 82170b33
*** SHOWDOWN ***
82170b33 collected $0.04 from pot
*** SUMMARY ***
Total pot $0.04 | Rake $0 | Jackpot $0 | Bingo $0 | Fortune $0 | Tax $0
Seat 1: c5fb4aae (button) folded before Flop (didn't bet)
Seat 2: e285be9a (small blind) folded before Flop
Seat 3: 82170b33 (big blind) collected ($0.04)
Seat 4: 37ae15a4 folded before Flop (didn't bet)
Seat 5: Hero folded before Flop (didn't bet)
Seat 6: a821c381 folded before Flop (didn't bet)


Poker Hand #RC3812367812: Hold'em No Limit ($0.02/$0.05) - 2025/08/16 22:49:46
Table 'RushAndCash1063072' 6-max Seat #1 is the button
Seat 1: 63f90119 ($3.63 in chips)
Seat 2: Hero ($7.15 in chips)
Seat 3: b699a745 ($6.38 in chips)
Seat 4: 43fd3005 ($13.46 in chips)
Seat 5: fed1995e ($5.48 in chips)
Seat 6: 86e97b9e ($6.63 in chips)
Hero: posts small blind $0.02
b699a745: posts big blind $0.05
*** HOLE CARDS ***
Dealt to 63f90119 
Dealt to Hero [2c 5d]
Dealt to b699a745 
Dealt to 43fd3005 
Dealt to fed1995e 
Dealt to 86e97b9e 
43fd3005: folds
fed1995e: folds
86e97b9e: folds
63f90119: folds
Hero: folds
Uncalled bet ($0.03) returned to b699a745
*** SHOWDOWN ***
b699a745 collected $0.04 from pot
*** SUMMARY ***
Total pot $0.04 | Rake $0 | Jackpot $0 | Bingo $0 | Fortune $0 | Tax $0
Seat 1: 63f90119 (button) folded before Flop (didn't bet)
Seat 2: Hero (small blind) folded before Flop
Seat 3: b699a745 (big blind) collected ($0.04)
Seat 4: 43fd3005 folded before Flop (didn't bet)
Seat 5: fed1995e folded before Flop (didn't bet)
Seat 6: 86e97b9e folded before Flop (didn't bet)


Poker Hand #RC3812367757: Hold'em No Limit ($0.02/$0.05) - 2025/08/16 22:49:39
Table 'RushAndCash1063017' 6-max Seat #1 is the button
Seat 1: 3ebdbd34 ($6.91 in chips)
Seat 2: 2a6b4de6 ($5.25 in chips)
Seat 3: Hero ($7.13 in chips)
Seat 4: 1c53873e ($5.15 in chips)
Seat 5: 7e90ec14 ($12.65 in chips)
Seat 6: cd2591eb ($5 in chips)
2a6b4de6: posts small blind $0.02
Hero: posts big blind $0.05
*** HOLE CARDS ***
Dealt to 3ebdbd34 
Dealt to 2a6b4de6 
Dealt to Hero [4h Qs]
Dealt to 1c53873e 
Dealt to 7e90ec14 
Dealt to cd2591eb 
1c53873e: folds
7e90ec14: folds
cd2591eb: folds
3ebdbd34: folds
2a6b4de6: folds
Uncalled bet ($0.03) returned to Hero
*** SHOWDOWN ***
Hero collected $0.04 from pot
*** SUMMARY ***
Total pot $0.04 | Rake $0 | Jackpot $0 | Bingo $0 | Fortune $0 | Tax $0
Seat 1: 3ebdbd34 (button) folded before Flop (didn't bet)
Seat 2: 2a6b4de6 (small blind) folded before Flop
Seat 3: Hero (big blind) collected ($0.04)
Seat 4: 1c53873e folded before Flop (didn't bet)
Seat 5: 7e90ec14 folded before Flop (didn't bet)
Seat 6: cd2591eb folded before Flop (didn't bet)


Poker Hand #RC3812367732: Hold'em No Limit ($0.02/$0.05) - 2025/08/16 22:49:35
Table 'RushAndCash1062992' 6-max Seat #1 is the button
Seat 1: 84cba902 ($7.45 in chips)
Seat 2: fdbdecff ($5.02 in chips)
Seat 3: 43fb7813 ($5.51 in chips)
Seat 4: Hero ($7.13 in chips)
Seat 5: 7b5bc58 ($5 in chips)
Seat 6: 24d280ec ($5.26 in chips)
fdbdecff: posts small blind $0.02
43fb7813: posts big blind $0.05
*** HOLE CARDS ***
Dealt to 84cba902 
Dealt to fdbdecff 
Dealt to 43fb7813 
Dealt to Hero [7h Ad]
Dealt to 7b5bc58 
Dealt to 24d280ec 
Hero: folds
7b5bc58: folds
24d280ec: folds
84cba902: folds
fdbdecff: calls $0.03
43fb7813: raises $0.1 to $0.15
fdbdecff: folds
Uncalled bet ($0.1) returned to 43fb7813
*** SHOWDOWN ***
43fb7813 collected $0.1 from pot
*** SUMMARY ***
Total pot $0.1 | Rake $0 | Jackpot $0 | Bingo $0 | Fortune $0 | Tax $0
Seat 1: 84cba902 (button) folded before Flop (didn't bet)
Seat 2: fdbdecff (small blind) folded before Flop
Seat 3: 43fb7813 (big blind) collected ($0.1)
Seat 4: Hero folded before Flop (didn't bet)
Seat 5: 7b5bc58 folded before Flop (didn't bet)
Seat 6: 24d280ec folded before Flop (didn't bet)


Poker Hand #RC3812367615: Hold'em No Limit ($0.02/$0.05) - 2025/08/16 22:49:19
Table 'RushAndCash1062875' 6-max Seat #1 is the button
Seat 1: Hero ($7.06 in chips)
Seat 2: 82ee8230 ($5.97 in chips)
Seat 3: 5b514e91 ($5.96 in chips)
Seat 4: 358cc738 ($5 in chips)
Seat 5: c2968eb7 ($5.07 in chips)
Seat 6: dde5d1b0 ($6.14 in chips)
82ee8230: posts small blind $0.02
5b514e91: posts big blind $0.05
*** HOLE CARDS ***
Dealt to Hero [Qh Jd]
Dealt to 82ee8230 
Dealt to 5b514e91 
Dealt to 358cc738 
Dealt to c2968eb7 
Dealt to dde5d1b0 
358cc738: folds
c2968eb7: folds
dde5d1b0: folds
Hero: raises $0.05 to $0.1
82ee8230: folds
5b514e91: folds
Uncalled bet ($0.05) returned to Hero
*** SHOWDOWN ***
Hero collected $0.12 from pot
*** SUMMARY ***
Total pot $0.12 | Rake $0 | Jackpot $0 | Bingo $0 | Fortune $0 | Tax $0
Seat 1: Hero (button) collected ($0.12)
Seat 2: 82ee8230 (small blind) folded before Flop
Seat 3: 5b514e91 (big blind) folded before Flop
Seat 4: 358cc738 folded before Flop (didn't bet)
Seat 5: c2968eb7 folded before Flop (didn't bet)
Seat 6: dde5d1b0 folded before Flop (didn't bet)


Poker Hand #RC3812367526: Hold'em No Limit ($0.02/$0.05) - 2025/08/16 22:49:07
Table 'RushAndCash1062786' 6-max Seat #1 is the button
Seat 1: 5cf21b14 ($5.07 in chips)
Seat 2: 5b514e91 ($5.98 in chips)
Seat 3: 5ad17830 ($3.86 in chips)
Seat 4: 2a385857 ($5.6 in chips)
Seat 5: Hero ($7.06 in chips)
Seat 6: f59c9744 ($5.04 in chips)
5b514e91: posts small blind $0.02
5ad17830: posts big blind $0.05
*** HOLE CARDS ***
Dealt to 5cf21b14 
Dealt to 5b514e91 
Dealt to 5ad17830 
Dealt to 2a385857 
Dealt to Hero [Tc Kd]
Dealt to f59c9744 
2a385857: folds
Hero: folds
f59c9744: folds
5cf21b14: raises $0.06 to $0.11
5b514e91: folds
5ad17830: folds
Uncalled bet ($0.06) returned to 5cf21b14
*** SHOWDOWN ***
5cf21b14 collected $0.12 from pot
*** SUMMARY ***
Total pot $0.12 | Rake $0 | Jackpot $0 | Bingo $0 | Fortune $0 | Tax $0
Seat 1: 5cf21b14 (button) collected ($0.12)
Seat 2: 5b514e91 (small blind) folded before Flop
Seat 3: 5ad17830 (big blind) folded before Flop
Seat 4: 2a385857 folded before Flop (didn't bet)
Seat 5: Hero folded before Flop (didn't bet)
Seat 6: f59c9744 folded before Flop (didn't bet)


Poker Hand #RC3812367498: Hold'em No Limit ($0.02/$0.05) - 2025/08/16 22:49:04
Table 'RushAndCash1062758' 6-max Seat #1 is the button
Seat 1: 3a07b8f2 ($5.8 in chips)
Seat 2: 29d1b108 ($4.32 in chips)
Seat 3: e7605546 ($4.98 in chips)
Seat 4: Hero ($7.06 in chips)
Seat 5: df068b52 ($6.82 in chips)
Seat 6: 4001b8e5 ($12.6 in chips)
29d1b108: posts small blind $0.02
e7605546: posts big blind $0.05
*** HOLE CARDS ***
Dealt to 3a07b8f2 
Dealt to 29d1b108 
Dealt to e7605546 
Dealt to Hero [8c Qd]
Dealt to df068b52 
Dealt to 4001b8e5 
Hero: folds
df068b52: folds
4001b8e5: folds
3a07b8f2: folds
29d1b108: folds
Uncalled bet ($0.03) returned to e7605546
*** SHOWDOWN ***
e7605546 collected $0.04 from pot
*** SUMMARY ***
Total pot $0.04 | Rake $0 | Jackpot $0 | Bingo $0 | Fortune $0 | Tax $0
Seat 1: 3a07b8f2 (button) folded before Flop (didn't bet)
Seat 2: 29d1b108 (small blind) folded before Flop
Seat 3: e7605546 (big blind) collected ($0.04)
Seat 4: Hero folded before Flop (didn't bet)
Seat 5: df068b52 folded before Flop (didn't bet)
Seat 6: 4001b8e5 folded before Flop (didn't bet)


Poker Hand #RC3812367402: Hold'em No Limit ($0.02/$0.05) - 2025/08/16 22:48:51
Table 'RushAndCash1062662' 6-max Seat #1 is the button
Seat 1: Hero ($7.06 in chips)
Seat 2: d3c7d081 ($13.86 in chips)
Seat 3: 80ca18ba ($5.14 in chips)
Seat 4: d61c7236 ($5.14 in chips)
Seat 5: 99d129fb ($1.93 in chips)
Seat 6: fdfb98f1 ($7.89 in chips)
d3c7d081: posts small blind $0.02
80ca18ba: posts big blind $0.05
*** HOLE CARDS ***
Dealt to Hero [7c 8d]
Dealt to d3c7d081 
Dealt to 80ca18ba 
Dealt to d61c7236 
Dealt to 99d129fb 
Dealt to fdfb98f1 
d61c7236: folds
99d129fb: raises $0.05 to $0.1
fdfb98f1: folds
Hero: folds
d3c7d081: raises $0.4 to $0.5
80ca18ba: folds
99d129fb: calls $0.4
*** FLOP *** [9h 4d Ad]
d3c7d081: bets $0.35
99d129fb: folds
Uncalled bet ($0.35) returned to d3c7d081
*** SHOWDOWN ***
d3c7d081 collected $1 from pot
*** SUMMARY ***
Total pot $1.05 | Rake $0.05 | Jackpot $0 | Bingo $0 | Fortune $0 | Tax $0
Board [9h 4d Ad]
Seat 1: Hero (button) folded before Flop (didn't bet)
Seat 2: d3c7d081 (small blind) won ($1)
Seat 3: 80ca18ba (big blind) folded before Flop
Seat 4: d61c7236 folded before Flop (didn't bet)
Seat 5: 99d129fb folded on the Flop
Seat 6: fdfb98f1 folded before Flop (didn't bet)


Poker Hand #RC3812367361: Hold'em No Limit ($0.02/$0.05) - 2025/08/16 22:48:44
Table 'RushAndCash1062621' 6-max Seat #1 is the button
Seat 1: c5fb4aae ($4.26 in chips)
Seat 2: Hero ($7.08 in chips)
Seat 3: 3f7fd703 ($5.53 in chips)
Seat 4: f07f348e ($5.35 in chips)
Seat 5: bd1c70d5 ($2.77 in chips)
Seat 6: bfac3f86 ($8.58 in chips)
Hero: posts small blind $0.02
3f7fd703: posts big blind $0.05
*** HOLE CARDS ***
Dealt to c5fb4aae 
Dealt to Hero [Kd 6h]
Dealt to 3f7fd703 
Dealt to f07f348e 
Dealt to bd1c70d5 
Dealt to bfac3f86 
f07f348e: folds
bd1c70d5: folds
bfac3f86: raises $0.05 to $0.1
c5fb4aae: folds
Hero: folds
3f7fd703: calls $0.05
*** FLOP *** [7h Jd 8h]
3f7fd703: checks
bfac3f86: checks
*** TURN *** [7h Jd 8h] [7c]
3f7fd703: checks
bfac3f86: bets $0.14
3f7fd703: calls $0.14
*** RIVER *** [7h Jd 8h 7c] [As]
3f7fd703: checks
bfac3f86: checks
3f7fd703: shows [Ah Ts] (two pair, Aces and Sevens)
bfac3f86: shows [Qs Th] (a pair of Sevens)
*** SHOWDOWN ***
3f7fd703 collected $0.48 from pot
*** SUMMARY ***
Total pot $0.5 | Rake $0.02 | Jackpot $0 | Bingo $0 | Fortune $0 | Tax $0
Board [7h Jd 8h 7c As]
Seat 1: c5fb4aae (button) folded before Flop (didn't bet)
Seat 2: Hero (small blind) folded before Flop
Seat 3: 3f7fd703 (big blind) showed [Ah Ts] and won ($0.48) with two pair, Aces and Sevens
Seat 4: f07f348e folded before Flop (didn't bet)
Seat 5: bd1c70d5 folded before Flop (didn't bet)
Seat 6: bfac3f86 showed [Qs Th] and lost with a pair of Sevens


Poker Hand #RC3812366786: Hold'em No Limit ($0.02/$0.05) - 2025/08/16 22:47:24
Table 'RushAndCash1062046' 6-max Seat #1 is the button
Seat 1: a801bbc4 ($6.22 in chips)
Seat 2: abe74b79 ($5.02 in chips)
Seat 3: Hero ($7.13 in chips)
Seat 4: cc98320 ($5 in chips)
Seat 5: 53cb8154 ($9.15 in chips)
Seat 6: cbee5300 ($5 in chips)
abe74b79: posts small blind $0.02
Hero: posts big blind $0.05
*** HOLE CARDS ***
Dealt to a801bbc4 
Dealt to abe74b79 
Dealt to Hero [Th 5c]
Dealt to cc98320 
Dealt to 53cb8154 
Dealt to cbee5300 
cc98320: folds
53cb8154: folds
cbee5300: folds
a801bbc4: folds
abe74b79: raises $0.1 to $0.15
Hero: folds
Uncalled bet ($0.1) returned to abe74b79
*** SHOWDOWN ***
abe74b79 collected $0.1 from pot
*** SUMMARY ***
Total pot $0.1 | Rake $0 | Jackpot $0 | Bingo $0 | Fortune $0 | Tax $0
Seat 1: a801bbc4 (button) folded before Flop (didn't bet)
Seat 2: abe74b79 (small blind) collected ($0.1)
Seat 3: Hero (big blind) folded before Flop
Seat 4: cc98320 folded before Flop (didn't bet)
Seat 5: 53cb8154 folded before Flop (didn't bet)
Seat 6: cbee5300 folded before Flop (didn't bet)


Poker Hand #RC3812366200: Hold'em No Limit ($0.02/$0.05) - 2025/08/16 22:46:01
Table 'RushAndCash1061460' 6-max Seat #1 is the button
Seat 1: 4ad0b015 ($4.86 in chips)
Seat 2: d61c7236 ($6.35 in chips)
Seat 3: edba6ccc ($9.01 in chips)
Seat 4: cbee5300 ($5 in chips)
Seat 5: 270a393a ($5 in chips)
Seat 6: Hero ($3.65 in chips)
d61c7236: posts small blind $0.02
edba6ccc: posts big blind $0.05
*** HOLE CARDS ***
Dealt to 4ad0b015 
Dealt to d61c7236 
Dealt to edba6ccc 
Dealt to cbee5300 
Dealt to 270a393a 
Dealt to Hero [Qh Qc]
cbee5300: folds
270a393a: folds
Hero: raises $0.05 to $0.1
4ad0b015: folds
d61c7236: raises $0.45 to $0.55
edba6ccc: folds
Hero: calls $0.45
*** FLOP *** [Tc 5d 9h]
d61c7236: bets $0.58
Hero: calls $0.58
*** TURN *** [Tc 5d 9h] [Th]
d61c7236: bets $1.16
Hero: calls $1.16
*** RIVER *** [Tc 5d 9h Th] [7s]
d61c7236: bets $4.06 and is all-in
Hero: calls $1.36 and is all-in
Uncalled bet ($2.7) returned to d61c7236
d61c7236: shows [As Jc] (a pair of Tens)
Hero: shows [Qh Qc] (two pair, Queens and Tens)
*** SHOWDOWN ***
Hero collected $7.13 from pot
*** SUMMARY ***
Total pot $7.35 | Rake $0.15 | Jackpot $0.07 | Bingo $0 | Fortune $0 | Tax $0
Board [Tc 5d 9h Th 7s]
Seat 1: 4ad0b015 (button) folded before Flop (didn't bet)
Seat 2: d61c7236 (small blind) showed [As Jc] and lost with a pair of Tens
Seat 3: edba6ccc (big blind) folded before Flop
Seat 4: cbee5300 folded before Flop (didn't bet)
Seat 5: 270a393a folded before Flop (didn't bet)
Seat 6: Hero showed [Qh Qc] and won ($7.13) with two pair, Queens and Tens


Poker Hand #RC3812365788: Hold'em No Limit ($0.02/$0.05) - 2025/08/16 22:45:09
Table 'RushAndCash1061048' 6-max Seat #1 is the button
Seat 1: d77bfcba ($4.46 in chips)
Seat 2: b11a8a85 ($4.02 in chips)
Seat 3: 4cf59b27 ($6.89 in chips)
Seat 4: 1c26a2dc ($6.04 in chips)
Seat 5: Hero ($3.75 in chips)
Seat 6: 6f8adeab ($8.21 in chips)
b11a8a85: posts small blind $0.02
4cf59b27: posts big blind $0.05
*** HOLE CARDS ***
Dealt to d77bfcba 
Dealt to b11a8a85 
Dealt to 4cf59b27 
Dealt to 1c26a2dc 
Dealt to Hero [Qd As]
Dealt to 6f8adeab 
1c26a2dc: raises $0.05 to $0.1
Hero: calls $0.1
6f8adeab: folds
d77bfcba: folds
b11a8a85: folds
4cf59b27: calls $0.05
*** FLOP *** [Jc Jh 7h]
4cf59b27: checks
1c26a2dc: checks
Hero: checks
*** TURN *** [Jc Jh 7h] [4d]
4cf59b27: bets $0.12
1c26a2dc: calls $0.12
Hero: folds
*** RIVER *** [Jc Jh 7h 4d] [8c]
4cf59b27: checks
1c26a2dc: checks
4cf59b27: shows [7s 8s] (two pair, Jacks and Eights)
1c26a2dc: shows [7c 9c] (two pair, Jacks and Sevens)
*** SHOWDOWN ***
4cf59b27 collected $0.54 from pot
*** SUMMARY ***
Total pot $0.56 | Rake $0.02 | Jackpot $0 | Bingo $0 | Fortune $0 | Tax $0
Board [Jc Jh 7h 4d 8c]
Seat 1: d77bfcba (button) folded before Flop (didn't bet)
Seat 2: b11a8a85 (small blind) folded before Flop
Seat 3: 4cf59b27 (big blind) showed [7s 8s] and won ($0.54) with two pair, Jacks and Eights
Seat 4: 1c26a2dc showed [7c 9c] and lost with two pair, Jacks and Sevens
Seat 5: Hero folded on the Turn
Seat 6: 6f8adeab folded before Flop (didn't bet)


Poker Hand #RC3812365377: Hold'em No Limit ($0.02/$0.05) - 2025/08/16 22:44:14
Table 'RushAndCash1060637' 6-max Seat #1 is the button
Seat 1: f26a9f66 ($5.02 in chips)
Seat 2: Hero ($3.8 in chips)
Seat 3: c05cfde4 ($5.08 in chips)
Seat 4: c8bdfb6 ($5 in chips)
Seat 5: 58ebb27f ($12.13 in chips)
Seat 6: 2a8cf5cb ($4.22 in chips)
Hero: posts small blind $0.02
c05cfde4: posts big blind $0.05
*** HOLE CARDS ***
Dealt to f26a9f66 
Dealt to Hero [Qc Ts]
Dealt to c05cfde4 
Dealt to c8bdfb6 
Dealt to 58ebb27f 
Dealt to 2a8cf5cb 
c8bdfb6: folds
58ebb27f: folds
2a8cf5cb: folds
f26a9f66: folds
Hero: calls $0.03
c05cfde4: checks
*** FLOP *** [2d 3s Js]
Hero: checks
c05cfde4: checks
*** TURN *** [2d 3s Js] [7c]
Hero: checks
c05cfde4: checks
*** RIVER *** [2d 3s Js 7c] [Jc]
Hero: checks
c05cfde4: checks
Hero: shows [Qc Ts] (a pair of Jacks)
c05cfde4: shows [Kd Th] (a pair of Jacks)
*** SHOWDOWN ***
c05cfde4 collected $0.1 from pot
*** SUMMARY ***
Total pot $0.1 | Rake $0 | Jackpot $0 | Bingo $0 | Fortune $0 | Tax $0
Board [2d 3s Js 7c Jc]
Seat 1: f26a9f66 (button) folded before Flop (didn't bet)
Seat 2: Hero (small blind) showed [Qc Ts] and lost with a pair of Jacks
Seat 3: c05cfde4 (big blind) showed [Kd Th] and won ($0.1) with a pair of Jacks
Seat 4: c8bdfb6 folded before Flop (didn't bet)
Seat 5: 58ebb27f folded before Flop (didn't bet)
Seat 6: 2a8cf5cb folded before Flop (didn't bet)


Poker Hand #RC3812365340: Hold'em No Limit ($0.02/$0.05) - 2025/08/16 22:44:08
Table 'RushAndCash1060600' 6-max Seat #1 is the button
Seat 1: 86e97b9e ($5.09 in chips)
Seat 2: 1e8ef55c ($5 in chips)
Seat 3: b699a745 ($6.15 in chips)
Seat 4: 645c1c8a ($5.58 in chips)
Seat 5: Hero ($3.8 in chips)
Seat 6: 281a8acb ($3.37 in chips)
1e8ef55c: posts small blind $0.02
b699a745: posts big blind $0.05
*** HOLE CARDS ***
Dealt to 86e97b9e 
Dealt to 1e8ef55c 
Dealt to b699a745 
Dealt to 645c1c8a 
Dealt to Hero [Qh 9d]
Dealt to 281a8acb 
645c1c8a: folds
Hero: folds
281a8acb: folds
86e97b9e: folds
1e8ef55c: raises $0.08 to $0.13
b699a745: calls $0.08
*** FLOP *** [Ad 5c Qs]
1e8ef55c: bets $0.09
b699a745: folds
Uncalled bet ($0.09) returned to 1e8ef55c
*** SHOWDOWN ***
1e8ef55c collected $0.25 from pot
*** SUMMARY ***
Total pot $0.26 | Rake $0.01 | Jackpot $0 | Bingo $0 | Fortune $0 | Tax $0
Board [Ad 5c Qs]
Seat 1: 86e97b9e (button) folded before Flop (didn't bet)
Seat 2: 1e8ef55c (small blind) won ($0.25)
Seat 3: b699a745 (big blind) folded on the Flop
Seat 4: 645c1c8a folded before Flop (didn't bet)
Seat 5: Hero folded before Flop (didn't bet)
Seat 6: 281a8acb folded before Flop (didn't bet)


Poker Hand #RC3812365256: Hold'em No Limit ($0.02/$0.05) - 2025/08/16 22:43:57
Table 'RushAndCash1060516' 6-max Seat #1 is the button
Seat 1: 4c91f7e2 ($5.73 in chips)
Seat 2: 4d008864 ($9.39 in chips)
Seat 3: Hero ($3.85 in chips)
Seat 4: c614ebe7 ($6.48 in chips)
Seat 5: 73547c73 ($1.81 in chips)
Seat 6: fec0d079 ($9.44 in chips)
4d008864: posts small blind $0.02
Hero: posts big blind $0.05
*** HOLE CARDS ***
Dealt to 4c91f7e2 
Dealt to 4d008864 
Dealt to Hero [8s Kd]
Dealt to c614ebe7 
Dealt to 73547c73 
Dealt to fec0d079 
c614ebe7: raises $0.1 to $0.15
73547c73: folds
fec0d079: folds
4c91f7e2: folds
4d008864: folds
Hero: folds
Uncalled bet ($0.1) returned to c614ebe7
*** SHOWDOWN ***
c614ebe7 collected $0.12 from pot
*** SUMMARY ***
Total pot $0.12 | Rake $0 | Jackpot $0 | Bingo $0 | Fortune $0 | Tax $0
Seat 1: 4c91f7e2 (button) folded before Flop (didn't bet)
Seat 2: 4d008864 (small blind) folded before Flop
Seat 3: Hero (big blind) folded before Flop
Seat 4: c614ebe7 collected ($0.12)
Seat 5: 73547c73 folded before Flop (didn't bet)
Seat 6: fec0d079 folded before Flop (didn't bet)


Poker Hand #RC3812365118: Hold'em No Limit ($0.02/$0.05) - 2025/08/16 22:43:39
Table 'RushAndCash1060378' 6-max Seat #1 is the button
Seat 1: Hero ($3.85 in chips)
Seat 2: 90471d95 ($1.95 in chips)
Seat 3: 40a92532 ($6.3 in chips)
Seat 4: c46c7d3e ($5.49 in chips)
Seat 5: 7ce12b39 ($3.69 in chips)
Seat 6: f734c0c4 ($9.18 in chips)
90471d95: posts small blind $0.02
40a92532: posts big blind $0.05
*** HOLE CARDS ***
Dealt to Hero [5d Jh]
Dealt to 90471d95 
Dealt to 40a92532 
Dealt to c46c7d3e 
Dealt to 7ce12b39 
Dealt to f734c0c4 
c46c7d3e: folds
7ce12b39: folds
f734c0c4: raises $0.08 to $0.13
Hero: folds
90471d95: folds
40a92532: folds
Uncalled bet ($0.08) returned to f734c0c4
*** SHOWDOWN ***
f734c0c4 collected $0.12 from pot
*** SUMMARY ***
Total pot $0.12 | Rake $0 | Jackpot $0 | Bingo $0 | Fortune $0 | Tax $0
Seat 1: Hero (button) folded before Flop (didn't bet)
Seat 2: 90471d95 (small blind) folded before Flop
Seat 3: 40a92532 (big blind) folded before Flop
Seat 4: c46c7d3e folded before Flop (didn't bet)
Seat 5: 7ce12b39 folded before Flop (didn't bet)
Seat 6: f734c0c4 collected ($0.12)


Poker Hand #RC3812365088: Hold'em No Limit ($0.02/$0.05) - 2025/08/16 22:43:35
Table 'RushAndCash1060348' 6-max Seat #1 is the button
Seat 1: 8ca94ff2 ($11.51 in chips)
Seat 2: 5dbcbc29 ($6 in chips)
Seat 3: 3f3d8b95 ($1.33 in chips)
Seat 4: Hero ($3.85 in chips)
Seat 5: de500ce ($4.93 in chips)
Seat 6: 8a793499 ($7.62 in chips)
5dbcbc29: posts small blind $0.02
3f3d8b95: posts big blind $0.05
*** HOLE CARDS ***
Dealt to 8ca94ff2 
Dealt to 5dbcbc29 
Dealt to 3f3d8b95 
Dealt to Hero [Ad 6s]
Dealt to de500ce 
Dealt to 8a793499 
Hero: folds
de500ce: folds
8a793499: folds
8ca94ff2: raises $0.07 to $0.12
5dbcbc29: folds
3f3d8b95: folds
Uncalled bet ($0.07) returned to 8ca94ff2
*** SHOWDOWN ***
8ca94ff2 collected $0.12 from pot
*** SUMMARY ***
Total pot $0.12 | Rake $0 | Jackpot $0 | Bingo $0 | Fortune $0 | Tax $0
Seat 1: 8ca94ff2 (button) collected ($0.12)
Seat 2: 5dbcbc29 (small blind) folded before Flop
Seat 3: 3f3d8b95 (big blind) folded before Flop
Seat 4: Hero folded before Flop (didn't bet)
Seat 5: de500ce folded before Flop (didn't bet)
Seat 6: 8a793499 folded before Flop (didn't bet)


Poker Hand #RC3812365053: Hold'em No Limit ($0.02/$0.05) - 2025/08/16 22:43:31
Table 'RushAndCash1060313' 6-max Seat #1 is the button
Seat 1: 38232278 ($10.21 in chips)
Seat 2: bfac3f86 ($8.51 in chips)
Seat 3: ba346191 ($14.12 in chips)
Seat 4: Hero ($3.85 in chips)
Seat 5: a801bbc4 ($5.43 in chips)
Seat 6: 2c704e54 ($9.21 in chips)
bfac3f86: posts small blind $0.02
ba346191: posts big blind $0.05
*** HOLE CARDS ***
Dealt to 38232278 
Dealt to bfac3f86 
Dealt to ba346191 
Dealt to Hero [7h Jd]
Dealt to a801bbc4 
Dealt to 2c704e54 
Hero: folds
a801bbc4: folds
2c704e54: folds
38232278: folds
bfac3f86: folds
Uncalled bet ($0.03) returned to ba346191
*** SHOWDOWN ***
ba346191 collected $0.04 from pot
*** SUMMARY ***
Total pot $0.04 | Rake $0 | Jackpot $0 | Bingo $0 | Fortune $0 | Tax $0
Seat 1: 38232278 (button) folded before Flop (didn't bet)
Seat 2: bfac3f86 (small blind) folded before Flop
Seat 3: ba346191 (big blind) collected ($0.04)
Seat 4: Hero folded before Flop (didn't bet)
Seat 5: a801bbc4 folded before Flop (didn't bet)
Seat 6: 2c704e54 folded before Flop (didn't bet)


Poker Hand #RC3812365028: Hold'em No Limit ($0.02/$0.05) - 2025/08/16 22:43:28
Table 'RushAndCash1060288' 6-max Seat #1 is the button
Seat 1: 4543d70c ($4.8 in chips)
Seat 2: 42ef9b6b ($2.84 in chips)
Seat 3: 32856fe4 ($1.53 in chips)
Seat 4: af0142ec ($5.83 in chips)
Seat 5: Hero ($3.85 in chips)
Seat 6: 24d280ec ($5 in chips)
42ef9b6b: posts small blind $0.02
32856fe4: posts big blind $0.05
*** HOLE CARDS ***
Dealt to 4543d70c 
Dealt to 42ef9b6b 
Dealt to 32856fe4 
Dealt to af0142ec 
Dealt to Hero [Jc 7d]
Dealt to 24d280ec 
af0142ec: folds
Hero: folds
24d280ec: folds
4543d70c: raises $0.07 to $0.12
42ef9b6b: raises $0.29 to $0.41
32856fe4: folds
4543d70c: calls $0.29
*** FLOP *** [3c 5h As]
42ef9b6b: bets $0.44
4543d70c: folds
Uncalled bet ($0.44) returned to 42ef9b6b
*** SHOWDOWN ***
42ef9b6b collected $0.83 from pot
*** SUMMARY ***
Total pot $0.87 | Rake $0.04 | Jackpot $0 | Bingo $0 | Fortune $0 | Tax $0
Board [3c 5h As]
Seat 1: 4543d70c (button) folded on the Flop
Seat 2: 42ef9b6b (small blind) won ($0.83)
Seat 3: 32856fe4 (big blind) folded before Flop
Seat 4: af0142ec folded before Flop (didn't bet)
Seat 5: Hero folded before Flop (didn't bet)
Seat 6: 24d280ec folded before Flop (didn't bet)


Poker Hand #RC3812364999: Hold'em No Limit ($0.02/$0.05) - 2025/08/16 22:43:24
Table 'RushAndCash1060259' 6-max Seat #1 is the button
Seat 1: 3a07b8f2 ($6.22 in chips)
Seat 2: b6774e9c ($5 in chips)
Seat 3: 3ed9d1f1 ($12.45 in chips)
Seat 4: Hero ($3.85 in chips)
Seat 5: d3370876 ($1.69 in chips)
Seat 6: ad14e904 ($10.95 in chips)
b6774e9c: posts small blind $0.02
3ed9d1f1: posts big blind $0.05
*** HOLE CARDS ***
Dealt to 3a07b8f2 
Dealt to b6774e9c 
Dealt to 3ed9d1f1 
Dealt to Hero [Qd 6c]
Dealt to d3370876 
Dealt to ad14e904 
Hero: folds
d3370876: folds
ad14e904: raises $0.05 to $0.1
3a07b8f2: folds
b6774e9c: raises $0.36 to $0.46
3ed9d1f1: folds
ad14e904: folds
Uncalled bet ($0.36) returned to b6774e9c
*** SHOWDOWN ***
b6774e9c collected $0.24 from pot
*** SUMMARY ***
Total pot $0.25 | Rake $0.01 | Jackpot $0 | Bingo $0 | Fortune $0 | Tax $0
Seat 1: 3a07b8f2 (button) folded before Flop (didn't bet)
Seat 2: b6774e9c (small blind) collected ($0.24)
Seat 3: 3ed9d1f1 (big blind) folded before Flop
Seat 4: Hero folded before Flop (didn't bet)
Seat 5: d3370876 folded before Flop (didn't bet)
Seat 6: ad14e904 folded before Flop


Poker Hand #RC3812364972: Hold'em No Limit ($0.02/$0.05) - 2025/08/16 22:43:20
Table 'RushAndCash1060232' 6-max Seat #1 is the button
Seat 1: b1f4635c ($7.59 in chips)
Seat 2: 2c704e54 ($9.23 in chips)
Seat 3: a12a73c2 ($10.19 in chips)
Seat 4: 52ee534e ($5.07 in chips)
Seat 5: c9cc819c ($5.07 in chips)
Seat 6: Hero ($3.85 in chips)
2c704e54: posts small blind $0.02
a12a73c2: posts big blind $0.05
*** HOLE CARDS ***
Dealt to b1f4635c 
Dealt to 2c704e54 
Dealt to a12a73c2 
Dealt to 52ee534e 
Dealt to c9cc819c 
Dealt to Hero [6d Jh]
52ee534e: raises $0.05 to $0.1
c9cc819c: folds
Hero: folds
b1f4635c: raises $0.3 to $0.4
2c704e54: folds
a12a73c2: folds
52ee534e: folds
Uncalled bet ($0.3) returned to b1f4635c
*** SHOWDOWN ***
b1f4635c collected $0.26 from pot
*** SUMMARY ***
Total pot $0.27 | Rake $0.01 | Jackpot $0 | Bingo $0 | Fortune $0 | Tax $0
Seat 1: b1f4635c (button) collected ($0.26)
Seat 2: 2c704e54 (small blind) folded before Flop
Seat 3: a12a73c2 (big blind) folded before Flop
Seat 4: 52ee534e folded before Flop
Seat 5: c9cc819c folded before Flop (didn't bet)
Seat 6: Hero folded before Flop (didn't bet)


Poker Hand #RC3812364830: Hold'em No Limit ($0.02/$0.05) - 2025/08/16 22:43:02
Table 'RushAndCash1060090' 6-max Seat #1 is the button
Seat 1: Hero ($3.78 in chips)
Seat 2: aa1d41d8 ($6.21 in chips)
Seat 3: e238836 ($5.03 in chips)
Seat 4: 46d64a45 ($5.3 in chips)
Seat 5: dccb32d0 ($11.33 in chips)
Seat 6: 2a8cf5cb ($4.15 in chips)
aa1d41d8: posts small blind $0.02
e238836: posts big blind $0.05
*** HOLE CARDS ***
Dealt to Hero [9h 7d]
Dealt to aa1d41d8 
Dealt to e238836 
Dealt to 46d64a45 
Dealt to dccb32d0 
Dealt to 2a8cf5cb 
46d64a45: folds
dccb32d0: folds
2a8cf5cb: folds
Hero: raises $0.05 to $0.1
aa1d41d8: folds
e238836: folds
Uncalled bet ($0.05) returned to Hero
*** SHOWDOWN ***
Hero collected $0.12 from pot
*** SUMMARY ***
Total pot $0.12 | Rake $0 | Jackpot $0 | Bingo $0 | Fortune $0 | Tax $0
Seat 1: Hero (button) collected ($0.12)
Seat 2: aa1d41d8 (small blind) folded before Flop
Seat 3: e238836 (big blind) folded before Flop
Seat 4: 46d64a45 folded before Flop (didn't bet)
Seat 5: dccb32d0 folded before Flop (didn't bet)
Seat 6: 2a8cf5cb folded before Flop (didn't bet)


Poker Hand #RC3812364764: Hold'em No Limit ($0.02/$0.05) - 2025/08/16 22:42:53
Table 'RushAndCash1060024' 6-max Seat #1 is the button
Seat 1: dc3fa354 ($16.42 in chips)
Seat 2: b036096b ($5.18 in chips)
Seat 3: Hero ($3.76 in chips)
Seat 4: 63f90119 ($4.68 in chips)
Seat 5: 3414e94a ($12.64 in chips)
Seat 6: 64e1e0e2 ($5.44 in chips)
b036096b: posts small blind $0.02
Hero: posts big blind $0.05
*** HOLE CARDS ***
Dealt to dc3fa354 
Dealt to b036096b 
Dealt to Hero [9s 9d]
Dealt to 63f90119 
Dealt to 3414e94a 
Dealt to 64e1e0e2 
63f90119: folds
3414e94a: folds
64e1e0e2: folds
dc3fa354: folds
b036096b: folds
Uncalled bet ($0.03) returned to Hero
*** SHOWDOWN ***
Hero collected $0.04 from pot
*** SUMMARY ***
Total pot $0.04 | Rake $0 | Jackpot $0 | Bingo $0 | Fortune $0 | Tax $0
Seat 1: dc3fa354 (button) folded before Flop (didn't bet)
Seat 2: b036096b (small blind) folded before Flop
Seat 3: Hero (big blind) collected ($0.04)
Seat 4: 63f90119 folded before Flop (didn't bet)
Seat 5: 3414e94a folded before Flop (didn't bet)
Seat 6: 64e1e0e2 folded before Flop (didn't bet)


Poker Hand #RC3812334408: Hold'em No Limit ($0.02/$0.05) - 2025/08/16 22:42:05
Table 'RushAndCash1059668' 6-max Seat #1 is the button
Seat 1: a51cbb0e ($5.15 in chips)
Seat 2: Hero ($3.96 in chips)
Seat 3: b036096b ($5 in chips)
Seat 4: 228df635 ($6.55 in chips)
Seat 5: b6774e9c ($5 in chips)
Seat 6: 30246990 ($4.27 in chips)
Hero: posts small blind $0.02
b036096b: posts big blind $0.05
*** HOLE CARDS ***
Dealt to a51cbb0e 
Dealt to Hero [Ah Qc]
Dealt to b036096b 
Dealt to 228df635 
Dealt to b6774e9c 
Dealt to 30246990 
228df635: folds
b6774e9c: folds
30246990: folds
a51cbb0e: folds
Hero: raises $0.05 to $0.1
b036096b: calls $0.05
*** FLOP *** [Ks 3s As]
Hero: bets $0.1
b036096b: calls $0.1
*** TURN *** [Ks 3s As] [5s]
Hero: checks
b036096b: checks
*** RIVER *** [Ks 3s As 5s] [Ac]
Hero: checks
b036096b: checks
Hero: shows [Ah Qc] (three of a kind, Aces)
b036096b: shows [Ts 5c] (a flush Ace high)
*** SHOWDOWN ***
b036096b collected $0.38 from pot
*** SUMMARY ***
Total pot $0.4 | Rake $0.02 | Jackpot $0 | Bingo $0 | Fortune $0 | Tax $0
Board [Ks 3s As 5s Ac]
Seat 1: a51cbb0e (button) folded before Flop (didn't bet)
Seat 2: Hero (small blind) showed [Ah Qc] and lost with three of a kind, Aces
Seat 3: b036096b (big blind) showed [Ts 5c] and won ($0.38) with a flush Ace high
Seat 4: 228df635 folded before Flop (didn't bet)
Seat 5: b6774e9c folded before Flop (didn't bet)
Seat 6: 30246990 folded before Flop (didn't bet)


Poker Hand #RC3812334380: Hold'em No Limit ($0.02/$0.05) - 2025/08/16 22:42:01
Table 'RushAndCash1059640' 6-max Seat #1 is the button
Seat 1: 10dff872 ($6.81 in chips)
Seat 2: 52ee534e ($4.95 in chips)
Seat 3: 1c739e90 ($6.74 in chips)
Seat 4: Hero ($3.96 in chips)
Seat 5: 35e8abfd ($6.24 in chips)
Seat 6: 81b3c6f3 ($7.11 in chips)
52ee534e: posts small blind $0.02
1c739e90: posts big blind $0.05
*** HOLE CARDS ***
Dealt to 10dff872 
Dealt to 52ee534e 
Dealt to 1c739e90 
Dealt to Hero [6s 8c]
Dealt to 35e8abfd 
Dealt to 81b3c6f3 
Hero: folds
35e8abfd: folds
81b3c6f3: folds
10dff872: raises $0.05 to $0.1
52ee534e: folds
1c739e90: folds
Uncalled bet ($0.05) returned to 10dff872
*** SHOWDOWN ***
10dff872 collected $0.12 from pot
*** SUMMARY ***
Total pot $0.12 | Rake $0 | Jackpot $0 | Bingo $0 | Fortune $0 | Tax $0
Seat 1: 10dff872 (button) collected ($0.12)
Seat 2: 52ee534e (small blind) folded before Flop
Seat 3: 1c739e90 (big blind) folded before Flop
Seat 4: Hero folded before Flop (didn't bet)
Seat 5: 35e8abfd folded before Flop (didn't bet)
Seat 6: 81b3c6f3 folded before Flop (didn't bet)


Poker Hand #RC3812334204: Hold'em No Limit ($0.02/$0.05) - 2025/08/16 22:41:37
Table 'RushAndCash1059464' 6-max Seat #1 is the button
Seat 1: 43ae25b4 ($6.41 in chips)
Seat 2: Hero ($3.91 in chips)
Seat 3: b0432c89 ($6.32 in chips)
Seat 4: a4c0e017 ($18.64 in chips)
Seat 5: 1fe02a24 ($7.69 in chips)
Seat 6: e96405cf ($11.69 in chips)
Hero: posts small blind $0.02
b0432c89: posts big blind $0.05
*** HOLE CARDS ***
Dealt to 43ae25b4 
Dealt to Hero [As Jc]
Dealt to b0432c89 
Dealt to a4c0e017 
Dealt to 1fe02a24 
Dealt to e96405cf 
a4c0e017: folds
1fe02a24: folds
e96405cf: folds
43ae25b4: folds
Hero: calls $0.03
b0432c89: checks
*** FLOP *** [Ts Kd 6c]
Hero: bets $0.05
b0432c89: folds
Uncalled bet ($0.05) returned to Hero
*** SHOWDOWN ***
Hero collected $0.1 from pot
*** SUMMARY ***
Total pot $0.1 | Rake $0 | Jackpot $0 | Bingo $0 | Fortune $0 | Tax $0
Board [Ts Kd 6c]
Seat 1: 43ae25b4 (button) folded before Flop (didn't bet)
Seat 2: Hero (small blind) won ($0.1)
Seat 3: b0432c89 (big blind) folded on the Flop
Seat 4: a4c0e017 folded before Flop (didn't bet)
Seat 5: 1fe02a24 folded before Flop (didn't bet)
Seat 6: e96405cf folded before Flop (didn't bet)


Poker Hand #RC3812333842: Hold'em No Limit ($0.02/$0.05) - 2025/08/16 22:40:48
Table 'RushAndCash1059102' 6-max Seat #1 is the button
Seat 1: Hero ($3.43 in chips)
Seat 2: 5955ac5e ($6.19 in chips)
Seat 3: 250edbf5 ($5 in chips)
Seat 4: e8f3d79 ($5.62 in chips)
Seat 5: 65a6162b ($5.15 in chips)
Seat 6: 2b54e7a1 ($6.59 in chips)
5955ac5e: posts small blind $0.02
250edbf5: posts big blind $0.05
*** HOLE CARDS ***
Dealt to Hero [7c 5c]
Dealt to 5955ac5e 
Dealt to 250edbf5 
Dealt to e8f3d79 
Dealt to 65a6162b 
Dealt to 2b54e7a1 
e8f3d79: folds
65a6162b: folds
2b54e7a1: raises $0.06 to $0.11
Hero: calls $0.11
5955ac5e: folds
250edbf5: folds
*** FLOP *** [Qh 5d 8d]
2b54e7a1: bets $0.1
Hero: calls $0.1
*** TURN *** [Qh 5d 8d] [7d]
2b54e7a1: checks
Hero: bets $0.24
2b54e7a1: calls $0.24
*** RIVER *** [Qh 5d 8d 7d] [6h]
2b54e7a1: checks
Hero: checks
2b54e7a1: shows [Jc Jd] (a pair of Jacks)
Hero: shows [7c 5c] (two pair, Sevens and Fives)
*** SHOWDOWN ***
Hero collected $0.93 from pot
*** SUMMARY ***
Total pot $0.97 | Rake $0.04 | Jackpot $0 | Bingo $0 | Fortune $0 | Tax $0
Board [Qh 5d 8d 7d 6h]
Seat 1: Hero (button) showed [7c 5c] and won ($0.93) with two pair, Sevens and Fives
Seat 2: 5955ac5e (small blind) folded before Flop
Seat 3: 250edbf5 (big blind) folded before Flop
Seat 4: e8f3d79 folded before Flop (didn't bet)
Seat 5: 65a6162b folded before Flop (didn't bet)
Seat 6: 2b54e7a1 showed [Jc Jd] and lost with a pair of Jacks


Poker Hand #RC3812333658: Hold'em No Limit ($0.02/$0.05) - 2025/08/16 22:40:25
Table 'RushAndCash1058918' 6-max Seat #1 is the button
Seat 1: 25a26eba ($3.37 in chips)
Seat 2: 33f3a84f ($5.07 in chips)
Seat 3: Hero ($3.48 in chips)
Seat 4: 460fdae8 ($5.23 in chips)
Seat 5: a7b4ec8e ($5 in chips)
Seat 6: c9717df4 ($11.28 in chips)
33f3a84f: posts small blind $0.02
Hero: posts big blind $0.05
*** HOLE CARDS ***
Dealt to 25a26eba 
Dealt to 33f3a84f 
Dealt to Hero [8h Qs]
Dealt to 460fdae8 
Dealt to a7b4ec8e 
Dealt to c9717df4 
460fdae8: folds
a7b4ec8e: folds
c9717df4: folds
25a26eba: raises $0.1 to $0.15
33f3a84f: folds
Hero: folds
Uncalled bet ($0.1) returned to 25a26eba
*** SHOWDOWN ***
25a26eba collected $0.12 from pot
*** SUMMARY ***
Total pot $0.12 | Rake $0 | Jackpot $0 | Bingo $0 | Fortune $0 | Tax $0
Seat 1: 25a26eba (button) collected ($0.12)
Seat 2: 33f3a84f (small blind) folded before Flop
Seat 3: Hero (big blind) folded before Flop
Seat 4: 460fdae8 folded before Flop (didn't bet)
Seat 5: a7b4ec8e folded before Flop (didn't bet)
Seat 6: c9717df4 folded before Flop (didn't bet)


Poker Hand #RC3812333632: Hold'em No Limit ($0.02/$0.05) - 2025/08/16 22:40:21
Table 'RushAndCash1058892' 6-max Seat #1 is the button
Seat 1: 7278ff9d ($4.57 in chips)
Seat 2: c9717df4 ($11.3 in chips)
Seat 3: 7a4e8517 ($6.42 in chips)
Seat 4: Hero ($3.48 in chips)
Seat 5: b25db61b ($11.51 in chips)
Seat 6: 62d582f7 ($4.8 in chips)
c9717df4: posts small blind $0.02
7a4e8517: posts big blind $0.05
*** HOLE CARDS ***
Dealt to 7278ff9d 
Dealt to c9717df4 
Dealt to 7a4e8517 
Dealt to Hero [8d 9c]
Dealt to b25db61b 
Dealt to 62d582f7 
Hero: folds
b25db61b: folds
62d582f7: folds
7278ff9d: raises $0.07 to $0.12
c9717df4: folds
7a4e8517: folds
Uncalled bet ($0.07) returned to 7278ff9d
*** SHOWDOWN ***
7278ff9d collected $0.12 from pot
*** SUMMARY ***
Total pot $0.12 | Rake $0 | Jackpot $0 | Bingo $0 | Fortune $0 | Tax $0
Seat 1: 7278ff9d (button) collected ($0.12)
Seat 2: c9717df4 (small blind) folded before Flop
Seat 3: 7a4e8517 (big blind) folded before Flop
Seat 4: Hero folded before Flop (didn't bet)
Seat 5: b25db61b folded before Flop (didn't bet)
Seat 6: 62d582f7 folded before Flop (didn't bet)


Poker Hand #RC3812333606: Hold'em No Limit ($0.02/$0.05) - 2025/08/16 22:40:18
Table 'RushAndCash1058866' 6-max Seat #1 is the button
Seat 1: e02de91a ($5 in chips)
Seat 2: 15d2b261 ($5.46 in chips)
Seat 3: a8308aa6 ($12.56 in chips)
Seat 4: Hero ($3.48 in chips)
Seat 5: 8f7907e6 ($6.45 in chips)
Seat 6: 7278ff9d ($4.57 in chips)
15d2b261: posts small blind $0.02
a8308aa6: posts big blind $0.05
*** HOLE CARDS ***
Dealt to e02de91a 
Dealt to 15d2b261 
Dealt to a8308aa6 
Dealt to Hero [Qh 5c]
Dealt to 8f7907e6 
Dealt to 7278ff9d 
Hero: folds
8f7907e6: folds
7278ff9d: folds
e02de91a: folds
15d2b261: folds
Uncalled bet ($0.03) returned to a8308aa6
*** SHOWDOWN ***
a8308aa6 collected $0.04 from pot
*** SUMMARY ***
Total pot $0.04 | Rake $0 | Jackpot $0 | Bingo $0 | Fortune $0 | Tax $0
Seat 1: e02de91a (button) folded before Flop (didn't bet)
Seat 2: 15d2b261 (small blind) folded before Flop
Seat 3: a8308aa6 (big blind) collected ($0.04)
Seat 4: Hero folded before Flop (didn't bet)
Seat 5: 8f7907e6 folded before Flop (didn't bet)
Seat 6: 7278ff9d folded before Flop (didn't bet)


Poker Hand #RC3812333577: Hold'em No Limit ($0.02/$0.05) - 2025/08/16 22:40:14
Table 'RushAndCash1058837' 6-max Seat #1 is the button
Seat 1: 5e386847 ($6.36 in chips)
Seat 2: 603f89e1 ($5 in chips)
Seat 3: 8237129d ($8.24 in chips)
Seat 4: 1319708a ($16.02 in chips)
Seat 5: Hero ($3.48 in chips)
Seat 6: d171b62f ($6.18 in chips)
603f89e1: posts small blind $0.02
8237129d: posts big blind $0.05
*** HOLE CARDS ***
Dealt to 5e386847 
Dealt to 603f89e1 
Dealt to 8237129d 
Dealt to 1319708a 
Dealt to Hero [6c Kc]
Dealt to d171b62f 
1319708a: folds
Hero: folds
d171b62f: folds
5e386847: raises $0.05 to $0.1
603f89e1: folds
8237129d: calls $0.05
*** FLOP *** [3d 9d 4s]
8237129d: checks
5e386847: checks
*** TURN *** [3d 9d 4s] [Td]
8237129d: bets $0.17
5e386847: folds
Uncalled bet ($0.17) returned to 8237129d
*** SHOWDOWN ***
8237129d collected $0.21 from pot
*** SUMMARY ***
Total pot $0.22 | Rake $0.01 | Jackpot $0 | Bingo $0 | Fortune $0 | Tax $0
Board [3d 9d 4s Td]
Seat 1: 5e386847 (button) folded on the Turn
Seat 2: 603f89e1 (small blind) folded before Flop
Seat 3: 8237129d (big blind) won ($0.21)
Seat 4: 1319708a folded before Flop (didn't bet)
Seat 5: Hero folded before Flop (didn't bet)
Seat 6: d171b62f folded before Flop (didn't bet)


Poker Hand #RC3812333285: Hold'em No Limit ($0.02/$0.05) - 2025/08/16 22:39:39
Table 'RushAndCash1058545' 6-max Seat #1 is the button
Seat 1: e347d4ad ($5.67 in chips)
Seat 2: Hero ($3.43 in chips)
Seat 3: 82170b33 ($18.2 in chips)
Seat 4: 928b26d0 ($8.87 in chips)
Seat 5: 84afc5c7 ($4.64 in chips)
Seat 6: d85a7e29 ($25.09 in chips)
Hero: posts small blind $0.02
82170b33: posts big blind $0.05
*** HOLE CARDS ***
Dealt to e347d4ad 
Dealt to Hero [Kc Td]
Dealt to 82170b33 
Dealt to 928b26d0 
Dealt to 84afc5c7 
Dealt to d85a7e29 
928b26d0: folds
84afc5c7: folds
d85a7e29: folds
e347d4ad: folds
Hero: calls $0.03
82170b33: checks
*** FLOP *** [9c Qh 6s]
Hero: checks
82170b33: checks
*** TURN *** [9c Qh 6s] [5d]
Hero: checks
82170b33: checks
*** RIVER *** [9c Qh 6s 5d] [6c]
Hero: checks
82170b33: checks
Hero: shows [Kc Td] (a pair of Sixes)
82170b33: shows [4h Tc] (a pair of Sixes)
*** SHOWDOWN ***
Hero collected $0.1 from pot
*** SUMMARY ***
Total pot $0.1 | Rake $0 | Jackpot $0 | Bingo $0 | Fortune $0 | Tax $0
Board [9c Qh 6s 5d 6c]
Seat 1: e347d4ad (button) folded before Flop (didn't bet)
Seat 2: Hero (small blind) showed [Kc Td] and won ($0.1) with a pair of Sixes
Seat 3: 82170b33 (big blind) showed [4h Tc] and lost with a pair of Sixes
Seat 4: 928b26d0 folded before Flop (didn't bet)
Seat 5: 84afc5c7 folded before Flop (didn't bet)
Seat 6: d85a7e29 folded before Flop (didn't bet)


Poker Hand #RC3812333163: Hold'em No Limit ($0.02/$0.05) - 2025/08/16 22:39:23
Table 'RushAndCash1058423' 6-max Seat #1 is the button
Seat 1: 2a385857 ($5.17 in chips)
Seat 2: 7691efea ($6.37 in chips)
Seat 3: Hero ($3.41 in chips)
Seat 4: e347d4ad ($5.65 in chips)
Seat 5: 36541f05 ($11.48 in chips)
Seat 6: 33236916 ($9.98 in chips)
7691efea: posts small blind $0.02
Hero: posts big blind $0.05
*** HOLE CARDS ***
Dealt to 2a385857 
Dealt to 7691efea 
Dealt to Hero [5s Ah]
Dealt to e347d4ad 
Dealt to 36541f05 
Dealt to 33236916 
e347d4ad: folds
36541f05: folds
33236916: folds
2a385857: folds
7691efea: folds
Uncalled bet ($0.03) returned to Hero
*** SHOWDOWN ***
Hero collected $0.04 from pot
*** SUMMARY ***
Total pot $0.04 | Rake $0 | Jackpot $0 | Bingo $0 | Fortune $0 | Tax $0
Seat 1: 2a385857 (button) folded before Flop (didn't bet)
Seat 2: 7691efea (small blind) folded before Flop
Seat 3: Hero (big blind) collected ($0.04)
Seat 4: e347d4ad folded before Flop (didn't bet)
Seat 5: 36541f05 folded before Flop (didn't bet)
Seat 6: 33236916 folded before Flop (didn't bet)


Poker Hand #RC3812333137: Hold'em No Limit ($0.02/$0.05) - 2025/08/16 22:39:19
Table 'RushAndCash1058397' 6-max Seat #1 is the button
Seat 1: ee5ad467 ($6.89 in chips)
Seat 2: 6e48b49c ($12.23 in chips)
Seat 3: 57fcf0b ($4.63 in chips)
Seat 4: Hero ($3.41 in chips)
Seat 5: b75bcd72 ($4.87 in chips)
Seat 6: 36541f05 ($11.48 in chips)
6e48b49c: posts small blind $0.02
57fcf0b: posts big blind $0.05
*** HOLE CARDS ***
Dealt to ee5ad467 
Dealt to 6e48b49c 
Dealt to 57fcf0b 
Dealt to Hero [2s 4d]
Dealt to b75bcd72 
Dealt to 36541f05 
Hero: folds
b75bcd72: folds
36541f05: folds
ee5ad467: folds
6e48b49c: raises $0.1 to $0.15
57fcf0b: calls $0.1
*** FLOP *** [9h Kh 4h]
6e48b49c: bets $0.1
57fcf0b: calls $0.1
*** TURN *** [9h Kh 4h] [Qd]
6e48b49c: checks
57fcf0b: bets $0.25
6e48b49c: folds
Uncalled bet ($0.25) returned to 57fcf0b
*** SHOWDOWN ***
57fcf0b collected $0.48 from pot
*** SUMMARY ***
Total pot $0.5 | Rake $0.02 | Jackpot $0 | Bingo $0 | Fortune $0 | Tax $0
Board [9h Kh 4h Qd]
Seat 1: ee5ad467 (button) folded before Flop (didn't bet)
Seat 2: 6e48b49c (small blind) folded on the Turn
Seat 3: 57fcf0b (big blind) showed [6s 6d] and won ($0.48)
Seat 4: Hero folded before Flop (didn't bet)
Seat 5: b75bcd72 folded before Flop (didn't bet)
Seat 6: 36541f05 folded before Flop (didn't bet)


Poker Hand #RC3812333090: Hold'em No Limit ($0.02/$0.05) - 2025/08/16 22:39:13
Table 'RushAndCash1058350' 6-max Seat #1 is the button
Seat 1: Hero ($3.41 in chips)
Seat 2: 17d650ae ($5.78 in chips)
Seat 3: f0f0bd8 ($5.89 in chips)
Seat 4: 9e3020e8 ($8.2 in chips)
Seat 5: 9abd5c5a ($5.22 in chips)
Seat 6: a0ee51e3 ($5.07 in chips)
17d650ae: posts small blind $0.02
f0f0bd8: posts big blind $0.05
*** HOLE CARDS ***
Dealt to Hero [4d 8c]
Dealt to 17d650ae 
Dealt to f0f0bd8 
Dealt to 9e3020e8 
Dealt to 9abd5c5a 
Dealt to a0ee51e3 
9e3020e8: folds
9abd5c5a: folds
a0ee51e3: folds
Hero: folds
17d650ae: folds
Uncalled bet ($0.03) returned to f0f0bd8
*** SHOWDOWN ***
f0f0bd8 collected $0.04 from pot
*** SUMMARY ***
Total pot $0.04 | Rake $0 | Jackpot $0 | Bingo $0 | Fortune $0 | Tax $0
Seat 1: Hero (button) folded before Flop (didn't bet)
Seat 2: 17d650ae (small blind) folded before Flop
Seat 3: f0f0bd8 (big blind) collected ($0.04)
Seat 4: 9e3020e8 folded before Flop (didn't bet)
Seat 5: 9abd5c5a folded before Flop (didn't bet)
Seat 6: a0ee51e3 folded before Flop (didn't bet)


Poker Hand #RC3812333067: Hold'em No Limit ($0.02/$0.05) - 2025/08/16 22:39:09
Table 'RushAndCash1058327' 6-max Seat #1 is the button
Seat 1: e937107e ($5.84 in chips)
Seat 2: 5917f0c8 ($5 in chips)
Seat 3: 51218a42 ($5.14 in chips)
Seat 4: 73f8c93c ($6.93 in chips)
Seat 5: daa7740e ($7.45 in chips)
Seat 6: Hero ($3.41 in chips)
5917f0c8: posts small blind $0.02
51218a42: posts big blind $0.05
*** HOLE CARDS ***
Dealt to e937107e 
Dealt to 5917f0c8 
Dealt to 51218a42 
Dealt to 73f8c93c 
Dealt to daa7740e 
Dealt to Hero [4c 4d]
73f8c93c: folds
daa7740e: folds
Hero: folds
e937107e: folds
5917f0c8: folds
Uncalled bet ($0.03) returned to 51218a42
*** SHOWDOWN ***
51218a42 collected $0.04 from pot
*** SUMMARY ***
Total pot $0.04 | Rake $0 | Jackpot $0 | Bingo $0 | Fortune $0 | Tax $0
Seat 1: e937107e (button) folded before Flop (didn't bet)
Seat 2: 5917f0c8 (small blind) folded before Flop
Seat 3: 51218a42 (big blind) collected ($0.04)
Seat 4: 73f8c93c folded before Flop (didn't bet)
Seat 5: daa7740e folded before Flop (didn't bet)
Seat 6: Hero folded before Flop (didn't bet)


Poker Hand #RC3812333038: Hold'em No Limit ($0.02/$0.05) - 2025/08/16 22:39:06
Table 'RushAndCash1058298' 6-max Seat #1 is the button
Seat 1: c9696527 ($5.13 in chips)
Seat 2: c8bdfb6 ($5.97 in chips)
Seat 3: 5f1dba5d ($2.87 in chips)
Seat 4: Hero ($3.41 in chips)
Seat 5: fd554d30 ($6.46 in chips)
Seat 6: b40689b1 ($5 in chips)
c8bdfb6: posts small blind $0.02
5f1dba5d: posts big blind $0.05
*** HOLE CARDS ***
Dealt to c9696527 
Dealt to c8bdfb6 
Dealt to 5f1dba5d 
Dealt to Hero [8s Kh]
Dealt to fd554d30 
Dealt to b40689b1 
Hero: folds
fd554d30: folds
b40689b1: folds
c9696527: folds
c8bdfb6: folds
Uncalled bet ($0.03) returned to 5f1dba5d
*** SHOWDOWN ***
5f1dba5d collected $0.04 from pot
*** SUMMARY ***
Total pot $0.04 | Rake $0 | Jackpot $0 | Bingo $0 | Fortune $0 | Tax $0
Seat 1: c9696527 (button) folded before Flop (didn't bet)
Seat 2: c8bdfb6 (small blind) folded before Flop
Seat 3: 5f1dba5d (big blind) collected ($0.04)
Seat 4: Hero folded before Flop (didn't bet)
Seat 5: fd554d30 folded before Flop (didn't bet)
Seat 6: b40689b1 folded before Flop (didn't bet)


Poker Hand #RC3812332959: Hold'em No Limit ($0.02/$0.05) - 2025/08/16 22:38:55
Table 'RushAndCash1058219' 6-max Seat #1 is the button
Seat 1: a1bea61b ($4.26 in chips)
Seat 2: Hero ($3.43 in chips)
Seat 3: b75bcd72 ($4.94 in chips)
Seat 4: deb1c487 ($7.11 in chips)
Seat 5: 3ed9d1f1 ($11.57 in chips)
Seat 6: a78395fa ($5.04 in chips)
Hero: posts small blind $0.02
b75bcd72: posts big blind $0.05
*** HOLE CARDS ***
Dealt to a1bea61b 
Dealt to Hero [3s Jc]
Dealt to b75bcd72 
Dealt to deb1c487 
Dealt to 3ed9d1f1 
Dealt to a78395fa 
deb1c487: folds
3ed9d1f1: folds
a78395fa: raises $0.05 to $0.1
a1bea61b: raises $0.27 to $0.37
Hero: folds
b75bcd72: folds
a78395fa: calls $0.27
*** FLOP *** [8d 8c 4d]
a78395fa: checks
a1bea61b: bets $0.41
a78395fa: calls $0.41
*** TURN *** [8d 8c 4d] [5c]
a78395fa: checks
a1bea61b: checks
*** RIVER *** [8d 8c 4d 5c] [Qs]
a78395fa: checks
a1bea61b: checks
a78395fa: shows [7h 7c] (two pair, Eights and Sevens)
a1bea61b: shows [Ad Ks] (a pair of Eights)
*** SHOWDOWN ***
a78395fa collected $1.49 from pot
*** SUMMARY ***
Total pot $1.63 | Rake $0.07 | Jackpot $0.07 | Bingo $0 | Fortune $0 | Tax $0
Board [8d 8c 4d 5c Qs]
Seat 1: a1bea61b (button) showed [Ad Ks] and lost with a pair of Eights
Seat 2: Hero (small blind) folded before Flop
Seat 3: b75bcd72 (big blind) folded before Flop
Seat 4: deb1c487 folded before Flop (didn't bet)
Seat 5: 3ed9d1f1 folded before Flop (didn't bet)
Seat 6: a78395fa showed [7h 7c] and won ($1.49) with two pair, Eights and Sevens


Poker Hand #RC3812332493: Hold'em No Limit ($0.02/$0.05) - 2025/08/16 22:37:54
Table 'RushAndCash1057753' 6-max Seat #1 is the button
Seat 1: Hero ($3.09 in chips)
Seat 2: a1bea61b ($4.44 in chips)
Seat 3: f6838f11 ($6.68 in chips)
Seat 4: e347d4ad ($5.6 in chips)
Seat 5: b75bcd72 ($5.07 in chips)
Seat 6: 61130a0f ($5.14 in chips)
a1bea61b: posts small blind $0.02
f6838f11: posts big blind $0.05
*** HOLE CARDS ***
Dealt to Hero [Js 9s]
Dealt to a1bea61b 
Dealt to f6838f11 
Dealt to e347d4ad 
Dealt to b75bcd72 
Dealt to 61130a0f 
e347d4ad: folds
b75bcd72: raises $0.08 to $0.13
61130a0f: folds
Hero: calls $0.13
a1bea61b: calls $0.11
f6838f11: folds
*** FLOP *** [6c Td 9d]
a1bea61b: checks
b75bcd72: checks
Hero: bets $0.05
a1bea61b: calls $0.05
b75bcd72: folds
*** TURN *** [6c Td 9d] [Ah]
a1bea61b: checks
Hero: bets $0.08
a1bea61b: folds
Uncalled bet ($0.08) returned to Hero
*** SHOWDOWN ***
Hero collected $0.52 from pot
*** SUMMARY ***
Total pot $0.54 | Rake $0.02 | Jackpot $0 | Bingo $0 | Fortune $0 | Tax $0
Board [6c Td 9d Ah]
Seat 1: Hero (button) won ($0.52)
Seat 2: a1bea61b (small blind) folded on the Turn
Seat 3: f6838f11 (big blind) folded before Flop
Seat 4: e347d4ad folded before Flop (didn't bet)
Seat 5: b75bcd72 folded on the Flop
Seat 6: 61130a0f folded before Flop (didn't bet)


Poker Hand #RC3812332248: Hold'em No Limit ($0.02/$0.05) - 2025/08/16 22:37:21
Table 'RushAndCash1057508' 6-max Seat #1 is the button
Seat 1: ba22a17d ($6.45 in chips)
Seat 2: a11b42a0 ($6.83 in chips)
Seat 3: Hero ($3.14 in chips)
Seat 4: f0f0bd8 ($5.22 in chips)
Seat 5: b3b2dd05 ($7.4 in chips)
Seat 6: b177b7b4 ($5.52 in chips)
a11b42a0: posts small blind $0.02
Hero: posts big blind $0.05
*** HOLE CARDS ***
Dealt to ba22a17d 
Dealt to a11b42a0 
Dealt to Hero [Ah 2h]
Dealt to f0f0bd8 
Dealt to b3b2dd05 
Dealt to b177b7b4 
f0f0bd8: folds
b3b2dd05: folds
b177b7b4: folds
ba22a17d: folds
a11b42a0: raises $0.1 to $0.15
Hero: folds
Uncalled bet ($0.1) returned to a11b42a0
*** SHOWDOWN ***
a11b42a0 collected $0.1 from pot
*** SUMMARY ***
Total pot $0.1 | Rake $0 | Jackpot $0 | Bingo $0 | Fortune $0 | Tax $0
Seat 1: ba22a17d (button) folded before Flop (didn't bet)
Seat 2: a11b42a0 (small blind) collected ($0.1)
Seat 3: Hero (big blind) folded before Flop
Seat 4: f0f0bd8 folded before Flop (didn't bet)
Seat 5: b3b2dd05 folded before Flop (didn't bet)
Seat 6: b177b7b4 folded before Flop (didn't bet)


Poker Hand #RC3812332199: Hold'em No Limit ($0.02/$0.05) - 2025/08/16 22:37:14
Table 'RushAndCash1057459' 6-max Seat #1 is the button
Seat 1: 44245980 ($5.3 in chips)
Seat 2: 661aa2d3 ($8.21 in chips)
Seat 3: 3c699ea2 ($5.03 in chips)
Seat 4: Hero ($3.14 in chips)
Seat 5: 8cfdd388 ($5.03 in chips)
Seat 6: 3414e94a ($11.55 in chips)
661aa2d3: posts small blind $0.02
3c699ea2: posts big blind $0.05
*** HOLE CARDS ***
Dealt to 44245980 
Dealt to 661aa2d3 
Dealt to 3c699ea2 
Dealt to Hero [2h Ah]
Dealt to 8cfdd388 
Dealt to 3414e94a 
Hero: folds
8cfdd388: folds
3414e94a: folds
44245980: folds
661aa2d3: folds
Uncalled bet ($0.03) returned to 3c699ea2
*** SHOWDOWN ***
3c699ea2 collected $0.04 from pot
*** SUMMARY ***
Total pot $0.04 | Rake $0 | Jackpot $0 | Bingo $0 | Fortune $0 | Tax $0
Seat 1: 44245980 (button) folded before Flop (didn't bet)
Seat 2: 661aa2d3 (small blind) folded before Flop
Seat 3: 3c699ea2 (big blind) collected ($0.04)
Seat 4: Hero folded before Flop (didn't bet)
Seat 5: 8cfdd388 folded before Flop (didn't bet)
Seat 6: 3414e94a folded before Flop (didn't bet)


Poker Hand #RC3812332171: Hold'em No Limit ($0.02/$0.05) - 2025/08/16 22:37:11
Table 'RushAndCash1057431' 6-max Seat #1 is the button
Seat 1: fbfae31e ($5.19 in chips)
Seat 2: ef98be50 ($5.25 in chips)
Seat 3: 7e90ec14 ($7.43 in chips)
Seat 4: 82006be9 ($5 in chips)
Seat 5: b438a131 ($6.01 in chips)
Seat 6: Hero ($3.14 in chips)
ef98be50: posts small blind $0.02
7e90ec14: posts big blind $0.05
*** HOLE CARDS ***
Dealt to fbfae31e 
Dealt to ef98be50 
Dealt to 7e90ec14 
Dealt to 82006be9 
Dealt to b438a131 
Dealt to Hero [3h Jc]
82006be9: folds
b438a131: folds
Hero: folds
fbfae31e: folds
ef98be50: raises $0.1 to $0.15
7e90ec14: calls $0.1
*** FLOP *** [5d 5s Kd]
ef98be50: checks
7e90ec14: checks
*** TURN *** [5d 5s Kd] [4s]
ef98be50: bets $0.15
7e90ec14: folds
Uncalled bet ($0.15) returned to ef98be50
*** SHOWDOWN ***
ef98be50 collected $0.29 from pot
*** SUMMARY ***
Total pot $0.3 | Rake $0.01 | Jackpot $0 | Bingo $0 | Fortune $0 | Tax $0
Board [5d 5s Kd 4s]
Seat 1: fbfae31e (button) folded before Flop (didn't bet)
Seat 2: ef98be50 (small blind) won ($0.29)
Seat 3: 7e90ec14 (big blind) folded on the Turn
Seat 4: 82006be9 folded before Flop (didn't bet)
Seat 5: b438a131 folded before Flop (didn't bet)
Seat 6: Hero folded before Flop (didn't bet)


Poker Hand #RC3812332138: Hold'em No Limit ($0.02/$0.05) - 2025/08/16 22:37:07
Table 'RushAndCash1057398' 6-max Seat #1 is the button
Seat 1: b40689b1 ($5.07 in chips)
Seat 2: fbfae31e ($5.21 in chips)
Seat 3: 75462e35 ($11.73 in chips)
Seat 4: 215a37ea ($5 in chips)
Seat 5: Hero ($3.14 in chips)
Seat 6: 1656660f ($5 in chips)
fbfae31e: posts small blind $0.02
75462e35: posts big blind $0.05
*** HOLE CARDS ***
Dealt to b40689b1 
Dealt to fbfae31e 
Dealt to 75462e35 
Dealt to 215a37ea 
Dealt to Hero [8d 7c]
Dealt to 1656660f 
215a37ea: folds
Hero: folds
1656660f: raises $0.07 to $0.12
b40689b1: folds
fbfae31e: folds
75462e35: folds
Uncalled bet ($0.07) returned to 1656660f
*** SHOWDOWN ***
1656660f collected $0.12 from pot
*** SUMMARY ***
Total pot $0.12 | Rake $0 | Jackpot $0 | Bingo $0 | Fortune $0 | Tax $0
Seat 1: b40689b1 (button) folded before Flop (didn't bet)
Seat 2: fbfae31e (small blind) folded before Flop
Seat 3: 75462e35 (big blind) folded before Flop
Seat 4: 215a37ea folded before Flop (didn't bet)
Seat 5: Hero folded before Flop (didn't bet)
Seat 6: 1656660f collected ($0.12)


Poker Hand #RC3812332091: Hold'em No Limit ($0.02/$0.05) - 2025/08/16 22:37:00
Table 'RushAndCash1057351' 6-max Seat #1 is the button
Seat 1: Hero ($3.14 in chips)
Seat 2: 15d2b261 ($5 in chips)
Seat 3: cf396bf7 ($10.19 in chips)
Seat 4: 1c739e90 ($6.46 in chips)
Seat 5: 2b54e7a1 ($6.32 in chips)
Seat 6: 5dbcbc29 ($5 in chips)
15d2b261: posts small blind $0.02
cf396bf7: posts big blind $0.05
*** HOLE CARDS ***
Dealt to Hero [4c Ts]
Dealt to 15d2b261 
Dealt to cf396bf7 
Dealt to 1c739e90 
Dealt to 2b54e7a1 
Dealt to 5dbcbc29 
1c739e90: folds
2b54e7a1: folds
5dbcbc29: folds
Hero: folds
15d2b261: folds
Uncalled bet ($0.03) returned to cf396bf7
*** SHOWDOWN ***
cf396bf7 collected $0.04 from pot
*** SUMMARY ***
Total pot $0.04 | Rake $0 | Jackpot $0 | Bingo $0 | Fortune $0 | Tax $0
Seat 1: Hero (button) folded before Flop (didn't bet)
Seat 2: 15d2b261 (small blind) folded before Flop
Seat 3: cf396bf7 (big blind) collected ($0.04)
Seat 4: 1c739e90 folded before Flop (didn't bet)
Seat 5: 2b54e7a1 folded before Flop (didn't bet)
Seat 6: 5dbcbc29 folded before Flop (didn't bet)


Poker Hand #RC3812331662: Hold'em No Limit ($0.02/$0.05) - 2025/08/16 22:36:02
Table 'RushAndCash1056922' 6-max Seat #1 is the button
Seat 1: 8f1d6b23 ($5.45 in chips)
Seat 2: Hero ($3.16 in chips)
Seat 3: 4cf59b27 ($7.11 in chips)
Seat 4: e9537cbb ($8.8 in chips)
Seat 5: 4c612f15 ($14.72 in chips)
Seat 6: a8308aa6 ($12.32 in chips)
Hero: posts small blind $0.02
4cf59b27: posts big blind $0.05
*** HOLE CARDS ***
Dealt to 8f1d6b23 
Dealt to Hero [2s Ts]
Dealt to 4cf59b27 
Dealt to e9537cbb 
Dealt to 4c612f15 
Dealt to a8308aa6 
e9537cbb: folds
4c612f15: folds
a8308aa6: folds
8f1d6b23: raises $0.08 to $0.13
Hero: folds
4cf59b27: folds
Uncalled bet ($0.08) returned to 8f1d6b23
*** SHOWDOWN ***
8f1d6b23 collected $0.12 from pot
*** SUMMARY ***
Total pot $0.12 | Rake $0 | Jackpot $0 | Bingo $0 | Fortune $0 | Tax $0
Seat 1: 8f1d6b23 (button) collected ($0.12)
Seat 2: Hero (small blind) folded before Flop
Seat 3: 4cf59b27 (big blind) folded before Flop
Seat 4: e9537cbb folded before Flop (didn't bet)
Seat 5: 4c612f15 folded before Flop (didn't bet)
Seat 6: a8308aa6 folded before Flop (didn't bet)


Poker Hand #RC3812331615: Hold'em No Limit ($0.02/$0.05) - 2025/08/16 22:35:56
Table 'RushAndCash1056875' 6-max Seat #1 is the button
Seat 1: fed1995e ($7.61 in chips)
Seat 2: 60d16038 ($5.19 in chips)
Seat 3: Hero ($3.21 in chips)
Seat 4: 6da80c37 ($2.77 in chips)
Seat 5: 7a9715ba ($5.51 in chips)
Seat 6: e7aec4da ($5.8 in chips)
60d16038: posts small blind $0.02
Hero: posts big blind $0.05
*** HOLE CARDS ***
Dealt to fed1995e 
Dealt to 60d16038 
Dealt to Hero [Ac Jd]
Dealt to 6da80c37 
Dealt to 7a9715ba 
Dealt to e7aec4da 
6da80c37: folds
7a9715ba: folds
e7aec4da: folds
fed1995e: folds
60d16038: raises $0.07 to $0.12
Hero: folds
Uncalled bet ($0.07) returned to 60d16038
*** SHOWDOWN ***
60d16038 collected $0.1 from pot
*** SUMMARY ***
Total pot $0.1 | Rake $0 | Jackpot $0 | Bingo $0 | Fortune $0 | Tax $0
Seat 1: fed1995e (button) folded before Flop (didn't bet)
Seat 2: 60d16038 (small blind) collected ($0.1)
Seat 3: Hero (big blind) folded before Flop
Seat 4: 6da80c37 folded before Flop (didn't bet)
Seat 5: 7a9715ba folded before Flop (didn't bet)
Seat 6: e7aec4da folded before Flop (didn't bet)


Poker Hand #RC3812331592: Hold'em No Limit ($0.02/$0.05) - 2025/08/16 22:35:52
Table 'RushAndCash1056852' 6-max Seat #1 is the button
Seat 1: e347d4ad ($6.43 in chips)
Seat 2: 659e76bd ($6.05 in chips)
Seat 3: 86e97b9e ($5 in chips)
Seat 4: a6b70ec7 ($5.16 in chips)
Seat 5: Hero ($3.21 in chips)
Seat 6: 4878e795 ($5 in chips)
659e76bd: posts small blind $0.02
86e97b9e: posts big blind $0.05
*** HOLE CARDS ***
Dealt to e347d4ad 
Dealt to 659e76bd 
Dealt to 86e97b9e 
Dealt to a6b70ec7 
Dealt to Hero [4d Th]
Dealt to 4878e795 
a6b70ec7: raises $0.05 to $0.1
Hero: folds
4878e795: folds
e347d4ad: folds
659e76bd: calls $0.08
86e97b9e: folds
*** FLOP *** [7s 9s 4c]
659e76bd: checks
a6b70ec7: bets $0.09
659e76bd: calls $0.09
*** TURN *** [7s 9s 4c] [Td]
659e76bd: checks
a6b70ec7: bets $0.22
659e76bd: folds
Uncalled bet ($0.22) returned to a6b70ec7
*** SHOWDOWN ***
a6b70ec7 collected $0.41 from pot
*** SUMMARY ***
Total pot $0.43 | Rake $0.02 | Jackpot $0 | Bingo $0 | Fortune $0 | Tax $0
Board [7s 9s 4c Td]
Seat 1: e347d4ad (button) folded before Flop (didn't bet)
Seat 2: 659e76bd (small blind) folded on the Turn
Seat 3: 86e97b9e (big blind) folded before Flop
Seat 4: a6b70ec7 won ($0.41)
Seat 5: Hero folded before Flop (didn't bet)
Seat 6: 4878e795 folded before Flop (didn't bet)


Poker Hand #RC3812331566: Hold'em No Limit ($0.02/$0.05) - 2025/08/16 22:35:49
Table 'RushAndCash1056826' 6-max Seat #1 is the button
Seat 1: 8f89befa ($5 in chips)
Seat 2: 9abd5c5a ($5 in chips)
Seat 3: bc28ebe8 ($7.12 in chips)
Seat 4: 10dff872 ($4.44 in chips)
Seat 5: Hero ($3.21 in chips)
Seat 6: e7aec4da ($5.8 in chips)
9abd5c5a: posts small blind $0.02
bc28ebe8: posts big blind $0.05
*** HOLE CARDS ***
Dealt to 8f89befa 
Dealt to 9abd5c5a 
Dealt to bc28ebe8 
Dealt to 10dff872 
Dealt to Hero [2s Ac]
Dealt to e7aec4da 
10dff872: folds
Hero: folds
e7aec4da: folds
8f89befa: folds
9abd5c5a: folds
Uncalled bet ($0.03) returned to bc28ebe8
*** SHOWDOWN ***
bc28ebe8 collected $0.04 from pot
*** SUMMARY ***
Total pot $0.04 | Rake $0 | Jackpot $0 | Bingo $0 | Fortune $0 | Tax $0
Seat 1: 8f89befa (button) folded before Flop (didn't bet)
Seat 2: 9abd5c5a (small blind) folded before Flop
Seat 3: bc28ebe8 (big blind) collected ($0.04)
Seat 4: 10dff872 folded before Flop (didn't bet)
Seat 5: Hero folded before Flop (didn't bet)
Seat 6: e7aec4da folded before Flop (didn't bet)


Poker Hand #RC3812331541: Hold'em No Limit ($0.02/$0.05) - 2025/08/16 22:35:45
Table 'RushAndCash1056801' 6-max Seat #1 is the button
Seat 1: 2b893e7f ($8.5 in chips)
Seat 2: 356b7f15 ($5.12 in chips)
Seat 3: 368bc7be ($5.68 in chips)
Seat 4: Hero ($3.21 in chips)
Seat 5: bc8d0f53 ($4.76 in chips)
Seat 6: a30ee948 ($8.2 in chips)
356b7f15: posts small blind $0.02
368bc7be: posts big blind $0.05
*** HOLE CARDS ***
Dealt to 2b893e7f 
Dealt to 356b7f15 
Dealt to 368bc7be 
Dealt to Hero [8h 2c]
Dealt to bc8d0f53 
Dealt to a30ee948 
Hero: folds
bc8d0f53: folds
a30ee948: folds
2b893e7f: folds
356b7f15: calls $0.03
368bc7be: checks
*** FLOP *** [2d Kd 7d]
356b7f15: bets $0.05
368bc7be: folds
Uncalled bet ($0.05) returned to 356b7f15
*** SHOWDOWN ***
356b7f15 collected $0.1 from pot
*** SUMMARY ***
Total pot $0.1 | Rake $0 | Jackpot $0 | Bingo $0 | Fortune $0 | Tax $0
Board [2d Kd 7d]
Seat 1: 2b893e7f (button) folded before Flop (didn't bet)
Seat 2: 356b7f15 (small blind) won ($0.1)
Seat 3: 368bc7be (big blind) folded on the Flop
Seat 4: Hero folded before Flop (didn't bet)
Seat 5: bc8d0f53 folded before Flop (didn't bet)
Seat 6: a30ee948 folded before Flop (didn't bet)


Poker Hand #RC3812331516: Hold'em No Limit ($0.02/$0.05) - 2025/08/16 22:35:42
Table 'RushAndCash1056776' 6-max Seat #1 is the button
Seat 1: 12a126bd ($5.26 in chips)
Seat 2: af0142ec ($6.13 in chips)
Seat 3: eb15c2e2 ($1.7 in chips)
Seat 4: Hero ($3.21 in chips)
Seat 5: 32856fe4 ($5.64 in chips)
Seat 6: 9abd5c5a ($5 in chips)
af0142ec: posts small blind $0.02
eb15c2e2: posts big blind $0.05
*** HOLE CARDS ***
Dealt to 12a126bd 
Dealt to af0142ec 
Dealt to eb15c2e2 
Dealt to Hero [7h 5d]
Dealt to 32856fe4 
Dealt to 9abd5c5a 
Hero: folds
32856fe4: folds
9abd5c5a: folds
12a126bd: raises $0.05 to $0.1
af0142ec: raises $0.31 to $0.41
eb15c2e2: folds
12a126bd: folds
Uncalled bet ($0.31) returned to af0142ec
*** SHOWDOWN ***
af0142ec collected $0.24 from pot
*** SUMMARY ***
Total pot $0.25 | Rake $0.01 | Jackpot $0 | Bingo $0 | Fortune $0 | Tax $0
Seat 1: 12a126bd (button) folded before Flop
Seat 2: af0142ec (small blind) collected ($0.24)
Seat 3: eb15c2e2 (big blind) folded before Flop
Seat 4: Hero folded before Flop (didn't bet)
Seat 5: 32856fe4 folded before Flop (didn't bet)
Seat 6: 9abd5c5a folded before Flop (didn't bet)


Poker Hand #RC3812331449: Hold'em No Limit ($0.02/$0.05) - 2025/08/16 22:35:32
Table 'RushAndCash1056709' 6-max Seat #1 is the button
Seat 1: Hero ($3.21 in chips)
Seat 2: ff02ba4e ($5.27 in chips)
Seat 3: 44245980 ($5.35 in chips)
Seat 4: d171b62f ($5.61 in chips)
Seat 5: 58542e99 ($13.51 in chips)
Seat 6: ab5cff07 ($13.85 in chips)
ff02ba4e: posts small blind $0.02
44245980: posts big blind $0.05
*** HOLE CARDS ***
Dealt to Hero [Ah 6s]
Dealt to ff02ba4e 
Dealt to 44245980 
Dealt to d171b62f 
Dealt to 58542e99 
Dealt to ab5cff07 
d171b62f: raises $0.05 to $0.1
58542e99: folds
ab5cff07: raises $0.22 to $0.32
Hero: folds
ff02ba4e: calls $0.3
44245980: folds
d171b62f: calls $0.22
*** FLOP *** [Jd Ac 5d]
ff02ba4e: checks
d171b62f: checks
ab5cff07: checks
*** TURN *** [Jd Ac 5d] [Ks]
ff02ba4e: checks
d171b62f: checks
ab5cff07: checks
*** RIVER *** [Jd Ac 5d Ks] [8h]
ff02ba4e: checks
d171b62f: checks
ab5cff07: checks
ff02ba4e: shows [Kd Qd] (a pair of Kings)
d171b62f: shows [Tc Jc] (a pair of Jacks)
ab5cff07: shows [Kh Th] (a pair of Kings)
*** SHOWDOWN ***
ff02ba4e collected $0.96 from pot
*** SUMMARY ***
Total pot $1.01 | Rake $0.05 | Jackpot $0 | Bingo $0 | Fortune $0 | Tax $0
Board [Jd Ac 5d Ks 8h]
Seat 1: Hero (button) folded before Flop (didn't bet)
Seat 2: ff02ba4e (small blind) showed [Kd Qd] and won ($0.96) with a pair of Kings
Seat 3: 44245980 (big blind) folded before Flop
Seat 4: d171b62f showed [Tc Jc] and lost with a pair of Jacks
Seat 5: 58542e99 folded before Flop (didn't bet)
Seat 6: ab5cff07 showed [Kh Th] and lost with a pair of Kings


Poker Hand #RC3812331177: Hold'em No Limit ($0.02/$0.05) - 2025/08/16 22:34:54
Table 'RushAndCash1056437' 6-max Seat #1 is the button
Seat 1: bae32903 ($2.49 in chips)
Seat 2: 44245980 ($5.26 in chips)
Seat 3: Hero ($3.31 in chips)
Seat 4: dfe8628b ($5 in chips)
Seat 5: 3dabf495 ($7.87 in chips)
Seat 6: 928b26d0 ($8.58 in chips)
44245980: posts small blind $0.02
Hero: posts big blind $0.05
*** HOLE CARDS ***
Dealt to bae32903 
Dealt to 44245980 
Dealt to Hero [Td Js]
Dealt to dfe8628b 
Dealt to 3dabf495 
Dealt to 928b26d0 
dfe8628b: folds
3dabf495: folds
928b26d0: folds
bae32903: folds
44245980: raises $0.05 to $0.1
Hero: calls $0.05
*** FLOP *** [Ks Ad 8h]
44245980: bets $0.15
Hero: folds
Uncalled bet ($0.15) returned to 44245980
*** SHOWDOWN ***
44245980 collected $0.19 from pot
*** SUMMARY ***
Total pot $0.2 | Rake $0.01 | Jackpot $0 | Bingo $0 | Fortune $0 | Tax $0
Board [Ks Ad 8h]
Seat 1: bae32903 (button) folded before Flop (didn't bet)
Seat 2: 44245980 (small blind) won ($0.19)
Seat 3: Hero (big blind) folded on the Flop
Seat 4: dfe8628b folded before Flop (didn't bet)
Seat 5: 3dabf495 folded before Flop (didn't bet)
Seat 6: 928b26d0 folded before Flop (didn't bet)


Poker Hand #RC3812330695: Hold'em No Limit ($0.02/$0.05) - 2025/08/16 22:33:47
Table 'RushAndCash1055955' 6-max Seat #1 is the button
Seat 1: 49ba8da2 ($5.29 in chips)
Seat 2: Hero ($3.26 in chips)
Seat 3: af5d4ebf ($8.07 in chips)
Seat 4: 368bc7be ($5 in chips)
Seat 5: 52e702ba ($6.04 in chips)
Seat 6: 6da80c37 ($2.85 in chips)
Hero: posts small blind $0.02
af5d4ebf: posts big blind $0.05
*** HOLE CARDS ***
Dealt to 49ba8da2 
Dealt to Hero [9c Td]
Dealt to af5d4ebf 
Dealt to 368bc7be 
Dealt to 52e702ba 
Dealt to 6da80c37 
368bc7be: folds
52e702ba: folds
6da80c37: folds
49ba8da2: folds
Hero: calls $0.03
af5d4ebf: checks
*** FLOP *** [6d Kd 4c]
Hero: checks
af5d4ebf: checks
*** TURN *** [6d Kd 4c] [Jd]
Hero: checks
af5d4ebf: checks
*** RIVER *** [6d Kd 4c Jd] [3d]
Hero: bets $0.05
af5d4ebf: folds
Uncalled bet ($0.05) returned to Hero
*** SHOWDOWN ***
Hero collected $0.1 from pot
*** SUMMARY ***
Total pot $0.1 | Rake $0 | Jackpot $0 | Bingo $0 | Fortune $0 | Tax $0
Board [6d Kd 4c Jd 3d]
Seat 1: 49ba8da2 (button) folded before Flop (didn't bet)
Seat 2: Hero (small blind) won ($0.1)
Seat 3: af5d4ebf (big blind) folded on the River
Seat 4: 368bc7be folded before Flop (didn't bet)
Seat 5: 52e702ba folded before Flop (didn't bet)
Seat 6: 6da80c37 folded before Flop (didn't bet)


Poker Hand #RC3812330669: Hold'em No Limit ($0.02/$0.05) - 2025/08/16 22:33:43
Table 'RushAndCash1055929' 6-max Seat #1 is the button
Seat 1: 83a66d1b ($7.63 in chips)
Seat 2: e0f479b7 ($17.38 in chips)
Seat 3: b8755603 ($6.36 in chips)
Seat 4: 1569061f ($8.19 in chips)
Seat 5: Hero ($3.26 in chips)
Seat 6: 7b8cef20 ($9.58 in chips)
e0f479b7: posts small blind $0.02
b8755603: posts big blind $0.05
*** HOLE CARDS ***
Dealt to 83a66d1b 
Dealt to e0f479b7 
Dealt to b8755603 
Dealt to 1569061f 
Dealt to Hero [5d Qc]
Dealt to 7b8cef20 
1569061f: folds
Hero: folds
7b8cef20: folds
83a66d1b: raises $0.08 to $0.13
e0f479b7: folds
b8755603: calls $0.08
*** FLOP *** [Qh 8h Kh]
b8755603: checks
83a66d1b: bets $0.2
b8755603: folds
Uncalled bet ($0.2) returned to 83a66d1b
*** SHOWDOWN ***
83a66d1b collected $0.27 from pot
*** SUMMARY ***
Total pot $0.28 | Rake $0.01 | Jackpot $0 | Bingo $0 | Fortune $0 | Tax $0
Board [Qh 8h Kh]
Seat 1: 83a66d1b (button) won ($0.27)
Seat 2: e0f479b7 (small blind) folded before Flop
Seat 3: b8755603 (big blind) folded on the Flop
Seat 4: 1569061f folded before Flop (didn't bet)
Seat 5: Hero folded before Flop (didn't bet)
Seat 6: 7b8cef20 folded before Flop (didn't bet)


Poker Hand #RC3812330505: Hold'em No Limit ($0.02/$0.05) - 2025/08/16 22:33:22
Table 'RushAndCash1055765' 6-max Seat #1 is the button
Seat 1: c2fdfb90 ($5.09 in chips)
Seat 2: 1569061f ($8.26 in chips)
Seat 3: 6aa1a4eb ($5.05 in chips)
Seat 4: fba9f6af ($5.85 in chips)
Seat 5: f1ee4b08 ($7.79 in chips)
Seat 6: Hero ($3.19 in chips)
1569061f: posts small blind $0.02
6aa1a4eb: posts big blind $0.05
*** HOLE CARDS ***
Dealt to c2fdfb90 
Dealt to 1569061f 
Dealt to 6aa1a4eb 
Dealt to fba9f6af 
Dealt to f1ee4b08 
Dealt to Hero [Ad 8d]
fba9f6af: folds
f1ee4b08: folds
Hero: raises $0.05 to $0.1
c2fdfb90: folds
1569061f: folds
6aa1a4eb: folds
Uncalled bet ($0.05) returned to Hero
*** SHOWDOWN ***
Hero collected $0.12 from pot
*** SUMMARY ***
Total pot $0.12 | Rake $0 | Jackpot $0 | Bingo $0 | Fortune $0 | Tax $0
Seat 1: c2fdfb90 (button) folded before Flop (didn't bet)
Seat 2: 1569061f (small blind) folded before Flop
Seat 3: 6aa1a4eb (big blind) folded before Flop
Seat 4: fba9f6af folded before Flop (didn't bet)
Seat 5: f1ee4b08 folded before Flop (didn't bet)
Seat 6: Hero collected ($0.12)


Poker Hand #RC3812330411: Hold'em No Limit ($0.02/$0.05) - 2025/08/16 22:33:10
Table 'RushAndCash1055671' 6-max Seat #1 is the button
Seat 1: Hero ($3.19 in chips)
Seat 2: a6b70ec7 ($5.38 in chips)
Seat 3: 17940c38 ($5.02 in chips)
Seat 4: ca1b4043 ($20.67 in chips)
Seat 5: 2fa78f8b ($5.56 in chips)
Seat 6: 9e4a1ce8 ($5.29 in chips)
a6b70ec7: posts small blind $0.02
17940c38: posts big blind $0.05
*** HOLE CARDS ***
Dealt to Hero [As 6c]
Dealt to a6b70ec7 
Dealt to 17940c38 
Dealt to ca1b4043 
Dealt to 2fa78f8b 
Dealt to 9e4a1ce8 
ca1b4043: folds
2fa78f8b: folds
9e4a1ce8: folds
Hero: folds
a6b70ec7: folds
Uncalled bet ($0.03) returned to 17940c38
*** SHOWDOWN ***
17940c38 collected $0.04 from pot
*** SUMMARY ***
Total pot $0.04 | Rake $0 | Jackpot $0 | Bingo $0 | Fortune $0 | Tax $0
Seat 1: Hero (button) folded before Flop (didn't bet)
Seat 2: a6b70ec7 (small blind) folded before Flop
Seat 3: 17940c38 (big blind) collected ($0.04)
Seat 4: ca1b4043 folded before Flop (didn't bet)
Seat 5: 2fa78f8b folded before Flop (didn't bet)
Seat 6: 9e4a1ce8 folded before Flop (didn't bet)


Poker Hand #RC3812330334: Hold'em No Limit ($0.02/$0.05) - 2025/08/16 22:33:00
Table 'RushAndCash1055594' 6-max Seat #1 is the button
Seat 1: 844ff92 ($4.9 in chips)
Seat 2: 821e3b2c ($6.34 in chips)
Seat 3: Hero ($3.24 in chips)
Seat 4: 39e70059 ($5.36 in chips)
Seat 5: fec0d079 ($8.09 in chips)
Seat 6: 8d3fb9bf ($14.56 in chips)
821e3b2c: posts small blind $0.02
Hero: posts big blind $0.05
*** HOLE CARDS ***
Dealt to 844ff92 
Dealt to 821e3b2c 
Dealt to Hero [Ts 4d]
Dealt to 39e70059 
Dealt to fec0d079 
Dealt to 8d3fb9bf 
39e70059: raises $0.05 to $0.1
fec0d079: folds
8d3fb9bf: calls $0.1
844ff92: folds
821e3b2c: folds
Hero: folds
*** FLOP *** [9d 9h Kc]
39e70059: checks
8d3fb9bf: bets $0.14
39e70059: calls $0.14
*** TURN *** [9d 9h Kc] [Ah]
39e70059: checks
8d3fb9bf: checks
*** RIVER *** [9d 9h Kc Ah] [5h]
39e70059: bets $0.42
8d3fb9bf: folds
Uncalled bet ($0.42) returned to 39e70059
*** SHOWDOWN ***
39e70059 collected $0.53 from pot
*** SUMMARY ***
Total pot $0.55 | Rake $0.02 | Jackpot $0 | Bingo $0 | Fortune $0 | Tax $0
Board [9d 9h Kc Ah 5h]
Seat 1: 844ff92 (button) folded before Flop (didn't bet)
Seat 2: 821e3b2c (small blind) folded before Flop
Seat 3: Hero (big blind) folded before Flop
Seat 4: 39e70059 won ($0.53)
Seat 5: fec0d079 folded before Flop (didn't bet)
Seat 6: 8d3fb9bf folded on the River


Poker Hand #RC3812330048: Hold'em No Limit ($0.02/$0.05) - 2025/08/16 22:32:21
Table 'RushAndCash1055308' 6-max Seat #1 is the button
Seat 1: 7e90ec14 ($5.33 in chips)
Seat 2: Hero ($3.19 in chips)
Seat 3: 1e601c85 ($1.58 in chips)
Seat 4: 7a9715ba ($5.91 in chips)
Seat 5: 3d0e102e ($11.93 in chips)
Seat 6: f313412f ($6.41 in chips)
Hero: posts small blind $0.02
1e601c85: posts big blind $0.05
*** HOLE CARDS ***
Dealt to 7e90ec14 
Dealt to Hero [9d Tc]
Dealt to 1e601c85 
Dealt to 7a9715ba 
Dealt to 3d0e102e 
Dealt to f313412f 
7a9715ba: folds
3d0e102e: folds
f313412f: folds
7e90ec14: folds
Hero: calls $0.03
1e601c85: checks
*** FLOP *** [3c Kh 5c]
Hero: bets $0.05
1e601c85: folds
Uncalled bet ($0.05) returned to Hero
*** SHOWDOWN ***
Hero collected $0.1 from pot
*** SUMMARY ***
Total pot $0.1 | Rake $0 | Jackpot $0 | Bingo $0 | Fortune $0 | Tax $0
Board [3c Kh 5c]
Seat 1: 7e90ec14 (button) folded before Flop (didn't bet)
Seat 2: Hero (small blind) won ($0.1)
Seat 3: 1e601c85 (big blind) folded on the Flop
Seat 4: 7a9715ba folded before Flop (didn't bet)
Seat 5: 3d0e102e folded before Flop (didn't bet)
Seat 6: f313412f folded before Flop (didn't bet)


Poker Hand #RC3812330020: Hold'em No Limit ($0.02/$0.05) - 2025/08/16 22:32:17
Table 'RushAndCash1055280' 6-max Seat #1 is the button
Seat 1: 7b8cef20 ($10.07 in chips)
Seat 2: 4ed749bb ($7.24 in chips)
Seat 3: c46c7d3e ($6.42 in chips)
Seat 4: 6c196a1f ($25.97 in chips)
Seat 5: 844ff92 ($5.1 in chips)
Seat 6: Hero ($3.19 in chips)
4ed749bb: posts small blind $0.02
c46c7d3e: posts big blind $0.05
*** HOLE CARDS ***
Dealt to 7b8cef20 
Dealt to 4ed749bb 
Dealt to c46c7d3e 
Dealt to 6c196a1f 
Dealt to 844ff92 
Dealt to Hero [6c 3s]
6c196a1f: folds
844ff92: folds
Hero: folds
7b8cef20: raises $0.07 to $0.12
4ed749bb: folds
c46c7d3e: folds
Uncalled bet ($0.07) returned to 7b8cef20
*** SHOWDOWN ***
7b8cef20 collected $0.12 from pot
*** SUMMARY ***
Total pot $0.12 | Rake $0 | Jackpot $0 | Bingo $0 | Fortune $0 | Tax $0
Seat 1: 7b8cef20 (button) collected ($0.12)
Seat 2: 4ed749bb (small blind) folded before Flop
Seat 3: c46c7d3e (big blind) folded before Flop
Seat 4: 6c196a1f folded before Flop (didn't bet)
Seat 5: 844ff92 folded before Flop (didn't bet)
Seat 6: Hero folded before Flop (didn't bet)


Poker Hand #RC3812329995: Hold'em No Limit ($0.02/$0.05) - 2025/08/16 22:32:13
Table 'RushAndCash1055255' 6-max Seat #1 is the button
Seat 1: ab5cff07 ($13.09 in chips)
Seat 2: fd3121f5 ($5 in chips)
Seat 3: 5bf4aa2a ($1.01 in chips)
Seat 4: 1e601c85 ($1.58 in chips)
Seat 5: 2c704e54 ($10.01 in chips)
Seat 6: Hero ($3.19 in chips)
fd3121f5: posts small blind $0.02
5bf4aa2a: posts big blind $0.05
*** HOLE CARDS ***
Dealt to ab5cff07 
Dealt to fd3121f5 
Dealt to 5bf4aa2a 
Dealt to 1e601c85 
Dealt to 2c704e54 
Dealt to Hero [3c 5s]
1e601c85: folds
2c704e54: folds
Hero: folds
ab5cff07: folds
fd3121f5: raises $0.1 to $0.15
5bf4aa2a: folds
Uncalled bet ($0.1) returned to fd3121f5
*** SHOWDOWN ***
fd3121f5 collected $0.1 from pot
*** SUMMARY ***
Total pot $0.1 | Rake $0 | Jackpot $0 | Bingo $0 | Fortune $0 | Tax $0
Seat 1: ab5cff07 (button) folded before Flop (didn't bet)
Seat 2: fd3121f5 (small blind) collected ($0.1)
Seat 3: 5bf4aa2a (big blind) folded before Flop
Seat 4: 1e601c85 folded before Flop (didn't bet)
Seat 5: 2c704e54 folded before Flop (didn't bet)
Seat 6: Hero folded before Flop (didn't bet)


Poker Hand #RC3812329970: Hold'em No Limit ($0.02/$0.05) - 2025/08/16 22:32:10
Table 'RushAndCash1055230' 6-max Seat #1 is the button
Seat 1: 265acec2 ($5.02 in chips)
Seat 2: b8641f24 ($6.51 in chips)
Seat 3: 9e633559 ($5.13 in chips)
Seat 4: Hero ($3.19 in chips)
Seat 5: a1c2d20d ($5.82 in chips)
Seat 6: d85a7e29 ($19.98 in chips)
b8641f24: posts small blind $0.02
9e633559: posts big blind $0.05
*** HOLE CARDS ***
Dealt to 265acec2 
Dealt to b8641f24 
Dealt to 9e633559 
Dealt to Hero [Tc Kh]
Dealt to a1c2d20d 
Dealt to d85a7e29 
Hero: folds
a1c2d20d: folds
d85a7e29: raises $0.05 to $0.1
265acec2: folds
b8641f24: raises $0.25 to $0.35
9e633559: folds
d85a7e29: folds
Uncalled bet ($0.25) returned to b8641f24
*** SHOWDOWN ***
b8641f24 collected $0.24 from pot
*** SUMMARY ***
Total pot $0.25 | Rake $0.01 | Jackpot $0 | Bingo $0 | Fortune $0 | Tax $0
Seat 1: 265acec2 (button) folded before Flop (didn't bet)
Seat 2: b8641f24 (small blind) collected ($0.24)
Seat 3: 9e633559 (big blind) folded before Flop
Seat 4: Hero folded before Flop (didn't bet)
Seat 5: a1c2d20d folded before Flop (didn't bet)
Seat 6: d85a7e29 folded before Flop


Poker Hand #RC3812329925: Hold'em No Limit ($0.02/$0.05) - 2025/08/16 22:32:03
Table 'RushAndCash1055185' 6-max Seat #1 is the button
Seat 1: Hero ($3.19 in chips)
Seat 2: 6b21924a ($6.22 in chips)
Seat 3: aa1d41d8 ($5.22 in chips)
Seat 4: a1c2d20d ($5.82 in chips)
Seat 5: e0c300c3 ($5.11 in chips)
Seat 6: 1d91ed09 ($5 in chips)
6b21924a: posts small blind $0.02
aa1d41d8: posts big blind $0.05
*** HOLE CARDS ***
Dealt to Hero [2c Ts]
Dealt to 6b21924a 
Dealt to aa1d41d8 
Dealt to a1c2d20d 
Dealt to e0c300c3 
Dealt to 1d91ed09 
a1c2d20d: folds
e0c300c3: folds
1d91ed09: raises $0.05 to $0.1
Hero: folds
6b21924a: calls $0.08
aa1d41d8: calls $0.05
*** FLOP *** [5c Qh Jc]
6b21924a: checks
aa1d41d8: checks
1d91ed09: checks
*** TURN *** [5c Qh Jc] [Kh]
6b21924a: checks
aa1d41d8: checks
1d91ed09: checks
*** RIVER *** [5c Qh Jc Kh] [Qc]
6b21924a: checks
aa1d41d8: checks
1d91ed09: checks
6b21924a: shows [8c 8d] (two pair, Queens and Eights)
aa1d41d8: shows [4h 3h] (a pair of Queens)
1d91ed09: shows [6d 6h] (two pair, Queens and Sixes)
*** SHOWDOWN ***
6b21924a collected $0.29 from pot
*** SUMMARY ***
Total pot $0.3 | Rake $0.01 | Jackpot $0 | Bingo $0 | Fortune $0 | Tax $0
Board [5c Qh Jc Kh Qc]
Seat 1: Hero (button) folded before Flop (didn't bet)
Seat 2: 6b21924a (small blind) showed [8c 8d] and won ($0.29) with two pair, Queens and Eights
Seat 3: aa1d41d8 (big blind) showed [4h 3h] and lost with a pair of Queens
Seat 4: a1c2d20d folded before Flop (didn't bet)
Seat 5: e0c300c3 folded before Flop (didn't bet)
Seat 6: 1d91ed09 showed [6d 6h] and lost with two pair, Queens and Sixes


Poker Hand #RC3812329681: Hold'em No Limit ($0.02/$0.05) - 2025/08/16 22:31:27
Table 'RushAndCash1054941' 6-max Seat #1 is the button
Seat 1: b3b2dd05 ($5.64 in chips)
Seat 2: Hero ($3.1 in chips)
Seat 3: 3bb0f727 ($5 in chips)
Seat 4: 2b79e688 ($5.04 in chips)
Seat 5: da13d992 ($11.05 in chips)
Seat 6: 3dabf495 ($7.84 in chips)
Hero: posts small blind $0.02
3bb0f727: posts big blind $0.05
*** HOLE CARDS ***
Dealt to b3b2dd05 
Dealt to Hero [9s 7d]
Dealt to 3bb0f727 
Dealt to 2b79e688 
Dealt to da13d992 
Dealt to 3dabf495 
2b79e688: folds
da13d992: folds
3dabf495: folds
b3b2dd05: folds
Hero: raises $0.05 to $0.1
3bb0f727: calls $0.05
*** FLOP *** [Ac 4s Th]
Hero: bets $0.08
3bb0f727: folds
Uncalled bet ($0.08) returned to Hero
*** SHOWDOWN ***
Hero collected $0.19 from pot
*** SUMMARY ***
Total pot $0.2 | Rake $0.01 | Jackpot $0 | Bingo $0 | Fortune $0 | Tax $0
Board [Ac 4s Th]
Seat 1: b3b2dd05 (button) folded before Flop (didn't bet)
Seat 2: Hero (small blind) won ($0.19)
Seat 3: 3bb0f727 (big blind) folded on the Flop
Seat 4: 2b79e688 folded before Flop (didn't bet)
Seat 5: da13d992 folded before Flop (didn't bet)
Seat 6: 3dabf495 folded before Flop (didn't bet)


Poker Hand #RC3812329592: Hold'em No Limit ($0.02/$0.05) - 2025/08/16 22:31:15
Table 'RushAndCash1054852' 6-max Seat #1 is the button
Seat 1: bf5c869a ($6.7 in chips)
Seat 2: 18ba9749 ($10.17 in chips)
Seat 3: Hero ($3.08 in chips)
Seat 4: bf539f78 ($11.22 in chips)
Seat 5: 4aacc403 ($11.54 in chips)
Seat 6: 15a79783 ($7.14 in chips)
18ba9749: posts small blind $0.02
Hero: posts big blind $0.05
*** HOLE CARDS ***
Dealt to bf5c869a 
Dealt to 18ba9749 
Dealt to Hero [3c Ts]
Dealt to bf539f78 
Dealt to 4aacc403 
Dealt to 15a79783 
bf539f78: folds
4aacc403: folds
15a79783: folds
bf5c869a: folds
18ba9749: folds
Uncalled bet ($0.03) returned to Hero
*** SHOWDOWN ***
Hero collected $0.04 from pot
*** SUMMARY ***
Total pot $0.04 | Rake $0 | Jackpot $0 | Bingo $0 | Fortune $0 | Tax $0
Seat 1: bf5c869a (button) folded before Flop (didn't bet)
Seat 2: 18ba9749 (small blind) folded before Flop
Seat 3: Hero (big blind) collected ($0.04)
Seat 4: bf539f78 folded before Flop (didn't bet)
Seat 5: 4aacc403 folded before Flop (didn't bet)
Seat 6: 15a79783 folded before Flop (didn't bet)


Poker Hand #RC3812329565: Hold'em No Limit ($0.02/$0.05) - 2025/08/16 22:31:11
Table 'RushAndCash1054825' 6-max Seat #1 is the button
Seat 1: 2a621c12 ($5.82 in chips)
Seat 2: bf5c869a ($6.72 in chips)
Seat 3: 65a6162b ($5.25 in chips)
Seat 4: 69411c40 ($5.32 in chips)
Seat 5: Hero ($3.08 in chips)
Seat 6: 1d91ed09 ($5 in chips)
bf5c869a: posts small blind $0.02
65a6162b: posts big blind $0.05
*** HOLE CARDS ***
Dealt to 2a621c12 
Dealt to bf5c869a 
Dealt to 65a6162b 
Dealt to 69411c40 
Dealt to Hero [2d Tc]
Dealt to 1d91ed09 
69411c40: folds
Hero: folds
1d91ed09: folds
2a621c12: folds
bf5c869a: folds
Uncalled bet ($0.03) returned to 65a6162b
*** SHOWDOWN ***
65a6162b collected $0.04 from pot
*** SUMMARY ***
Total pot $0.04 | Rake $0 | Jackpot $0 | Bingo $0 | Fortune $0 | Tax $0
Seat 1: 2a621c12 (button) folded before Flop (didn't bet)
Seat 2: bf5c869a (small blind) folded before Flop
Seat 3: 65a6162b (big blind) collected ($0.04)
Seat 4: 69411c40 folded before Flop (didn't bet)
Seat 5: Hero folded before Flop (didn't bet)
Seat 6: 1d91ed09 folded before Flop (didn't bet)


Poker Hand #RC3812329537: Hold'em No Limit ($0.02/$0.05) - 2025/08/16 22:31:08
Table 'RushAndCash1054797' 6-max Seat #1 is the button
Seat 1: 69411c40 ($5.32 in chips)
Seat 2: 15a79783 ($7.18 in chips)
Seat 3: 3bc5d2c5 ($14.08 in chips)
Seat 4: 46d64a45 ($5 in chips)
Seat 5: Hero ($3.08 in chips)
Seat 6: 65a6162b ($5.25 in chips)
15a79783: posts small blind $0.02
3bc5d2c5: posts big blind $0.05
*** HOLE CARDS ***
Dealt to 69411c40 
Dealt to 15a79783 
Dealt to 3bc5d2c5 
Dealt to 46d64a45 
Dealt to Hero [7s Kd]
Dealt to 65a6162b 
46d64a45: folds
Hero: folds
65a6162b: folds
69411c40: folds
15a79783: folds
Uncalled bet ($0.03) returned to 3bc5d2c5
*** SHOWDOWN ***
3bc5d2c5 collected $0.04 from pot
*** SUMMARY ***
Total pot $0.04 | Rake $0 | Jackpot $0 | Bingo $0 | Fortune $0 | Tax $0
Seat 1: 69411c40 (button) folded before Flop (didn't bet)
Seat 2: 15a79783 (small blind) folded before Flop
Seat 3: 3bc5d2c5 (big blind) collected ($0.04)
Seat 4: 46d64a45 folded before Flop (didn't bet)
Seat 5: Hero folded before Flop (didn't bet)
Seat 6: 65a6162b folded before Flop (didn't bet)


Poker Hand #RC3812329092: Hold'em No Limit ($0.02/$0.05) - 2025/08/16 22:30:01
Table 'RushAndCash1054352' 6-max Seat #1 is the button
Seat 1: 32856fe4 ($4 in chips)
Seat 2: 678bdd55 ($9.47 in chips)
Seat 3: 1656660f ($5.22 in chips)
Seat 4: Hero ($4.56 in chips)
Seat 5: b5a9deb7 ($5.22 in chips)
Seat 6: 432f91d2 ($11.41 in chips)
678bdd55: posts small blind $0.02
1656660f: posts big blind $0.05
*** HOLE CARDS ***
Dealt to 32856fe4 
Dealt to 678bdd55 
Dealt to 1656660f 
Dealt to Hero [Js As]
Dealt to b5a9deb7 
Dealt to 432f91d2 
Hero: raises $0.05 to $0.1
b5a9deb7: folds
432f91d2: folds
32856fe4: raises $0.32 to $0.42
678bdd55: folds
1656660f: folds
Hero: calls $0.32
*** FLOP *** [Kh Qs 6s]
Hero: checks
32856fe4: bets $0.3
Hero: calls $0.3
*** TURN *** [Kh Qs 6s] [Jh]
Hero: checks
32856fe4: checks
*** RIVER *** [Kh Qs 6s Jh] [7c]
Hero: checks
32856fe4: bets $0.76
Hero: calls $0.76
32856fe4: shows [Ac Ad] (a pair of Aces)
Hero: shows [Js As] (a pair of Jacks)
*** SHOWDOWN ***
32856fe4 collected $2.82 from pot
*** SUMMARY ***
Total pot $3.03 | Rake $0.14 | Jackpot $0.07 | Bingo $0 | Fortune $0 | Tax $0
Board [Kh Qs 6s Jh 7c]
Seat 1: 32856fe4 (button) showed [Ac Ad] and won ($2.82) with a pair of Aces
Seat 2: 678bdd55 (small blind) folded before Flop
Seat 3: 1656660f (big blind) folded before Flop
Seat 4: Hero showed [Js As] and lost with a pair of Jacks
Seat 5: b5a9deb7 folded before Flop (didn't bet)
Seat 6: 432f91d2 folded before Flop (didn't bet)


Poker Hand #RC3812329032: Hold'em No Limit ($0.02/$0.05) - 2025/08/16 22:29:52
Table 'RushAndCash1054292' 6-max Seat #1 is the button
Seat 1: Hero ($4.56 in chips)
Seat 2: 4543d70c ($7.52 in chips)
Seat 3: 65fa1a78 ($5.5 in chips)
Seat 4: 9928c113 ($11.48 in chips)
Seat 5: 55eeaa66 ($5.1 in chips)
Seat 6: 3dabf495 ($7.22 in chips)
4543d70c: posts small blind $0.02
65fa1a78: posts big blind $0.05
*** HOLE CARDS ***
Dealt to Hero [3d Tc]
Dealt to 4543d70c 
Dealt to 65fa1a78 
Dealt to 9928c113 
Dealt to 55eeaa66 
Dealt to 3dabf495 
9928c113: folds
55eeaa66: folds
3dabf495: folds
Hero: folds
4543d70c: raises $0.15 to $0.2
65fa1a78: folds
Uncalled bet ($0.15) returned to 4543d70c
*** SHOWDOWN ***
4543d70c collected $0.1 from pot
*** SUMMARY ***
Total pot $0.1 | Rake $0 | Jackpot $0 | Bingo $0 | Fortune $0 | Tax $0
Seat 1: Hero (button) folded before Flop (didn't bet)
Seat 2: 4543d70c (small blind) collected ($0.1)
Seat 3: 65fa1a78 (big blind) folded before Flop
Seat 4: 9928c113 folded before Flop (didn't bet)
Seat 5: 55eeaa66 folded before Flop (didn't bet)
Seat 6: 3dabf495 folded before Flop (didn't bet)


Poker Hand #RC3812328786: Hold'em No Limit ($0.02/$0.05) - 2025/08/16 22:29:18
Table 'RushAndCash1054046' 6-max Seat #1 is the button
Seat 1: c8bdfb6 ($5 in chips)
Seat 2: Hero ($4.61 in chips)
Seat 3: 55eeaa66 ($5.05 in chips)
Seat 4: 32856fe4 ($3.93 in chips)
Seat 5: 5c996e33 ($5.3 in chips)
Seat 6: 37ca7961 ($5.35 in chips)
Hero: posts small blind $0.02
55eeaa66: posts big blind $0.05
*** HOLE CARDS ***
Dealt to c8bdfb6 
Dealt to Hero [8s 4s]
Dealt to 55eeaa66 
Dealt to 32856fe4 
Dealt to 5c996e33 
Dealt to 37ca7961 
32856fe4: folds
5c996e33: folds
37ca7961: folds
c8bdfb6: folds
Hero: calls $0.03
55eeaa66: raises $0.21 to $0.26
Hero: folds
Uncalled bet ($0.21) returned to 55eeaa66
*** SHOWDOWN ***
55eeaa66 collected $0.1 from pot
*** SUMMARY ***
Total pot $0.1 | Rake $0 | Jackpot $0 | Bingo $0 | Fortune $0 | Tax $0
Seat 1: c8bdfb6 (button) folded before Flop (didn't bet)
Seat 2: Hero (small blind) folded before Flop
Seat 3: 55eeaa66 (big blind) collected ($0.1)
Seat 4: 32856fe4 folded before Flop (didn't bet)
Seat 5: 5c996e33 folded before Flop (didn't bet)
Seat 6: 37ca7961 folded before Flop (didn't bet)


Poker Hand #RC3812328672: Hold'em No Limit ($0.02/$0.05) - 2025/08/16 22:29:02
Table 'RushAndCash1053932' 6-max Seat #1 is the button
Seat 1: 2257266 ($8 in chips)
Seat 2: b5791fee ($10.98 in chips)
Seat 3: Hero ($4.59 in chips)
Seat 4: df8c0e4e ($8.38 in chips)
Seat 5: 6a13208a ($12.05 in chips)
Seat 6: f734c0c4 ($9.02 in chips)
b5791fee: posts small blind $0.02
Hero: posts big blind $0.05
*** HOLE CARDS ***
Dealt to 2257266 
Dealt to b5791fee 
Dealt to Hero [5d 6s]
Dealt to df8c0e4e 
Dealt to 6a13208a 
Dealt to f734c0c4 
df8c0e4e: folds
6a13208a: folds
f734c0c4: folds
2257266: folds
b5791fee: folds
Uncalled bet ($0.03) returned to Hero
*** SHOWDOWN ***
Hero collected $0.04 from pot
*** SUMMARY ***
Total pot $0.04 | Rake $0 | Jackpot $0 | Bingo $0 | Fortune $0 | Tax $0
Seat 1: 2257266 (button) folded before Flop (didn't bet)
Seat 2: b5791fee (small blind) folded before Flop
Seat 3: Hero (big blind) collected ($0.04)
Seat 4: df8c0e4e folded before Flop (didn't bet)
Seat 5: 6a13208a folded before Flop (didn't bet)
Seat 6: f734c0c4 folded before Flop (didn't bet)


Poker Hand #RC3812328647: Hold'em No Limit ($0.02/$0.05) - 2025/08/16 22:28:59
Table 'RushAndCash1053907' 6-max Seat #1 is the button
Seat 1: 7e90ec14 ($5.21 in chips)
Seat 2: bc28ebe8 ($5 in chips)
Seat 3: 8bf47b54 ($5.33 in chips)
Seat 4: b5791fee ($10.98 in chips)
Seat 5: 4f15238c ($5.8 in chips)
Seat 6: Hero ($4.59 in chips)
bc28ebe8: posts small blind $0.02
8bf47b54: posts big blind $0.05
*** HOLE CARDS ***
Dealt to 7e90ec14 
Dealt to bc28ebe8 
Dealt to 8bf47b54 
Dealt to b5791fee 
Dealt to 4f15238c 
Dealt to Hero [Jh 2s]
b5791fee: folds
4f15238c: folds
Hero: folds
7e90ec14: folds
bc28ebe8: folds
Uncalled bet ($0.03) returned to 8bf47b54
*** SHOWDOWN ***
8bf47b54 collected $0.04 from pot
*** SUMMARY ***
Total pot $0.04 | Rake $0 | Jackpot $0 | Bingo $0 | Fortune $0 | Tax $0
Seat 1: 7e90ec14 (button) folded before Flop (didn't bet)
Seat 2: bc28ebe8 (small blind) folded before Flop
Seat 3: 8bf47b54 (big blind) collected ($0.04)
Seat 4: b5791fee folded before Flop (didn't bet)
Seat 5: 4f15238c folded before Flop (didn't bet)
Seat 6: Hero folded before Flop (didn't bet)


Poker Hand #RC3812328573: Hold'em No Limit ($0.02/$0.05) - 2025/08/16 22:28:48
Table 'RushAndCash1053833' 6-max Seat #1 is the button
Seat 1: 24091124 ($10.75 in chips)
Seat 2: 6e48b49c ($7.48 in chips)
Seat 3: 4da56cdf ($5.74 in chips)
Seat 4: d140874d ($5.69 in chips)
Seat 5: Hero ($4.59 in chips)
Seat 6: 82170b33 ($19.26 in chips)
6e48b49c: posts small blind $0.02
4da56cdf: posts big blind $0.05
*** HOLE CARDS ***
Dealt to 24091124 
Dealt to 6e48b49c 
Dealt to 4da56cdf 
Dealt to d140874d 
Dealt to Hero [Qs Th]
Dealt to 82170b33 
d140874d: folds
Hero: folds
82170b33: folds
24091124: folds
6e48b49c: raises $0.1 to $0.15
4da56cdf: folds
Uncalled bet ($0.1) returned to 6e48b49c
*** SHOWDOWN ***
6e48b49c collected $0.1 from pot
*** SUMMARY ***
Total pot $0.1 | Rake $0 | Jackpot $0 | Bingo $0 | Fortune $0 | Tax $0
Seat 1: 24091124 (button) folded before Flop (didn't bet)
Seat 2: 6e48b49c (small blind) collected ($0.1)
Seat 3: 4da56cdf (big blind) folded before Flop
Seat 4: d140874d folded before Flop (didn't bet)
Seat 5: Hero folded before Flop (didn't bet)
Seat 6: 82170b33 folded before Flop (didn't bet)


Poker Hand #RC3812328545: Hold'em No Limit ($0.02/$0.05) - 2025/08/16 22:28:45
Table 'RushAndCash1053805' 6-max Seat #1 is the button
Seat 1: 25a26eba ($5.02 in chips)
Seat 2: a9581dc8 ($11.65 in chips)
Seat 3: d85a7e29 ($20.27 in chips)
Seat 4: f6e7e3d4 ($2.44 in chips)
Seat 5: 855ad684 ($12.42 in chips)
Seat 6: Hero ($4.59 in chips)
a9581dc8: posts small blind $0.02
d85a7e29: posts big blind $0.05
*** HOLE CARDS ***
Dealt to 25a26eba 
Dealt to a9581dc8 
Dealt to d85a7e29 
Dealt to f6e7e3d4 
Dealt to 855ad684 
Dealt to Hero [Kd 8d]
f6e7e3d4: folds
855ad684: folds
Hero: folds
25a26eba: folds
a9581dc8: folds
Uncalled bet ($0.03) returned to d85a7e29
*** SHOWDOWN ***
d85a7e29 collected $0.04 from pot
*** SUMMARY ***
Total pot $0.04 | Rake $0 | Jackpot $0 | Bingo $0 | Fortune $0 | Tax $0
Seat 1: 25a26eba (button) folded before Flop (didn't bet)
Seat 2: a9581dc8 (small blind) folded before Flop
Seat 3: d85a7e29 (big blind) collected ($0.04)
Seat 4: f6e7e3d4 folded before Flop (didn't bet)
Seat 5: 855ad684 folded before Flop (didn't bet)
Seat 6: Hero folded before Flop (didn't bet)


Poker Hand #RC3812328517: Hold'em No Limit ($0.02/$0.05) - 2025/08/16 22:28:41
Table 'RushAndCash1053777' 6-max Seat #1 is the button
Seat 1: c9696527 ($5 in chips)
Seat 2: 44c3e1ad ($2.23 in chips)
Seat 3: 1319708a ($7.72 in chips)
Seat 4: e96405cf ($11.05 in chips)
Seat 5: Hero ($4.59 in chips)
Seat 6: a0ee51e3 ($5.8 in chips)
44c3e1ad: posts small blind $0.02
1319708a: posts big blind $0.05
*** HOLE CARDS ***
Dealt to c9696527 
Dealt to 44c3e1ad 
Dealt to 1319708a 
Dealt to e96405cf 
Dealt to Hero [4d 4c]
Dealt to a0ee51e3 
e96405cf: folds
Hero: folds
a0ee51e3: folds
c9696527: folds
44c3e1ad: folds
Uncalled bet ($0.03) returned to 1319708a
*** SHOWDOWN ***
1319708a collected $0.04 from pot
*** SUMMARY ***
Total pot $0.04 | Rake $0 | Jackpot $0 | Bingo $0 | Fortune $0 | Tax $0
Seat 1: c9696527 (button) folded before Flop (didn't bet)
Seat 2: 44c3e1ad (small blind) folded before Flop
Seat 3: 1319708a (big blind) collected ($0.04)
Seat 4: e96405cf folded before Flop (didn't bet)
Seat 5: Hero folded before Flop (didn't bet)
Seat 6: a0ee51e3 folded before Flop (didn't bet)


Poker Hand #RC3812328438: Hold'em No Limit ($0.02/$0.05) - 2025/08/16 22:28:31
Table 'RushAndCash1053698' 6-max Seat #1 is the button
Seat 1: ef98be50 ($5 in chips)
Seat 2: Hero ($4.61 in chips)
Seat 3: 21ffd351 ($7.27 in chips)
Seat 4: 3bb0f727 ($5.3 in chips)
Seat 5: d3f68008 ($11.52 in chips)
Seat 6: 68e71ab2 ($5 in chips)
Hero: posts small blind $0.02
21ffd351: posts big blind $0.05
*** HOLE CARDS ***
Dealt to ef98be50 
Dealt to Hero [8h 9c]
Dealt to 21ffd351 
Dealt to 3bb0f727 
Dealt to d3f68008 
Dealt to 68e71ab2 
3bb0f727: folds
d3f68008: folds
68e71ab2: raises $0.08 to $0.13
ef98be50: folds
Hero: folds
21ffd351: folds
Uncalled bet ($0.08) returned to 68e71ab2
*** SHOWDOWN ***
68e71ab2 collected $0.12 from pot
*** SUMMARY ***
Total pot $0.12 | Rake $0 | Jackpot $0 | Bingo $0 | Fortune $0 | Tax $0
Seat 1: ef98be50 (button) folded before Flop (didn't bet)
Seat 2: Hero (small blind) folded before Flop
Seat 3: 21ffd351 (big blind) folded before Flop
Seat 4: 3bb0f727 folded before Flop (didn't bet)
Seat 5: d3f68008 folded before Flop (didn't bet)
Seat 6: 68e71ab2 collected ($0.12)


Poker Hand #RC3812328359: Hold'em No Limit ($0.02/$0.05) - 2025/08/16 22:28:21
Table 'RushAndCash1053619' 6-max Seat #1 is the button
Seat 1: a36a858d ($9.68 in chips)
Seat 2: 3b661f83 ($11.75 in chips)
Seat 3: Hero ($4.66 in chips)
Seat 4: 4f15238c ($5.14 in chips)
Seat 5: 432f91d2 ($11.51 in chips)
Seat 6: 7ce12b39 ($4.78 in chips)
3b661f83: posts small blind $0.02
Hero: posts big blind $0.05
*** HOLE CARDS ***
Dealt to a36a858d 
Dealt to 3b661f83 
Dealt to Hero [4s 9h]
Dealt to 4f15238c 
Dealt to 432f91d2 
Dealt to 7ce12b39 
4f15238c: folds
432f91d2: raises $0.06 to $0.11
7ce12b39: folds
a36a858d: folds
3b661f83: folds
Hero: folds
Uncalled bet ($0.06) returned to 432f91d2
*** SHOWDOWN ***
432f91d2 collected $0.12 from pot
*** SUMMARY ***
Total pot $0.12 | Rake $0 | Jackpot $0 | Bingo $0 | Fortune $0 | Tax $0
Seat 1: a36a858d (button) folded before Flop (didn't bet)
Seat 2: 3b661f83 (small blind) folded before Flop
Seat 3: Hero (big blind) folded before Flop
Seat 4: 4f15238c folded before Flop (didn't bet)
Seat 5: 432f91d2 collected ($0.12)
Seat 6: 7ce12b39 folded before Flop (didn't bet)


Poker Hand #RC3812328280: Hold'em No Limit ($0.02/$0.05) - 2025/08/16 22:28:10
Table 'RushAndCash1053540' 6-max Seat #1 is the button
Seat 1: Hero ($4.66 in chips)
Seat 2: dc3fa354 ($9.02 in chips)
Seat 3: b3b2dd05 ($5 in chips)
Seat 4: 98a8f7b2 ($5.04 in chips)
Seat 5: b0b5dd83 ($5.54 in chips)
Seat 6: dc8b0ec8 ($5.03 in chips)
dc3fa354: posts small blind $0.02
b3b2dd05: posts big blind $0.05
*** HOLE CARDS ***
Dealt to Hero [Qd 2d]
Dealt to dc3fa354 
Dealt to b3b2dd05 
Dealt to 98a8f7b2 
Dealt to b0b5dd83 
Dealt to dc8b0ec8 
98a8f7b2: folds
b0b5dd83: raises $0.05 to $0.1
dc8b0ec8: folds
Hero: folds
dc3fa354: folds
b3b2dd05: folds
Uncalled bet ($0.05) returned to b0b5dd83
*** SHOWDOWN ***
b0b5dd83 collected $0.12 from pot
*** SUMMARY ***
Total pot $0.12 | Rake $0 | Jackpot $0 | Bingo $0 | Fortune $0 | Tax $0
Seat 1: Hero (button) folded before Flop (didn't bet)
Seat 2: dc3fa354 (small blind) folded before Flop
Seat 3: b3b2dd05 (big blind) folded before Flop
Seat 4: 98a8f7b2 folded before Flop (didn't bet)
Seat 5: b0b5dd83 collected ($0.12)
Seat 6: dc8b0ec8 folded before Flop (didn't bet)


Poker Hand #RC3812328206: Hold'em No Limit ($0.02/$0.05) - 2025/08/16 22:27:59
Table 'RushAndCash1053466' 6-max Seat #1 is the button
Seat 1: ae9f2488 ($7.02 in chips)
Seat 2: 27f599c4 ($15.69 in chips)
Seat 3: 4662e7d9 ($5.79 in chips)
Seat 4: b6aede31 ($5.32 in chips)
Seat 5: ac622eaf ($6.33 in chips)
Seat 6: Hero ($4.66 in chips)
27f599c4: posts small blind $0.02
4662e7d9: posts big blind $0.05
*** HOLE CARDS ***
Dealt to ae9f2488 
Dealt to 27f599c4 
Dealt to 4662e7d9 
Dealt to b6aede31 
Dealt to ac622eaf 
Dealt to Hero [Ts Ah]
b6aede31: raises $0.05 to $0.1
ac622eaf: folds
Hero: folds
ae9f2488: folds
27f599c4: folds
4662e7d9: folds
Uncalled bet ($0.05) returned to b6aede31
*** SHOWDOWN ***
b6aede31 collected $0.12 from pot
*** SUMMARY ***
Total pot $0.12 | Rake $0 | Jackpot $0 | Bingo $0 | Fortune $0 | Tax $0
Seat 1: ae9f2488 (button) folded before Flop (didn't bet)
Seat 2: 27f599c4 (small blind) folded before Flop
Seat 3: 4662e7d9 (big blind) folded before Flop
Seat 4: b6aede31 collected ($0.12)
Seat 5: ac622eaf folded before Flop (didn't bet)
Seat 6: Hero folded before Flop (didn't bet)


Poker Hand #RC3812328164: Hold'em No Limit ($0.02/$0.05) - 2025/08/16 22:27:53
Table 'RushAndCash1053424' 6-max Seat #1 is the button
Seat 1: 41ceabbe ($5 in chips)
Seat 2: 7700906c ($5 in chips)
Seat 3: daa7740e ($6.03 in chips)
Seat 4: Hero ($4.66 in chips)
Seat 5: 3206bb0c ($6.65 in chips)
Seat 6: 841471b9 ($5 in chips)
7700906c: posts small blind $0.02
daa7740e: posts big blind $0.05
*** HOLE CARDS ***
Dealt to 41ceabbe 
Dealt to 7700906c 
Dealt to daa7740e 
Dealt to Hero [2c 5h]
Dealt to 3206bb0c 
Dealt to 841471b9 
Hero: folds
3206bb0c: folds
841471b9: raises $0.07 to $0.12
41ceabbe: folds
7700906c: folds
daa7740e: folds
Uncalled bet ($0.07) returned to 841471b9
*** SHOWDOWN ***
841471b9 collected $0.12 from pot
*** SUMMARY ***
Total pot $0.12 | Rake $0 | Jackpot $0 | Bingo $0 | Fortune $0 | Tax $0
Seat 1: 41ceabbe (button) folded before Flop (didn't bet)
Seat 2: 7700906c (small blind) folded before Flop
Seat 3: daa7740e (big blind) folded before Flop
Seat 4: Hero folded before Flop (didn't bet)
Seat 5: 3206bb0c folded before Flop (didn't bet)
Seat 6: 841471b9 collected ($0.12)


Poker Hand #RC3812328069: Hold'em No Limit ($0.02/$0.05) - 2025/08/16 22:27:41
Table 'RushAndCash1053329' 6-max Seat #1 is the button
Seat 1: Hero ($4.66 in chips)
Seat 2: ec694fdc ($10.66 in chips)
Seat 3: 9c258b00 ($20.4 in chips)
Seat 4: 2343b41 ($6.65 in chips)
Seat 5: b25db61b ($14.62 in chips)
Seat 6: 476c7cfc ($7.45 in chips)
ec694fdc: posts small blind $0.02
9c258b00: posts big blind $0.05
*** HOLE CARDS ***
Dealt to Hero [Ac 2h]
Dealt to ec694fdc 
Dealt to 9c258b00 
Dealt to 2343b41 
Dealt to b25db61b 
Dealt to 476c7cfc 
2343b41: folds
b25db61b: folds
476c7cfc: folds
Hero: folds
ec694fdc: folds
Uncalled bet ($0.03) returned to 9c258b00
*** SHOWDOWN ***
9c258b00 collected $0.04 from pot
*** SUMMARY ***
Total pot $0.04 | Rake $0 | Jackpot $0 | Bingo $0 | Fortune $0 | Tax $0
Seat 1: Hero (button) folded before Flop (didn't bet)
Seat 2: ec694fdc (small blind) folded before Flop
Seat 3: 9c258b00 (big blind) collected ($0.04)
Seat 4: 2343b41 folded before Flop (didn't bet)
Seat 5: b25db61b folded before Flop (didn't bet)
Seat 6: 476c7cfc folded before Flop (didn't bet)


Poker Hand #RC3812327996: Hold'em No Limit ($0.02/$0.05) - 2025/08/16 22:27:30
Table 'RushAndCash1053256' 6-max Seat #1 is the button
Seat 1: 196df7c ($5.05 in chips)
Seat 2: Hero ($4.68 in chips)
Seat 3: 2b1d8a4d ($5.35 in chips)
Seat 4: 33236916 ($5.64 in chips)
Seat 5: 12db1abd ($5 in chips)
Seat 6: 54f318ea ($5.1 in chips)
Hero: posts small blind $0.02
2b1d8a4d: posts big blind $0.05
*** HOLE CARDS ***
Dealt to 196df7c 
Dealt to Hero [Jh 5d]
Dealt to 2b1d8a4d 
Dealt to 33236916 
Dealt to 12db1abd 
Dealt to 54f318ea 
33236916: folds
12db1abd: raises $0.08 to $0.13
54f318ea: folds
196df7c: folds
Hero: folds
2b1d8a4d: calls $0.08
*** FLOP *** [7c 2s 7s]
2b1d8a4d: checks
12db1abd: bets $0.13
2b1d8a4d: calls $0.13
*** TURN *** [7c 2s 7s] [3c]
2b1d8a4d: checks
12db1abd: bets $0.68
2b1d8a4d: calls $0.68
*** RIVER *** [7c 2s 7s 3c] [3d]
2b1d8a4d: checks
12db1abd: checks
2b1d8a4d: shows [8s 8h] (two pair, Eights and Sevens)
12db1abd: shows [Kd Ac] (two pair, Sevens and Threes)
*** SHOWDOWN ***
2b1d8a4d collected $1.74 from pot
*** SUMMARY ***
Total pot $1.9 | Rake $0.09 | Jackpot $0.07 | Bingo $0 | Fortune $0 | Tax $0
Board [7c 2s 7s 3c 3d]
Seat 1: 196df7c (button) folded before Flop (didn't bet)
Seat 2: Hero (small blind) folded before Flop
Seat 3: 2b1d8a4d (big blind) showed [8s 8h] and won ($1.74) with two pair, Eights and Sevens
Seat 4: 33236916 folded before Flop (didn't bet)
Seat 5: 12db1abd showed [Kd Ac] and lost with two pair, Sevens and Threes
Seat 6: 54f318ea folded before Flop (didn't bet)


Poker Hand #RC3812327845: Hold'em No Limit ($0.02/$0.05) - 2025/08/16 22:27:09
Table 'RushAndCash1053105' 6-max Seat #1 is the button
Seat 1: 9b809693 ($11.5 in chips)
Seat 2: 25a26eba ($5.14 in chips)
Seat 3: Hero ($4.73 in chips)
Seat 4: 1969b459 ($5.42 in chips)
Seat 5: 26539f36 ($5.5 in chips)
Seat 6: 6c3973b1 ($7.74 in chips)
25a26eba: posts small blind $0.02
Hero: posts big blind $0.05
*** HOLE CARDS ***
Dealt to 9b809693 
Dealt to 25a26eba 
Dealt to Hero [5c 6h]
Dealt to 1969b459 
Dealt to 26539f36 
Dealt to 6c3973b1 
1969b459: folds
26539f36: folds
6c3973b1: folds
9b809693: raises $0.08 to $0.13
25a26eba: folds
Hero: folds
Uncalled bet ($0.08) returned to 9b809693
*** SHOWDOWN ***
9b809693 collected $0.12 from pot
*** SUMMARY ***
Total pot $0.12 | Rake $0 | Jackpot $0 | Bingo $0 | Fortune $0 | Tax $0
Seat 1: 9b809693 (button) collected ($0.12)
Seat 2: 25a26eba (small blind) folded before Flop
Seat 3: Hero (big blind) folded before Flop
Seat 4: 1969b459 folded before Flop (didn't bet)
Seat 5: 26539f36 folded before Flop (didn't bet)
Seat 6: 6c3973b1 folded before Flop (didn't bet)


Poker Hand #RC3812327755: Hold'em No Limit ($0.02/$0.05) - 2025/08/16 22:26:56
Table 'RushAndCash1053015' 6-max Seat #1 is the button
Seat 1: 5d9a8c7a ($2.69 in chips)
Seat 2: b0432c89 ($5 in chips)
Seat 3: 65fa1a78 ($5.52 in chips)
Seat 4: Hero ($4.73 in chips)
Seat 5: af52575d ($5.32 in chips)
Seat 6: 2c704e54 ($8.76 in chips)
b0432c89: posts small blind $0.02
65fa1a78: posts big blind $0.05
*** HOLE CARDS ***
Dealt to 5d9a8c7a 
Dealt to b0432c89 
Dealt to 65fa1a78 
Dealt to Hero [Ad 5h]
Dealt to af52575d 
Dealt to 2c704e54 
Hero: folds
af52575d: folds
2c704e54: folds
5d9a8c7a: folds
b0432c89: raises $0.1 to $0.15
65fa1a78: raises $0.33 to $0.48
b0432c89: folds
Uncalled bet ($0.33) returned to 65fa1a78
*** SHOWDOWN ***
65fa1a78 collected $0.29 from pot
*** SUMMARY ***
Total pot $0.3 | Rake $0.01 | Jackpot $0 | Bingo $0 | Fortune $0 | Tax $0
Seat 1: 5d9a8c7a (button) folded before Flop (didn't bet)
Seat 2: b0432c89 (small blind) folded before Flop
Seat 3: 65fa1a78 (big blind) collected ($0.29)
Seat 4: Hero folded before Flop (didn't bet)
Seat 5: af52575d folded before Flop (didn't bet)
Seat 6: 2c704e54 folded before Flop (didn't bet)


Poker Hand #RC3812327731: Hold'em No Limit ($0.02/$0.05) - 2025/08/16 22:26:52
Table 'RushAndCash1052991' 6-max Seat #1 is the button
Seat 1: edba6ccc ($7.22 in chips)
Seat 2: b33109ed ($10.01 in chips)
Seat 3: 10dff872 ($4.85 in chips)
Seat 4: 5bf4aa2a ($0.81 in chips)
Seat 5: Hero ($4.73 in chips)
Seat 6: 3dc9b1ad ($13.71 in chips)
b33109ed: posts small blind $0.02
10dff872: posts big blind $0.05
*** HOLE CARDS ***
Dealt to edba6ccc 
Dealt to b33109ed 
Dealt to 10dff872 
Dealt to 5bf4aa2a 
Dealt to Hero [3h 3c]
Dealt to 3dc9b1ad 
5bf4aa2a: calls $0.05
Hero: folds
3dc9b1ad: folds
edba6ccc: raises $0.07 to $0.12
b33109ed: folds
10dff872: calls $0.07
5bf4aa2a: calls $0.07
*** FLOP *** [As Ts 5d]
10dff872: checks
5bf4aa2a: bets $0.05
edba6ccc: calls $0.05
10dff872: calls $0.05
*** TURN *** [As Ts 5d] [8c]
10dff872: checks
5bf4aa2a: checks
edba6ccc: checks
*** RIVER *** [As Ts 5d 8c] [Ks]
10dff872: checks
5bf4aa2a: checks
edba6ccc: bets $0.2
10dff872: folds
5bf4aa2a: folds
Uncalled bet ($0.2) returned to edba6ccc
*** SHOWDOWN ***
edba6ccc collected $0.51 from pot
*** SUMMARY ***
Total pot $0.53 | Rake $0.02 | Jackpot $0 | Bingo $0 | Fortune $0 | Tax $0
Board [As Ts 5d 8c Ks]
Seat 1: edba6ccc (button) won ($0.51)
Seat 2: b33109ed (small blind) folded before Flop
Seat 3: 10dff872 (big blind) folded on the River
Seat 4: 5bf4aa2a folded on the River
Seat 5: Hero folded before Flop (didn't bet)
Seat 6: 3dc9b1ad folded before Flop (didn't bet)


Poker Hand #RC3812327697: Hold'em No Limit ($0.02/$0.05) - 2025/08/16 22:26:48
Table 'RushAndCash1052957' 6-max Seat #1 is the button
Seat 1: 4313d9dc ($11.24 in chips)
Seat 2: bb214334 ($3.99 in chips)
Seat 3: b51d732b ($5.39 in chips)
Seat 4: a2eab32c ($7.86 in chips)
Seat 5: 2ed14820 ($5.33 in chips)
Seat 6: Hero ($4.73 in chips)
bb214334: posts small blind $0.02
b51d732b: posts big blind $0.05
*** HOLE CARDS ***
Dealt to 4313d9dc 
Dealt to bb214334 
Dealt to b51d732b 
Dealt to a2eab32c 
Dealt to 2ed14820 
Dealt to Hero [Qs 8h]
a2eab32c: folds
2ed14820: raises $0.05 to $0.1
Hero: folds
4313d9dc: folds
bb214334: folds
b51d732b: calls $0.05
*** FLOP *** [7c 4c 9c]
b51d732b: checks
2ed14820: checks
*** TURN *** [7c 4c 9c] [3d]
b51d732b: checks
2ed14820: checks
*** RIVER *** [7c 4c 9c 3d] [8s]
b51d732b: checks
2ed14820: checks
b51d732b: shows [Jh 9s] (a pair of Nines)
2ed14820: shows [Ad Td] (Ace high)
*** SHOWDOWN ***
b51d732b collected $0.21 from pot
*** SUMMARY ***
Total pot $0.22 | Rake $0.01 | Jackpot $0 | Bingo $0 | Fortune $0 | Tax $0
Board [7c 4c 9c 3d 8s]
Seat 1: 4313d9dc (button) folded before Flop (didn't bet)
Seat 2: bb214334 (small blind) folded before Flop
Seat 3: b51d732b (big blind) showed [Jh 9s] and won ($0.21) with a pair of Nines
Seat 4: a2eab32c folded before Flop (didn't bet)
Seat 5: 2ed14820 showed [Ad Td] and lost with Ace high
Seat 6: Hero folded before Flop (didn't bet)


Poker Hand #RC3812327660: Hold'em No Limit ($0.02/$0.05) - 2025/08/16 22:26:43
Table 'RushAndCash1052920' 6-max Seat #1 is the button
Seat 1: dcd4aca9 ($5 in chips)
Seat 2: 1569061f ($6.49 in chips)
Seat 3: 5ebbbcaf ($5.14 in chips)
Seat 4: 7cd6524d ($6.77 in chips)
Seat 5: Hero ($4.73 in chips)
Seat 6: 65fa1a78 ($5.52 in chips)
1569061f: posts small blind $0.02
5ebbbcaf: posts big blind $0.05
*** HOLE CARDS ***
Dealt to dcd4aca9 
Dealt to 1569061f 
Dealt to 5ebbbcaf 
Dealt to 7cd6524d 
Dealt to Hero [4h Qc]
Dealt to 65fa1a78 
7cd6524d: folds
Hero: folds
65fa1a78: folds
dcd4aca9: folds
1569061f: folds
Uncalled bet ($0.03) returned to 5ebbbcaf
*** SHOWDOWN ***
5ebbbcaf collected $0.04 from pot
*** SUMMARY ***
Total pot $0.04 | Rake $0 | Jackpot $0 | Bingo $0 | Fortune $0 | Tax $0
Seat 1: dcd4aca9 (button) folded before Flop (didn't bet)
Seat 2: 1569061f (small blind) folded before Flop
Seat 3: 5ebbbcaf (big blind) collected ($0.04)
Seat 4: 7cd6524d folded before Flop (didn't bet)
Seat 5: Hero folded before Flop (didn't bet)
Seat 6: 65fa1a78 folded before Flop (didn't bet)


Poker Hand #RC3812326369: Hold'em No Limit ($0.02/$0.05) - 2025/08/16 22:23:36
Table 'RushAndCash1051629' 6-max Seat #1 is the button
Seat 1: Hero ($5.07 in chips)
Seat 2: 6e2cd859 ($5 in chips)
Seat 3: 8f7907e6 ($5.58 in chips)
Seat 4: 1d14101c ($5 in chips)
Seat 5: 4a0920b8 ($5.34 in chips)
Seat 6: df8c0e4e ($6.98 in chips)
6e2cd859: posts small blind $0.02
8f7907e6: posts big blind $0.05
*** HOLE CARDS ***
Dealt to Hero [Kc Tc]
Dealt to 6e2cd859 
Dealt to 8f7907e6 
Dealt to 1d14101c 
Dealt to 4a0920b8 
Dealt to df8c0e4e 
1d14101c: folds
4a0920b8: folds
df8c0e4e: raises $0.1 to $0.15
Hero: calls $0.15
6e2cd859: folds
8f7907e6: folds
*** FLOP *** [Kd Ad 8d]
df8c0e4e: bets $0.19
Hero: calls $0.19
*** TURN *** [Kd Ad 8d] [7c]
df8c0e4e: bets $0.6
Hero: folds
Uncalled bet ($0.6) returned to df8c0e4e
*** SHOWDOWN ***
df8c0e4e collected $0.72 from pot
*** SUMMARY ***
Total pot $0.75 | Rake $0.03 | Jackpot $0 | Bingo $0 | Fortune $0 | Tax $0
Board [Kd Ad 8d 7c]
Seat 1: Hero (button) folded on the Turn
Seat 2: 6e2cd859 (small blind) folded before Flop
Seat 3: 8f7907e6 (big blind) folded before Flop
Seat 4: 1d14101c folded before Flop (didn't bet)
Seat 5: 4a0920b8 folded before Flop (didn't bet)
Seat 6: df8c0e4e won ($0.72)


Poker Hand #RC3812326253: Hold'em No Limit ($0.02/$0.05) - 2025/08/16 22:23:19
Table 'RushAndCash1051513' 6-max Seat #1 is the button
Seat 1: 2b54e7a1 ($5.37 in chips)
Seat 2: Hero ($5.02 in chips)
Seat 3: 1d91ed09 ($6.27 in chips)
Seat 4: 3d0e102e ($13.39 in chips)
Seat 5: d806727a ($6.29 in chips)
Seat 6: bf5c869a ($5.16 in chips)
Hero: posts small blind $0.02
1d91ed09: posts big blind $0.05
*** HOLE CARDS ***
Dealt to 2b54e7a1 
Dealt to Hero [5c 7h]
Dealt to 1d91ed09 
Dealt to 3d0e102e 
Dealt to d806727a 
Dealt to bf5c869a 
3d0e102e: folds
d806727a: folds
bf5c869a: folds
2b54e7a1: folds
Hero: calls $0.03
1d91ed09: checks
*** FLOP *** [2s Tc 5h]
Hero: bets $0.05
1d91ed09: folds
Uncalled bet ($0.05) returned to Hero
*** SHOWDOWN ***
Hero collected $0.1 from pot
*** SUMMARY ***
Total pot $0.1 | Rake $0 | Jackpot $0 | Bingo $0 | Fortune $0 | Tax $0
Board [2s Tc 5h]
Seat 1: 2b54e7a1 (button) folded before Flop (didn't bet)
Seat 2: Hero (small blind) won ($0.1)
Seat 3: 1d91ed09 (big blind) folded on the Flop
Seat 4: 3d0e102e folded before Flop (didn't bet)
Seat 5: d806727a folded before Flop (didn't bet)
Seat 6: bf5c869a folded before Flop (didn't bet)


Poker Hand #RC3812326101: Hold'em No Limit ($0.02/$0.05) - 2025/08/16 22:22:59
Table 'RushAndCash1051361' 6-max Seat #1 is the button
Seat 1: 1e462cd6 ($5.57 in chips)
Seat 2: 1d91ed09 ($6.29 in chips)
Seat 3: Hero ($5 in chips)
Seat 4: 54f318ea ($5 in chips)
Seat 5: 2c704e54 ($6.19 in chips)
Seat 6: c9717df4 ($6.67 in chips)
1d91ed09: posts small blind $0.02
Hero: posts big blind $0.05
*** HOLE CARDS ***
Dealt to 1e462cd6 
Dealt to 1d91ed09 
Dealt to Hero [2h 8h]
Dealt to 54f318ea 
Dealt to 2c704e54 
Dealt to c9717df4 
54f318ea: folds
2c704e54: folds
c9717df4: folds
1e462cd6: folds
1d91ed09: folds
Uncalled bet ($0.03) returned to Hero
*** SHOWDOWN ***
Hero collected $0.04 from pot
*** SUMMARY ***
Total pot $0.04 | Rake $0 | Jackpot $0 | Bingo $0 | Fortune $0 | Tax $0
Seat 1: 1e462cd6 (button) folded before Flop (didn't bet)
Seat 2: 1d91ed09 (small blind) folded before Flop
Seat 3: Hero (big blind) collected ($0.04)
Seat 4: 54f318ea folded before Flop (didn't bet)
Seat 5: 2c704e54 folded before Flop (didn't bet)
Seat 6: c9717df4 folded before Flop (didn't bet)


