Poker Hand #RC3795976758: Hold'em No Limit ($0.02/$0.05) - 2025/08/10 08:55:39
Table 'RushAndCash11072018' 6-max Seat #1 is the button
Seat 1: 98c7e0e9 ($4.55 in chips)
Seat 2: 68c48621 ($6.85 in chips)
Seat 3: Hero ($12.93 in chips)
Seat 4: b1b3930a ($5.23 in chips)
Seat 5: b1ac0d73 ($5.43 in chips)
Seat 6: 50f9d2cc ($5.26 in chips)
68c48621: posts small blind $0.02
Hero: posts big blind $0.05
*** HOLE CARDS ***
Dealt to 98c7e0e9 
Dealt to 68c48621 
Dealt to Hero [6s 2d]
Dealt to b1b3930a 
Dealt to b1ac0d73 
Dealt to 50f9d2cc 
b1b3930a: folds
b1ac0d73: folds
50f9d2cc: folds
98c7e0e9: folds
68c48621: raises $0.08 to $0.13
Hero: folds
Uncalled bet ($0.08) returned to 68c48621
*** SHOWDOWN ***
68c48621 collected $0.1 from pot
*** SUMMARY ***
Total pot $0.1 | Rake $0 | Jackpot $0 | Bingo $0 | Fortune $0 | Tax $0
Seat 1: 98c7e0e9 (button) folded before Flop (didn't bet)
Seat 2: 68c48621 (small blind) collected ($0.1)
Seat 3: Hero (big blind) folded before Flop
Seat 4: b1b3930a folded before Flop (didn't bet)
Seat 5: b1ac0d73 folded before Flop (didn't bet)
Seat 6: 50f9d2cc folded before Flop (didn't bet)


Poker Hand #RC3795976727: Hold'em No Limit ($0.02/$0.05) - 2025/08/10 08:55:29
Table 'RushAndCash11071987' 6-max Seat #1 is the button
Seat 1: Hero ($12.93 in chips)
Seat 2: 662fd34 ($3.26 in chips)
Seat 3: c870b5d7 ($5.46 in chips)
Seat 4: 35c42e8c ($11.71 in chips)
Seat 5: 93754e0d ($7.02 in chips)
Seat 6: a361fe13 ($7.5 in chips)
662fd34: posts small blind $0.02
c870b5d7: posts big blind $0.05
*** HOLE CARDS ***
Dealt to Hero [Kc 7h]
Dealt to 662fd34 
Dealt to c870b5d7 
Dealt to 35c42e8c 
Dealt to 93754e0d 
Dealt to a361fe13 
35c42e8c: folds
93754e0d: folds
a361fe13: folds
Hero: folds
662fd34: folds
Uncalled bet ($0.03) returned to c870b5d7
*** SHOWDOWN ***
c870b5d7 collected $0.04 from pot
*** SUMMARY ***
Total pot $0.04 | Rake $0 | Jackpot $0 | Bingo $0 | Fortune $0 | Tax $0
Seat 1: Hero (button) folded before Flop (didn't bet)
Seat 2: 662fd34 (small blind) folded before Flop
Seat 3: c870b5d7 (big blind) collected ($0.04)
Seat 4: 35c42e8c folded before Flop (didn't bet)
Seat 5: 93754e0d folded before Flop (didn't bet)
Seat 6: a361fe13 folded before Flop (didn't bet)


Poker Hand #RC3795976698: Hold'em No Limit ($0.02/$0.05) - 2025/08/10 08:55:22
Table 'RushAndCash11071958' 6-max Seat #1 is the button
Seat 1: ef16305 ($6.5 in chips)
Seat 2: Hero ($12.95 in chips)
Seat 3: 7d9c970c ($5 in chips)
Seat 4: 60890e17 ($5 in chips)
Seat 5: 8b4bad56 ($1.16 in chips)
Seat 6: 99058ade ($8.79 in chips)
Hero: posts small blind $0.02
7d9c970c: posts big blind $0.05
*** HOLE CARDS ***
Dealt to ef16305 
Dealt to Hero [Td 8c]
Dealt to 7d9c970c 
Dealt to 60890e17 
Dealt to 8b4bad56 
Dealt to 99058ade 
60890e17: raises $0.05 to $0.1
8b4bad56: folds
99058ade: calls $0.1
ef16305: raises $0.28 to $0.38
Hero: folds
7d9c970c: folds
60890e17: folds
99058ade: calls $0.28
*** FLOP *** [4s 7d 7c]
99058ade: checks
ef16305: bets $0.28
99058ade: raises $1.12 to $1.4
ef16305: folds
Uncalled bet ($1.12) returned to 99058ade
*** SHOWDOWN ***
99058ade collected $1.42 from pot
*** SUMMARY ***
Total pot $1.49 | Rake $0.07 | Jackpot $0 | Bingo $0 | Fortune $0 | Tax $0
Board [4s 7d 7c]
Seat 1: ef16305 (button) folded on the Flop
Seat 2: Hero (small blind) folded before Flop
Seat 3: 7d9c970c (big blind) folded before Flop
Seat 4: 60890e17 folded before Flop
Seat 5: 8b4bad56 folded before Flop (didn't bet)
Seat 6: 99058ade won ($1.42)


Poker Hand #RC3795976684: Hold'em No Limit ($0.02/$0.05) - 2025/08/10 08:55:19
Table 'RushAndCash11071944' 6-max Seat #1 is the button
Seat 1: 2c53d2c7 ($5.25 in chips)
Seat 2: d97bce4f ($16.56 in chips)
Seat 3: ef16305 ($6.55 in chips)
Seat 4: 971f8a92 ($9.5 in chips)
Seat 5: Hero ($12.95 in chips)
Seat 6: 34f17b0d ($7.92 in chips)
d97bce4f: posts small blind $0.02
ef16305: posts big blind $0.05
*** HOLE CARDS ***
Dealt to 2c53d2c7 
Dealt to d97bce4f 
Dealt to ef16305 
Dealt to 971f8a92 
Dealt to Hero [As 2c]
Dealt to 34f17b0d 
971f8a92: folds
Hero: folds
34f17b0d: raises $0.05 to $0.1
2c53d2c7: folds
d97bce4f: folds
ef16305: folds
Uncalled bet ($0.05) returned to 34f17b0d
*** SHOWDOWN ***
34f17b0d collected $0.12 from pot
*** SUMMARY ***
Total pot $0.12 | Rake $0 | Jackpot $0 | Bingo $0 | Fortune $0 | Tax $0
Seat 1: 2c53d2c7 (button) folded before Flop (didn't bet)
Seat 2: d97bce4f (small blind) folded before Flop
Seat 3: ef16305 (big blind) folded before Flop
Seat 4: 971f8a92 folded before Flop (didn't bet)
Seat 5: Hero folded before Flop (didn't bet)
Seat 6: 34f17b0d collected ($0.12)


Poker Hand #RC3795976669: Hold'em No Limit ($0.02/$0.05) - 2025/08/10 08:55:15
Table 'RushAndCash11071929' 6-max Seat #1 is the button
Seat 1: a08146b8 ($5.17 in chips)
Seat 2: 7244fd77 ($5.55 in chips)
Seat 3: 9095f6a6 ($6.35 in chips)
Seat 4: 91b024bc ($11.55 in chips)
Seat 5: 9a343d90 ($10.37 in chips)
Seat 6: Hero ($12.95 in chips)
7244fd77: posts small blind $0.02
9095f6a6: posts big blind $0.05
*** HOLE CARDS ***
Dealt to a08146b8 
Dealt to 7244fd77 
Dealt to 9095f6a6 
Dealt to 91b024bc 
Dealt to 9a343d90 
Dealt to Hero [Ac 7s]
91b024bc: raises $0.05 to $0.1
9a343d90: folds
Hero: folds
a08146b8: folds
7244fd77: folds
9095f6a6: folds
Uncalled bet ($0.05) returned to 91b024bc
*** SHOWDOWN ***
91b024bc collected $0.12 from pot
*** SUMMARY ***
Total pot $0.12 | Rake $0 | Jackpot $0 | Bingo $0 | Fortune $0 | Tax $0
Seat 1: a08146b8 (button) folded before Flop (didn't bet)
Seat 2: 7244fd77 (small blind) folded before Flop
Seat 3: 9095f6a6 (big blind) folded before Flop
Seat 4: 91b024bc collected ($0.12)
Seat 5: 9a343d90 folded before Flop (didn't bet)
Seat 6: Hero folded before Flop (didn't bet)


Poker Hand #RC3795976476: Hold'em No Limit ($0.02/$0.05) - 2025/08/10 08:54:23
Table 'RushAndCash11071736' 6-max Seat #1 is the button
Seat 1: cd7dffc4 ($11.74 in chips)
Seat 2: 92509c17 ($5.69 in chips)
Seat 3: ddd082ae ($5.86 in chips)
Seat 4: Hero ($13.35 in chips)
Seat 5: c3409b4 ($5.37 in chips)
Seat 6: 91b024bc ($11.12 in chips)
92509c17: posts small blind $0.02
ddd082ae: posts big blind $0.05
*** HOLE CARDS ***
Dealt to cd7dffc4 
Dealt to 92509c17 
Dealt to ddd082ae 
Dealt to Hero [Qc Jc]
Dealt to c3409b4 
Dealt to 91b024bc 
Hero: raises $0.05 to $0.1
c3409b4: folds
91b024bc: raises $0.3 to $0.4
cd7dffc4: folds
92509c17: folds
ddd082ae: folds
Hero: calls $0.3
*** FLOP *** [2d 2h 9h]
Hero: checks
91b024bc: bets $0.35
Hero: folds
Uncalled bet ($0.35) returned to 91b024bc
*** SHOWDOWN ***
91b024bc collected $0.83 from pot
*** SUMMARY ***
Total pot $0.87 | Rake $0.04 | Jackpot $0 | Bingo $0 | Fortune $0 | Tax $0
Board [2d 2h 9h]
Seat 1: cd7dffc4 (button) folded before Flop (didn't bet)
Seat 2: 92509c17 (small blind) folded before Flop
Seat 3: ddd082ae (big blind) folded before Flop
Seat 4: Hero folded on the Flop
Seat 5: c3409b4 folded before Flop (didn't bet)
Seat 6: 91b024bc won ($0.83)


Poker Hand #RC3795976412: Hold'em No Limit ($0.02/$0.05) - 2025/08/10 08:54:08
Table 'RushAndCash11071672' 6-max Seat #1 is the button
Seat 1: e9f334c0 ($14.76 in chips)
Seat 2: 7911ebbe ($5 in chips)
Seat 3: Hero ($13.4 in chips)
Seat 4: 9c6cac08 ($5 in chips)
Seat 5: 92509c17 ($5.67 in chips)
Seat 6: 7d9c970c ($5.06 in chips)
7911ebbe: posts small blind $0.02
Hero: posts big blind $0.05
*** HOLE CARDS ***
Dealt to e9f334c0 
Dealt to 7911ebbe 
Dealt to Hero [3s Tc]
Dealt to 9c6cac08 
Dealt to 92509c17 
Dealt to 7d9c970c 
9c6cac08: raises $0.05 to $0.1
92509c17: folds
7d9c970c: folds
e9f334c0: folds
7911ebbe: folds
Hero: folds
Uncalled bet ($0.05) returned to 9c6cac08
*** SHOWDOWN ***
9c6cac08 collected $0.12 from pot
*** SUMMARY ***
Total pot $0.12 | Rake $0 | Jackpot $0 | Bingo $0 | Fortune $0 | Tax $0
Seat 1: e9f334c0 (button) folded before Flop (didn't bet)
Seat 2: 7911ebbe (small blind) folded before Flop
Seat 3: Hero (big blind) folded before Flop
Seat 4: 9c6cac08 collected ($0.12)
Seat 5: 92509c17 folded before Flop (didn't bet)
Seat 6: 7d9c970c folded before Flop (didn't bet)


Poker Hand #RC3795976396: Hold'em No Limit ($0.02/$0.05) - 2025/08/10 08:54:05
Table 'RushAndCash11071656' 6-max Seat #1 is the button
Seat 1: d796f1b5 ($19.78 in chips)
Seat 2: Hero ($13.42 in chips)
Seat 3: ad9c4672 ($5.53 in chips)
Seat 4: 64601e60 ($10.06 in chips)
Seat 5: 9c6cac08 ($5 in chips)
Seat 6: 6412bd28 ($4.92 in chips)
Hero: posts small blind $0.02
ad9c4672: posts big blind $0.05
*** HOLE CARDS ***
Dealt to d796f1b5 
Dealt to Hero [7h 4c]
Dealt to ad9c4672 
Dealt to 64601e60 
Dealt to 9c6cac08 
Dealt to 6412bd28 
64601e60: raises $0.05 to $0.1
9c6cac08: folds
6412bd28: raises $0.14 to $0.24
d796f1b5: folds
Hero: folds
ad9c4672: folds
64601e60: calls $0.14
*** FLOP *** [6h 7c 5c]
64601e60: checks
6412bd28: bets $0.19
64601e60: calls $0.19
*** TURN *** [6h 7c 5c] [9c]
64601e60: checks
6412bd28: bets $0.31
64601e60: calls $0.31
*** RIVER *** [6h 7c 5c 9c] [Qh]
64601e60: bets $0.93
6412bd28: raises $3.25 to $4.18 and is all-in
64601e60: folds
Uncalled bet ($3.25) returned to 6412bd28
*** SHOWDOWN ***
6412bd28 collected $3.19 from pot
*** SUMMARY ***
Total pot $3.41 | Rake $0.15 | Jackpot $0.07 | Bingo $0 | Fortune $0 | Tax $0
Board [6h 7c 5c 9c Qh]
Seat 1: d796f1b5 (button) folded before Flop (didn't bet)
Seat 2: Hero (small blind) folded before Flop
Seat 3: ad9c4672 (big blind) folded before Flop
Seat 4: 64601e60 folded on the River
Seat 5: 9c6cac08 folded before Flop (didn't bet)
Seat 6: 6412bd28 won ($3.19)


Poker Hand #RC3795976253: Hold'em No Limit ($0.02/$0.05) - 2025/08/10 08:53:27
Table 'RushAndCash11071513' 6-max Seat #1 is the button
Seat 1: Hero ($13.74 in chips)
Seat 2: 945ad682 ($5.09 in chips)
Seat 3: 6412bd28 ($4.61 in chips)
Seat 4: a8b73c32 ($5.14 in chips)
Seat 5: 43f64b9b ($6.76 in chips)
Seat 6: ec2068d4 ($5.07 in chips)
945ad682: posts small blind $0.02
6412bd28: posts big blind $0.05
*** HOLE CARDS ***
Dealt to Hero [6h 5h]
Dealt to 945ad682 
Dealt to 6412bd28 
Dealt to a8b73c32 
Dealt to 43f64b9b 
Dealt to ec2068d4 
a8b73c32: folds
43f64b9b: folds
ec2068d4: folds
Hero: raises $0.05 to $0.1
945ad682: folds
6412bd28: calls $0.05
*** FLOP *** [8d 9d 9h]
6412bd28: checks
Hero: checks
*** TURN *** [8d 9d 9h] [Qh]
6412bd28: bets $0.22
Hero: calls $0.22
*** RIVER *** [8d 9d 9h Qh] [4s]
6412bd28: bets $0.66
Hero: folds
Uncalled bet ($0.66) returned to 6412bd28
*** SHOWDOWN ***
6412bd28 collected $0.63 from pot
*** SUMMARY ***
Total pot $0.66 | Rake $0.03 | Jackpot $0 | Bingo $0 | Fortune $0 | Tax $0
Board [8d 9d 9h Qh 4s]
Seat 1: Hero (button) folded on the River
Seat 2: 945ad682 (small blind) folded before Flop
Seat 3: 6412bd28 (big blind) won ($0.63)
Seat 4: a8b73c32 folded before Flop (didn't bet)
Seat 5: 43f64b9b folded before Flop (didn't bet)
Seat 6: ec2068d4 folded before Flop (didn't bet)


Poker Hand #RC3795976241: Hold'em No Limit ($0.02/$0.05) - 2025/08/10 08:53:23
Table 'RushAndCash11071501' 6-max Seat #1 is the button
Seat 1: d466ce85 ($7.64 in chips)
Seat 2: c38047a5 ($5.54 in chips)
Seat 3: afdaf82b ($4.81 in chips)
Seat 4: fd8ef7f7 ($5.78 in chips)
Seat 5: Hero ($13.74 in chips)
Seat 6: 5c5d4a8d ($12.15 in chips)
c38047a5: posts small blind $0.02
afdaf82b: posts big blind $0.05
*** HOLE CARDS ***
Dealt to d466ce85 
Dealt to c38047a5 
Dealt to afdaf82b 
Dealt to fd8ef7f7 
Dealt to Hero [9c Td]
Dealt to 5c5d4a8d 
fd8ef7f7: folds
Hero: folds
5c5d4a8d: folds
d466ce85: folds
c38047a5: folds
Uncalled bet ($0.03) returned to afdaf82b
*** SHOWDOWN ***
afdaf82b collected $0.04 from pot
*** SUMMARY ***
Total pot $0.04 | Rake $0 | Jackpot $0 | Bingo $0 | Fortune $0 | Tax $0
Seat 1: d466ce85 (button) folded before Flop (didn't bet)
Seat 2: c38047a5 (small blind) folded before Flop
Seat 3: afdaf82b (big blind) collected ($0.04)
Seat 4: fd8ef7f7 folded before Flop (didn't bet)
Seat 5: Hero folded before Flop (didn't bet)
Seat 6: 5c5d4a8d folded before Flop (didn't bet)


Poker Hand #RC3795976226: Hold'em No Limit ($0.02/$0.05) - 2025/08/10 08:53:20
Table 'RushAndCash11071486' 6-max Seat #1 is the button
Seat 1: d6441c19 ($4.47 in chips)
Seat 2: 6487a64d ($10.47 in chips)
Seat 3: 22d5981a ($5.14 in chips)
Seat 4: 41ed372d ($7.66 in chips)
Seat 5: c4cbb3ef ($8.66 in chips)
Seat 6: Hero ($13.74 in chips)
6487a64d: posts small blind $0.02
22d5981a: posts big blind $0.05
*** HOLE CARDS ***
Dealt to d6441c19 
Dealt to 6487a64d 
Dealt to 22d5981a 
Dealt to 41ed372d 
Dealt to c4cbb3ef 
Dealt to Hero [Kc 8s]
41ed372d: folds
c4cbb3ef: folds
Hero: folds
d6441c19: raises $0.06 to $0.11
6487a64d: folds
22d5981a: folds
Uncalled bet ($0.06) returned to d6441c19
*** SHOWDOWN ***
d6441c19 collected $0.12 from pot
*** SUMMARY ***
Total pot $0.12 | Rake $0 | Jackpot $0 | Bingo $0 | Fortune $0 | Tax $0
Seat 1: d6441c19 (button) collected ($0.12)
Seat 2: 6487a64d (small blind) folded before Flop
Seat 3: 22d5981a (big blind) folded before Flop
Seat 4: 41ed372d folded before Flop (didn't bet)
Seat 5: c4cbb3ef folded before Flop (didn't bet)
Seat 6: Hero folded before Flop (didn't bet)


Poker Hand #RC3795976211: Hold'em No Limit ($0.02/$0.05) - 2025/08/10 08:53:16
Table 'RushAndCash11071471' 6-max Seat #1 is the button
Seat 1: 23739ee8 ($6.96 in chips)
Seat 2: e23a6898 ($10.45 in chips)
Seat 3: b1ac0d73 ($5.68 in chips)
Seat 4: cbf461b9 ($3.98 in chips)
Seat 5: Hero ($13.74 in chips)
Seat 6: d466ce85 ($7.64 in chips)
e23a6898: posts small blind $0.02
b1ac0d73: posts big blind $0.05
*** HOLE CARDS ***
Dealt to 23739ee8 
Dealt to e23a6898 
Dealt to b1ac0d73 
Dealt to cbf461b9 
Dealt to Hero [2h 9s]
Dealt to d466ce85 
cbf461b9: folds
Hero: folds
d466ce85: folds
23739ee8: folds
e23a6898: folds
Uncalled bet ($0.03) returned to b1ac0d73
*** SHOWDOWN ***
b1ac0d73 collected $0.04 from pot
*** SUMMARY ***
Total pot $0.04 | Rake $0 | Jackpot $0 | Bingo $0 | Fortune $0 | Tax $0
Seat 1: 23739ee8 (button) folded before Flop (didn't bet)
Seat 2: e23a6898 (small blind) folded before Flop
Seat 3: b1ac0d73 (big blind) collected ($0.04)
Seat 4: cbf461b9 folded before Flop (didn't bet)
Seat 5: Hero folded before Flop (didn't bet)
Seat 6: d466ce85 folded before Flop (didn't bet)


Poker Hand #RC3795976190: Hold'em No Limit ($0.02/$0.05) - 2025/08/10 08:53:11
Table 'RushAndCash11071450' 6-max Seat #1 is the button
Seat 1: 6412bd28 ($4.54 in chips)
Seat 2: 7bd4810f ($5.47 in chips)
Seat 3: Hero ($13.79 in chips)
Seat 4: 6d940edd ($6.88 in chips)
Seat 5: 4ba45dd4 ($5 in chips)
Seat 6: 92b7243a ($5 in chips)
7bd4810f: posts small blind $0.02
Hero: posts big blind $0.05
*** HOLE CARDS ***
Dealt to 6412bd28 
Dealt to 7bd4810f 
Dealt to Hero [4s 5h]
Dealt to 6d940edd 
Dealt to 4ba45dd4 
Dealt to 92b7243a 
6d940edd: folds
4ba45dd4: folds
92b7243a: folds
6412bd28: raises $0.1 to $0.15
7bd4810f: folds
Hero: folds
Uncalled bet ($0.1) returned to 6412bd28
*** SHOWDOWN ***
6412bd28 collected $0.12 from pot
*** SUMMARY ***
Total pot $0.12 | Rake $0 | Jackpot $0 | Bingo $0 | Fortune $0 | Tax $0
Seat 1: 6412bd28 (button) collected ($0.12)
Seat 2: 7bd4810f (small blind) folded before Flop
Seat 3: Hero (big blind) folded before Flop
Seat 4: 6d940edd folded before Flop (didn't bet)
Seat 5: 4ba45dd4 folded before Flop (didn't bet)
Seat 6: 92b7243a folded before Flop (didn't bet)


Poker Hand #RC3795975986: Hold'em No Limit ($0.02/$0.05) - 2025/08/10 08:52:19
Table 'RushAndCash11071246' 6-max Seat #1 is the button
Seat 1: Hero ($14.07 in chips)
Seat 2: f3a1d090 ($23.77 in chips)
Seat 3: 7bd4810f ($5.19 in chips)
Seat 4: d3b2bf87 ($9.97 in chips)
Seat 5: e2ddd0b5 ($4.31 in chips)
Seat 6: 94188a14 ($5.93 in chips)
f3a1d090: posts small blind $0.02
7bd4810f: posts big blind $0.05
*** HOLE CARDS ***
Dealt to Hero [7s Ks]
Dealt to f3a1d090 
Dealt to 7bd4810f 
Dealt to d3b2bf87 
Dealt to e2ddd0b5 
Dealt to 94188a14 
d3b2bf87: folds
e2ddd0b5: folds
94188a14: folds
Hero: raises $0.05 to $0.1
f3a1d090: folds
7bd4810f: calls $0.05
*** FLOP *** [2h Jc Qh]
7bd4810f: checks
Hero: checks
*** TURN *** [2h Jc Qh] [Ac]
7bd4810f: checks
Hero: bets $0.18
7bd4810f: calls $0.18
*** RIVER *** [2h Jc Qh Ac] [7h]
7bd4810f: checks
Hero: checks
7bd4810f: shows [8s Ah] (a pair of Aces)
Hero: shows [7s Ks] (a pair of Sevens)
*** SHOWDOWN ***
7bd4810f collected $0.56 from pot
*** SUMMARY ***
Total pot $0.58 | Rake $0.02 | Jackpot $0 | Bingo $0 | Fortune $0 | Tax $0
Board [2h Jc Qh Ac 7h]
Seat 1: Hero (button) showed [7s Ks] and lost with a pair of Sevens
Seat 2: f3a1d090 (small blind) folded before Flop
Seat 3: 7bd4810f (big blind) showed [8s Ah] and won ($0.56) with a pair of Aces
Seat 4: d3b2bf87 folded before Flop (didn't bet)
Seat 5: e2ddd0b5 folded before Flop (didn't bet)
Seat 6: 94188a14 folded before Flop (didn't bet)


Poker Hand #RC3795975966: Hold'em No Limit ($0.02/$0.05) - 2025/08/10 08:52:14
Table 'RushAndCash11071226' 6-max Seat #1 is the button
Seat 1: 86d57974 ($5.25 in chips)
Seat 2: Hero ($14.09 in chips)
Seat 3: e35de614 ($5.05 in chips)
Seat 4: d796f1b5 ($18.17 in chips)
Seat 5: 630dda79 ($5.05 in chips)
Seat 6: e9f334c0 ($13.97 in chips)
Hero: posts small blind $0.02
e35de614: posts big blind $0.05
*** HOLE CARDS ***
Dealt to 86d57974 
Dealt to Hero [Jc 8s]
Dealt to e35de614 
Dealt to d796f1b5 
Dealt to 630dda79 
Dealt to e9f334c0 
d796f1b5: folds
630dda79: raises $0.05 to $0.1
e9f334c0: folds
86d57974: folds
Hero: folds
e35de614: calls $0.05
*** FLOP *** [Jh 2h 5h]
e35de614: checks
630dda79: checks
*** TURN *** [Jh 2h 5h] [5c]
e35de614: bets $0.11
630dda79: folds
Uncalled bet ($0.11) returned to e35de614
*** SHOWDOWN ***
e35de614 collected $0.21 from pot
*** SUMMARY ***
Total pot $0.22 | Rake $0.01 | Jackpot $0 | Bingo $0 | Fortune $0 | Tax $0
Board [Jh 2h 5h 5c]
Seat 1: 86d57974 (button) folded before Flop (didn't bet)
Seat 2: Hero (small blind) folded before Flop
Seat 3: e35de614 (big blind) won ($0.21)
Seat 4: d796f1b5 folded before Flop (didn't bet)
Seat 5: 630dda79 folded on the Turn
Seat 6: e9f334c0 folded before Flop (didn't bet)


Poker Hand #RC3795975953: Hold'em No Limit ($0.02/$0.05) - 2025/08/10 08:52:10
Table 'RushAndCash11071213' 6-max Seat #1 is the button
Seat 1: de160a56 ($5.27 in chips)
Seat 2: 28a55cc9 ($5.69 in chips)
Seat 3: 86d57974 ($5.3 in chips)
Seat 4: Hero ($14.09 in chips)
Seat 5: 279a8e9f ($6.83 in chips)
Seat 6: dc4f2a76 ($8.14 in chips)
28a55cc9: posts small blind $0.02
86d57974: posts big blind $0.05
*** HOLE CARDS ***
Dealt to de160a56 
Dealt to 28a55cc9 
Dealt to 86d57974 
Dealt to Hero [4s Tc]
Dealt to 279a8e9f 
Dealt to dc4f2a76 
Hero: folds
279a8e9f: folds
dc4f2a76: raises $0.08 to $0.13
de160a56: folds
28a55cc9: calls $0.11
86d57974: folds
*** FLOP *** [2d 7d 8s]
28a55cc9: checks
dc4f2a76: bets $0.24
28a55cc9: calls $0.24
*** TURN *** [2d 7d 8s] [8h]
28a55cc9: bets $0.79
dc4f2a76: calls $0.79
*** RIVER *** [2d 7d 8s 8h] [9s]
28a55cc9: checks
dc4f2a76: checks
28a55cc9: shows [Qh 7h] (two pair, Eights and Sevens)
dc4f2a76: shows [Ah As] (two pair, Aces and Eights)
*** SHOWDOWN ***
dc4f2a76 collected $2.19 from pot
*** SUMMARY ***
Total pot $2.37 | Rake $0.11 | Jackpot $0.07 | Bingo $0 | Fortune $0 | Tax $0
Board [2d 7d 8s 8h 9s]
Seat 1: de160a56 (button) folded before Flop (didn't bet)
Seat 2: 28a55cc9 (small blind) showed [Qh 7h] and lost with two pair, Eights and Sevens
Seat 3: 86d57974 (big blind) folded before Flop
Seat 4: Hero folded before Flop (didn't bet)
Seat 5: 279a8e9f folded before Flop (didn't bet)
Seat 6: dc4f2a76 showed [Ah As] and won ($2.19) with two pair, Aces and Eights


Poker Hand #RC3795975941: Hold'em No Limit ($0.02/$0.05) - 2025/08/10 08:52:07
Table 'RushAndCash11071201' 6-max Seat #1 is the button
Seat 1: d3b2bf87 ($9.9 in chips)
Seat 2: 1d9a9697 ($6.47 in chips)
Seat 3: f1d249e2 ($7.14 in chips)
Seat 4: Hero ($14.09 in chips)
Seat 5: 2ae3e290 ($7.58 in chips)
Seat 6: de160a56 ($5.27 in chips)
1d9a9697: posts small blind $0.02
f1d249e2: posts big blind $0.05
*** HOLE CARDS ***
Dealt to d3b2bf87 
Dealt to 1d9a9697 
Dealt to f1d249e2 
Dealt to Hero [6s 7c]
Dealt to 2ae3e290 
Dealt to de160a56 
Hero: folds
2ae3e290: folds
de160a56: folds
d3b2bf87: raises $0.07 to $0.12
1d9a9697: folds
f1d249e2: folds
Uncalled bet ($0.07) returned to d3b2bf87
*** SHOWDOWN ***
d3b2bf87 collected $0.12 from pot
*** SUMMARY ***
Total pot $0.12 | Rake $0 | Jackpot $0 | Bingo $0 | Fortune $0 | Tax $0
Seat 1: d3b2bf87 (button) collected ($0.12)
Seat 2: 1d9a9697 (small blind) folded before Flop
Seat 3: f1d249e2 (big blind) folded before Flop
Seat 4: Hero folded before Flop (didn't bet)
Seat 5: 2ae3e290 folded before Flop (didn't bet)
Seat 6: de160a56 folded before Flop (didn't bet)


Poker Hand #RC3795975837: Hold'em No Limit ($0.02/$0.05) - 2025/08/10 08:51:40
Table 'RushAndCash11071097' 6-max Seat #1 is the button
Seat 1: 14ed52c2 ($2.13 in chips)
Seat 2: 9c6cac08 ($5 in chips)
Seat 3: d3b2bf87 ($9.69 in chips)
Seat 4: 3f5c4b90 ($6.9 in chips)
Seat 5: Hero ($14.19 in chips)
Seat 6: ec2068d4 ($5 in chips)
9c6cac08: posts small blind $0.02
d3b2bf87: posts big blind $0.05
*** HOLE CARDS ***
Dealt to 14ed52c2 
Dealt to 9c6cac08 
Dealt to d3b2bf87 
Dealt to 3f5c4b90 
Dealt to Hero [Ad Tc]
Dealt to ec2068d4 
3f5c4b90: folds
Hero: raises $0.05 to $0.1
ec2068d4: folds
14ed52c2: calls $0.1
9c6cac08: folds
d3b2bf87: calls $0.05
*** FLOP *** [4s 6c 5h]
d3b2bf87: checks
Hero: checks
14ed52c2: checks
*** TURN *** [4s 6c 5h] [9c]
d3b2bf87: bets $0.24
Hero: folds
14ed52c2: folds
Uncalled bet ($0.24) returned to d3b2bf87
*** SHOWDOWN ***
d3b2bf87 collected $0.31 from pot
*** SUMMARY ***
Total pot $0.32 | Rake $0.01 | Jackpot $0 | Bingo $0 | Fortune $0 | Tax $0
Board [4s 6c 5h 9c]
Seat 1: 14ed52c2 (button) folded on the Turn
Seat 2: 9c6cac08 (small blind) folded before Flop
Seat 3: d3b2bf87 (big blind) won ($0.31)
Seat 4: 3f5c4b90 folded before Flop (didn't bet)
Seat 5: Hero folded on the Turn
Seat 6: ec2068d4 folded before Flop (didn't bet)


Poker Hand #RC3795975791: Hold'em No Limit ($0.02/$0.05) - 2025/08/10 08:51:26
Table 'RushAndCash11071051' 6-max Seat #1 is the button
Seat 1: 66a574d1 ($5.45 in chips)
Seat 2: e4727e9b ($5.51 in chips)
Seat 3: eb6b9c9e ($5.24 in chips)
Seat 4: cbf461b9 ($5.32 in chips)
Seat 5: Hero ($14.12 in chips)
Seat 6: f38b69c2 ($5.55 in chips)
e4727e9b: posts small blind $0.02
eb6b9c9e: posts big blind $0.05
*** HOLE CARDS ***
Dealt to 66a574d1 
Dealt to e4727e9b 
Dealt to eb6b9c9e 
Dealt to cbf461b9 
Dealt to Hero [Ks As]
Dealt to f38b69c2 
cbf461b9: folds
Hero: raises $0.07 to $0.12
f38b69c2: folds
66a574d1: folds
e4727e9b: folds
eb6b9c9e: folds
Uncalled bet ($0.07) returned to Hero
*** SHOWDOWN ***
Hero collected $0.12 from pot
*** SUMMARY ***
Total pot $0.12 | Rake $0 | Jackpot $0 | Bingo $0 | Fortune $0 | Tax $0
Seat 1: 66a574d1 (button) folded before Flop (didn't bet)
Seat 2: e4727e9b (small blind) folded before Flop
Seat 3: eb6b9c9e (big blind) folded before Flop
Seat 4: cbf461b9 folded before Flop (didn't bet)
Seat 5: Hero collected ($0.12)
Seat 6: f38b69c2 folded before Flop (didn't bet)


Poker Hand #RC3795975778: Hold'em No Limit ($0.02/$0.05) - 2025/08/10 08:51:22
Table 'RushAndCash11071038' 6-max Seat #1 is the button
Seat 1: a4b58f11 ($9.71 in chips)
Seat 2: 97f832bf ($13.18 in chips)
Seat 3: 29035a3b ($7.82 in chips)
Seat 4: Hero ($14.12 in chips)
Seat 5: d466ce85 ($7.64 in chips)
Seat 6: ddd082ae ($5.81 in chips)
97f832bf: posts small blind $0.02
29035a3b: posts big blind $0.05
*** HOLE CARDS ***
Dealt to a4b58f11 
Dealt to 97f832bf 
Dealt to 29035a3b 
Dealt to Hero [Kd 3h]
Dealt to d466ce85 
Dealt to ddd082ae 
Hero: folds
d466ce85: folds
ddd082ae: folds
a4b58f11: raises $0.07 to $0.12
97f832bf: folds
29035a3b: folds
Uncalled bet ($0.07) returned to a4b58f11
*** SHOWDOWN ***
a4b58f11 collected $0.12 from pot
*** SUMMARY ***
Total pot $0.12 | Rake $0 | Jackpot $0 | Bingo $0 | Fortune $0 | Tax $0
Seat 1: a4b58f11 (button) collected ($0.12)
Seat 2: 97f832bf (small blind) folded before Flop
Seat 3: 29035a3b (big blind) folded before Flop
Seat 4: Hero folded before Flop (didn't bet)
Seat 5: d466ce85 folded before Flop (didn't bet)
Seat 6: ddd082ae folded before Flop (didn't bet)


Poker Hand #RC3795975734: Hold'em No Limit ($0.02/$0.05) - 2025/08/10 08:51:10
Table 'RushAndCash11070994' 6-max Seat #1 is the button
Seat 1: 6780a6cb ($7 in chips)
Seat 2: c4ed83bc ($6.94 in chips)
Seat 3: 513bb8fb ($2.75 in chips)
Seat 4: Hero ($14.05 in chips)
Seat 5: 5e046aad ($5.15 in chips)
Seat 6: 9c6cac08 ($5 in chips)
c4ed83bc: posts small blind $0.02
513bb8fb: posts big blind $0.05
*** HOLE CARDS ***
Dealt to 6780a6cb 
Dealt to c4ed83bc 
Dealt to 513bb8fb 
Dealt to Hero [Js 8s]
Dealt to 5e046aad 
Dealt to 9c6cac08 
Hero: raises $0.05 to $0.1
5e046aad: folds
9c6cac08: folds
6780a6cb: folds
c4ed83bc: folds
513bb8fb: folds
Uncalled bet ($0.05) returned to Hero
*** SHOWDOWN ***
Hero collected $0.12 from pot
*** SUMMARY ***
Total pot $0.12 | Rake $0 | Jackpot $0 | Bingo $0 | Fortune $0 | Tax $0
Seat 1: 6780a6cb (button) folded before Flop (didn't bet)
Seat 2: c4ed83bc (small blind) folded before Flop
Seat 3: 513bb8fb (big blind) folded before Flop
Seat 4: Hero collected ($0.12)
Seat 5: 5e046aad folded before Flop (didn't bet)
Seat 6: 9c6cac08 folded before Flop (didn't bet)


Poker Hand #RC3795975619: Hold'em No Limit ($0.02/$0.05) - 2025/08/10 08:50:39
Table 'RushAndCash11070879' 6-max Seat #1 is the button
Seat 1: 5fa26c5f ($5 in chips)
Seat 2: Hero ($14 in chips)
Seat 3: d8b9a478 ($7.5 in chips)
Seat 4: 43f64b9b ($6.86 in chips)
Seat 5: 31be6d88 ($5.18 in chips)
Seat 6: 9daec63f ($1.11 in chips)
Hero: posts small blind $0.02
d8b9a478: posts big blind $0.05
*** HOLE CARDS ***
Dealt to 5fa26c5f 
Dealt to Hero [Qc Ah]
Dealt to d8b9a478 
Dealt to 43f64b9b 
Dealt to 31be6d88 
Dealt to 9daec63f 
43f64b9b: folds
31be6d88: folds
9daec63f: folds
5fa26c5f: folds
Hero: raises $0.09 to $0.14
d8b9a478: folds
Uncalled bet ($0.09) returned to Hero
*** SHOWDOWN ***
Hero collected $0.1 from pot
*** SUMMARY ***
Total pot $0.1 | Rake $0 | Jackpot $0 | Bingo $0 | Fortune $0 | Tax $0
Seat 1: 5fa26c5f (button) folded before Flop (didn't bet)
Seat 2: Hero (small blind) collected ($0.1)
Seat 3: d8b9a478 (big blind) folded before Flop
Seat 4: 43f64b9b folded before Flop (didn't bet)
Seat 5: 31be6d88 folded before Flop (didn't bet)
Seat 6: 9daec63f folded before Flop (didn't bet)


Poker Hand #RC3795975393: Hold'em No Limit ($0.02/$0.05) - 2025/08/10 08:49:41
Table 'RushAndCash11070653' 6-max Seat #1 is the button
Seat 1: 43f64b9b ($6.42 in chips)
Seat 2: 15c880d8 ($5.35 in chips)
Seat 3: Hero ($14.15 in chips)
Seat 4: 9daec63f ($1.42 in chips)
Seat 5: 8a484f1f ($13.08 in chips)
Seat 6: a187372 ($5.25 in chips)
15c880d8: posts small blind $0.02
Hero: posts big blind $0.05
*** HOLE CARDS ***
Dealt to 43f64b9b 
Dealt to 15c880d8 
Dealt to Hero [7c Tc]
Dealt to 9daec63f 
Dealt to 8a484f1f 
Dealt to a187372 
9daec63f: raises $0.1 to $0.15
8a484f1f: folds
a187372: folds
43f64b9b: calls $0.15
15c880d8: folds
Hero: calls $0.1
*** FLOP *** [Jd Qh 6d]
Hero: checks
9daec63f: bets $0.16
43f64b9b: calls $0.16
Hero: folds
*** TURN *** [Jd Qh 6d] [5s]
9daec63f: checks
43f64b9b: bets $0.6
9daec63f: folds
Uncalled bet ($0.6) returned to 43f64b9b
*** SHOWDOWN ***
43f64b9b collected $0.75 from pot
*** SUMMARY ***
Total pot $0.79 | Rake $0.04 | Jackpot $0 | Bingo $0 | Fortune $0 | Tax $0
Board [Jd Qh 6d 5s]
Seat 1: 43f64b9b (button) won ($0.75)
Seat 2: 15c880d8 (small blind) folded before Flop
Seat 3: Hero (big blind) folded on the Flop
Seat 4: 9daec63f folded on the Turn
Seat 5: 8a484f1f folded before Flop (didn't bet)
Seat 6: a187372 folded before Flop (didn't bet)


Poker Hand #RC3795975257: Hold'em No Limit ($0.02/$0.05) - 2025/08/10 08:49:06
Table 'RushAndCash11070517' 6-max Seat #1 is the button
Seat 1: Hero ($14.25 in chips)
Seat 2: a187372 ($5.06 in chips)
Seat 3: dc34d8ca ($6.08 in chips)
Seat 4: 92509c17 ($5.4 in chips)
Seat 5: f6fdd16d ($6.16 in chips)
Seat 6: 81dcd1a8 ($6 in chips)
a187372: posts small blind $0.02
dc34d8ca: posts big blind $0.05
*** HOLE CARDS ***
Dealt to Hero [8s 7h]
Dealt to a187372 
Dealt to dc34d8ca 
Dealt to 92509c17 
Dealt to f6fdd16d 
Dealt to 81dcd1a8 
92509c17: folds
f6fdd16d: folds
81dcd1a8: folds
Hero: raises $0.05 to $0.1
a187372: calls $0.08
dc34d8ca: calls $0.05
*** FLOP *** [4c 2d Qs]
a187372: checks
dc34d8ca: checks
Hero: checks
*** TURN *** [4c 2d Qs] [Qd]
a187372: bets $0.1
dc34d8ca: folds
Hero: folds
Uncalled bet ($0.1) returned to a187372
*** SHOWDOWN ***
a187372 collected $0.29 from pot
*** SUMMARY ***
Total pot $0.3 | Rake $0.01 | Jackpot $0 | Bingo $0 | Fortune $0 | Tax $0
Board [4c 2d Qs Qd]
Seat 1: Hero (button) folded on the Turn
Seat 2: a187372 (small blind) won ($0.29)
Seat 3: dc34d8ca (big blind) folded on the Turn
Seat 4: 92509c17 folded before Flop (didn't bet)
Seat 5: f6fdd16d folded before Flop (didn't bet)
Seat 6: 81dcd1a8 folded before Flop (didn't bet)


Poker Hand #RC3795975233: Hold'em No Limit ($0.02/$0.05) - 2025/08/10 08:48:59
Table 'RushAndCash11070493' 6-max Seat #1 is the button
Seat 1: Hero ($14.25 in chips)
Seat 2: c38047a5 ($5.8 in chips)
Seat 3: ae5ace8a ($5.6 in chips)
Seat 4: cb83453e ($14.76 in chips)
Seat 5: 94188a14 ($5.37 in chips)
Seat 6: b1ac0d73 ($5.07 in chips)
c38047a5: posts small blind $0.02
ae5ace8a: posts big blind $0.05
*** HOLE CARDS ***
Dealt to Hero [6s 4h]
Dealt to c38047a5 
Dealt to ae5ace8a 
Dealt to cb83453e 
Dealt to 94188a14 
Dealt to b1ac0d73 
cb83453e: folds
94188a14: folds
b1ac0d73: raises $0.05 to $0.1
Hero: folds
c38047a5: folds
ae5ace8a: calls $0.05
*** FLOP *** [7c Ac 8d]
ae5ace8a: checks
b1ac0d73: checks
*** TURN *** [7c Ac 8d] [Th]
ae5ace8a: bets $0.08
b1ac0d73: calls $0.08
*** RIVER *** [7c Ac 8d Th] [6c]
ae5ace8a: bets $0.38
b1ac0d73: folds
Uncalled bet ($0.38) returned to ae5ace8a
*** SHOWDOWN ***
ae5ace8a collected $0.37 from pot
*** SUMMARY ***
Total pot $0.38 | Rake $0.01 | Jackpot $0 | Bingo $0 | Fortune $0 | Tax $0
Board [7c Ac 8d Th 6c]
Seat 1: Hero (button) folded before Flop (didn't bet)
Seat 2: c38047a5 (small blind) folded before Flop
Seat 3: ae5ace8a (big blind) won ($0.37)
Seat 4: cb83453e folded before Flop (didn't bet)
Seat 5: 94188a14 folded before Flop (didn't bet)
Seat 6: b1ac0d73 folded on the River


Poker Hand #RC3795975224: Hold'em No Limit ($0.02/$0.05) - 2025/08/10 08:48:55
Table 'RushAndCash11070484' 6-max Seat #1 is the button
Seat 1: 28a55cc9 ($5 in chips)
Seat 2: b3eab32a ($5.08 in chips)
Seat 3: 1a36daf0 ($5.07 in chips)
Seat 4: dde92c84 ($14.76 in chips)
Seat 5: 84a6e006 ($8.09 in chips)
Seat 6: Hero ($14.25 in chips)
b3eab32a: posts small blind $0.02
1a36daf0: posts big blind $0.05
*** HOLE CARDS ***
Dealt to 28a55cc9 
Dealt to b3eab32a 
Dealt to 1a36daf0 
Dealt to dde92c84 
Dealt to 84a6e006 
Dealt to Hero [6d As]
dde92c84: folds
84a6e006: folds
Hero: folds
28a55cc9: raises $0.05 to $0.1
b3eab32a: folds
1a36daf0: raises $0.22 to $0.32
28a55cc9: calls $0.22
*** FLOP *** [7c 4h 8h]
1a36daf0: bets $0.5
28a55cc9: calls $0.5
*** TURN *** [7c 4h 8h] [5h]
1a36daf0: bets $1.25
28a55cc9: folds
Uncalled bet ($1.25) returned to 1a36daf0
*** SHOWDOWN ***
1a36daf0 collected $1.51 from pot
*** SUMMARY ***
Total pot $1.66 | Rake $0.08 | Jackpot $0.07 | Bingo $0 | Fortune $0 | Tax $0
Board [7c 4h 8h 5h]
Seat 1: 28a55cc9 (button) folded on the Turn
Seat 2: b3eab32a (small blind) folded before Flop
Seat 3: 1a36daf0 (big blind) won ($1.51)
Seat 4: dde92c84 folded before Flop (didn't bet)
Seat 5: 84a6e006 folded before Flop (didn't bet)
Seat 6: Hero folded before Flop (didn't bet)


Poker Hand #RC3795975177: Hold'em No Limit ($0.02/$0.05) - 2025/08/10 08:48:42
Table 'RushAndCash11070437' 6-max Seat #1 is the button
Seat 1: c1c6f9fc ($5 in chips)
Seat 2: Hero ($14.27 in chips)
Seat 3: d5bb3acb ($3.92 in chips)
Seat 4: d30b0a9c ($5.37 in chips)
Seat 5: d4249213 ($5.05 in chips)
Seat 6: 1a36daf0 ($5.07 in chips)
Hero: posts small blind $0.02
d5bb3acb: posts big blind $0.05
*** HOLE CARDS ***
Dealt to c1c6f9fc 
Dealt to Hero [As 2s]
Dealt to d5bb3acb 
Dealt to d30b0a9c 
Dealt to d4249213 
Dealt to 1a36daf0 
d30b0a9c: folds
d4249213: raises $0.07 to $0.12
1a36daf0: folds
c1c6f9fc: folds
Hero: folds
d5bb3acb: calls $0.07
*** FLOP *** [Kc 8h 6h]
d5bb3acb: checks
d4249213: bets $0.11
d5bb3acb: calls $0.11
*** TURN *** [Kc 8h 6h] [9h]
d5bb3acb: checks
d4249213: checks
*** RIVER *** [Kc 8h 6h 9h] [5c]
d5bb3acb: bets $0.24
d4249213: calls $0.24
d5bb3acb: shows [8d 9s] (two pair, Nines and Eights)
d4249213: shows [9d Ah] (a pair of Nines)
*** SHOWDOWN ***
d5bb3acb collected $0.92 from pot
*** SUMMARY ***
Total pot $0.96 | Rake $0.04 | Jackpot $0 | Bingo $0 | Fortune $0 | Tax $0
Board [Kc 8h 6h 9h 5c]
Seat 1: c1c6f9fc (button) folded before Flop (didn't bet)
Seat 2: Hero (small blind) folded before Flop
Seat 3: d5bb3acb (big blind) showed [8d 9s] and won ($0.92) with two pair, Nines and Eights
Seat 4: d30b0a9c folded before Flop (didn't bet)
Seat 5: d4249213 showed [9d Ah] and lost with a pair of Nines
Seat 6: 1a36daf0 folded before Flop (didn't bet)


Poker Hand #RC3795975159: Hold'em No Limit ($0.02/$0.05) - 2025/08/10 08:48:38
Table 'RushAndCash11070419' 6-max Seat #1 is the button
Seat 1: e6b7142a ($4.85 in chips)
Seat 2: ede202e3 ($7.01 in chips)
Seat 3: Hero ($14.32 in chips)
Seat 4: de160a56 ($7.45 in chips)
Seat 5: bbe7580 ($4.34 in chips)
Seat 6: b527583c ($8.54 in chips)
ede202e3: posts small blind $0.02
Hero: posts big blind $0.05
*** HOLE CARDS ***
Dealt to e6b7142a 
Dealt to ede202e3 
Dealt to Hero [4h Ts]
Dealt to de160a56 
Dealt to bbe7580 
Dealt to b527583c 
de160a56: raises $0.05 to $0.1
bbe7580: calls $0.1
b527583c: folds
e6b7142a: raises $0.5 to $0.6
ede202e3: folds
Hero: folds
de160a56: calls $0.5
bbe7580: folds
*** FLOP *** [Jd As 9s]
de160a56: bets $0.73
e6b7142a: calls $0.73
*** TURN *** [Jd As 9s] [3h]
de160a56: checks
e6b7142a: checks
*** RIVER *** [Jd As 9s 3h] [2h]
de160a56: bets $2.83
e6b7142a: calls $2.83
de160a56: shows [9h 8s] (a pair of Nines)
e6b7142a: shows [Qh Ah] (a pair of Aces)
*** SHOWDOWN ***
e6b7142a collected $8.27 from pot
*** SUMMARY ***
Total pot $8.49 | Rake $0.15 | Jackpot $0.07 | Bingo $0 | Fortune $0 | Tax $0
Board [Jd As 9s 3h 2h]
Seat 1: e6b7142a (button) showed [Qh Ah] and won ($8.27) with a pair of Aces
Seat 2: ede202e3 (small blind) folded before Flop
Seat 3: Hero (big blind) folded before Flop
Seat 4: de160a56 showed [9h 8s] and lost with a pair of Nines
Seat 5: bbe7580 folded before Flop
Seat 6: b527583c folded before Flop (didn't bet)


Poker Hand #RC3795975143: Hold'em No Limit ($0.02/$0.05) - 2025/08/10 08:48:34
Table 'RushAndCash11070403' 6-max Seat #1 is the button
Seat 1: b3eab32a ($5.08 in chips)
Seat 2: ec2068d4 ($5 in chips)
Seat 3: 999a0f96 ($10.42 in chips)
Seat 4: d3b2bf87 ($7.99 in chips)
Seat 5: f2e3feac ($11.59 in chips)
Seat 6: Hero ($14.32 in chips)
ec2068d4: posts small blind $0.02
999a0f96: posts big blind $0.05
*** HOLE CARDS ***
Dealt to b3eab32a 
Dealt to ec2068d4 
Dealt to 999a0f96 
Dealt to d3b2bf87 
Dealt to f2e3feac 
Dealt to Hero [5c 8s]
d3b2bf87: folds
f2e3feac: folds
Hero: folds
b3eab32a: folds
ec2068d4: calls $0.03
999a0f96: checks
*** FLOP *** [5s 7c Td]
ec2068d4: bets $0.05
999a0f96: calls $0.05
*** TURN *** [5s 7c Td] [2c]
ec2068d4: checks
999a0f96: checks
*** RIVER *** [5s 7c Td 2c] [6s]
ec2068d4: checks
999a0f96: checks
ec2068d4: shows [2h 3s] (a pair of Twos)
999a0f96: shows [5h Js] (a pair of Fives)
*** SHOWDOWN ***
999a0f96 collected $0.19 from pot
*** SUMMARY ***
Total pot $0.2 | Rake $0.01 | Jackpot $0 | Bingo $0 | Fortune $0 | Tax $0
Board [5s 7c Td 2c 6s]
Seat 1: b3eab32a (button) folded before Flop (didn't bet)
Seat 2: ec2068d4 (small blind) showed [2h 3s] and lost with a pair of Twos
Seat 3: 999a0f96 (big blind) showed [5h Js] and won ($0.19) with a pair of Fives
Seat 4: d3b2bf87 folded before Flop (didn't bet)
Seat 5: f2e3feac folded before Flop (didn't bet)
Seat 6: Hero folded before Flop (didn't bet)


Poker Hand #RC3795975122: Hold'em No Limit ($0.02/$0.05) - 2025/08/10 08:48:29
Table 'RushAndCash11070382' 6-max Seat #1 is the button
Seat 1: 5e046aad ($5.39 in chips)
Seat 2: a57b331d ($27.03 in chips)
Seat 3: 5b54e251 ($12.37 in chips)
Seat 4: 8a89c761 ($5.37 in chips)
Seat 5: Hero ($14.32 in chips)
Seat 6: 4392275e ($6.94 in chips)
a57b331d: posts small blind $0.02
5b54e251: posts big blind $0.05
*** HOLE CARDS ***
Dealt to 5e046aad 
Dealt to a57b331d 
Dealt to 5b54e251 
Dealt to 8a89c761 
Dealt to Hero [4h 5h]
Dealt to 4392275e 
8a89c761: raises $0.07 to $0.12
Hero: folds
4392275e: folds
5e046aad: folds
a57b331d: folds
5b54e251: calls $0.07
*** FLOP *** [Kd 4s Ac]
5b54e251: checks
8a89c761: bets $0.09
5b54e251: calls $0.09
*** TURN *** [Kd 4s Ac] [9c]
5b54e251: checks
8a89c761: bets $0.22
5b54e251: folds
Uncalled bet ($0.22) returned to 8a89c761
*** SHOWDOWN ***
8a89c761 collected $0.42 from pot
*** SUMMARY ***
Total pot $0.44 | Rake $0.02 | Jackpot $0 | Bingo $0 | Fortune $0 | Tax $0
Board [Kd 4s Ac 9c]
Seat 1: 5e046aad (button) folded before Flop (didn't bet)
Seat 2: a57b331d (small blind) folded before Flop
Seat 3: 5b54e251 (big blind) folded on the Turn
Seat 4: 8a89c761 won ($0.42)
Seat 5: Hero folded before Flop (didn't bet)
Seat 6: 4392275e folded before Flop (didn't bet)


Poker Hand #RC3795975078: Hold'em No Limit ($0.02/$0.05) - 2025/08/10 08:48:16
Table 'RushAndCash11070338' 6-max Seat #1 is the button
Seat 1: 2c53d2c7 ($6.33 in chips)
Seat 2: Hero ($14.34 in chips)
Seat 3: c6b4a39c ($5 in chips)
Seat 4: c47206f4 ($17.08 in chips)
Seat 5: 6412bd28 ($4.98 in chips)
Seat 6: bc911417 ($10.84 in chips)
Hero: posts small blind $0.02
c6b4a39c: posts big blind $0.05
*** HOLE CARDS ***
Dealt to 2c53d2c7 
Dealt to Hero [Tc 4h]
Dealt to c6b4a39c 
Dealt to c47206f4 
Dealt to 6412bd28 
Dealt to bc911417 
c47206f4: folds
6412bd28: raises $0.1 to $0.15
bc911417: folds
2c53d2c7: folds
Hero: folds
c6b4a39c: folds
Uncalled bet ($0.1) returned to 6412bd28
*** SHOWDOWN ***
6412bd28 collected $0.12 from pot
*** SUMMARY ***
Total pot $0.12 | Rake $0 | Jackpot $0 | Bingo $0 | Fortune $0 | Tax $0
Seat 1: 2c53d2c7 (button) folded before Flop (didn't bet)
Seat 2: Hero (small blind) folded before Flop
Seat 3: c6b4a39c (big blind) folded before Flop
Seat 4: c47206f4 folded before Flop (didn't bet)
Seat 5: 6412bd28 collected ($0.12)
Seat 6: bc911417 folded before Flop (didn't bet)


Poker Hand #RC3795975016: Hold'em No Limit ($0.02/$0.05) - 2025/08/10 08:47:59
Table 'RushAndCash11070276' 6-max Seat #1 is the button
Seat 1: Hero ($14.27 in chips)
Seat 2: bef7b3e0 ($5.27 in chips)
Seat 3: 2d8e2689 ($6.59 in chips)
Seat 4: 263c886d ($4.61 in chips)
Seat 5: db591cd3 ($6.16 in chips)
Seat 6: 560bbe0d ($14.35 in chips)
bef7b3e0: posts small blind $0.02
2d8e2689: posts big blind $0.05
*** HOLE CARDS ***
Dealt to Hero [8s Qs]
Dealt to bef7b3e0 
Dealt to 2d8e2689 
Dealt to 263c886d 
Dealt to db591cd3 
Dealt to 560bbe0d 
263c886d: folds
db591cd3: folds
560bbe0d: folds
Hero: raises $0.05 to $0.1
bef7b3e0: folds
2d8e2689: folds
Uncalled bet ($0.05) returned to Hero
*** SHOWDOWN ***
Hero collected $0.12 from pot
*** SUMMARY ***
Total pot $0.12 | Rake $0 | Jackpot $0 | Bingo $0 | Fortune $0 | Tax $0
Seat 1: Hero (button) collected ($0.12)
Seat 2: bef7b3e0 (small blind) folded before Flop
Seat 3: 2d8e2689 (big blind) folded before Flop
Seat 4: 263c886d folded before Flop (didn't bet)
Seat 5: db591cd3 folded before Flop (didn't bet)
Seat 6: 560bbe0d folded before Flop (didn't bet)


Poker Hand #RC3795974991: Hold'em No Limit ($0.02/$0.05) - 2025/08/10 08:47:54
Table 'RushAndCash11070251' 6-max Seat #1 is the button
Seat 1: c4ed83bc ($5.85 in chips)
Seat 2: 8b4bad56 ($2.22 in chips)
Seat 3: 7529396e ($5.99 in chips)
Seat 4: 15c880d8 ($5.41 in chips)
Seat 5: 9115c007 ($10.56 in chips)
Seat 6: Hero ($14.27 in chips)
8b4bad56: posts small blind $0.02
7529396e: posts big blind $0.05
*** HOLE CARDS ***
Dealt to c4ed83bc 
Dealt to 8b4bad56 
Dealt to 7529396e 
Dealt to 15c880d8 
Dealt to 9115c007 
Dealt to Hero [8s Tc]
15c880d8: raises $0.06 to $0.11
9115c007: folds
Hero: folds
c4ed83bc: raises $0.22 to $0.33
8b4bad56: folds
7529396e: calls $0.28
15c880d8: folds
*** FLOP *** [7c 2s 2h]
7529396e: checks
c4ed83bc: bets $0.6
7529396e: folds
Uncalled bet ($0.6) returned to c4ed83bc
*** SHOWDOWN ***
c4ed83bc collected $0.75 from pot
*** SUMMARY ***
Total pot $0.79 | Rake $0.04 | Jackpot $0 | Bingo $0 | Fortune $0 | Tax $0
Board [7c 2s 2h]
Seat 1: c4ed83bc (button) won ($0.75)
Seat 2: 8b4bad56 (small blind) folded before Flop
Seat 3: 7529396e (big blind) folded on the Flop
Seat 4: 15c880d8 folded before Flop
Seat 5: 9115c007 folded before Flop (didn't bet)
Seat 6: Hero folded before Flop (didn't bet)


Poker Hand #RC3795974942: Hold'em No Limit ($0.02/$0.05) - 2025/08/10 08:47:40
Table 'RushAndCash11070202' 6-max Seat #1 is the button
Seat 1: dfb00ca4 ($5.12 in chips)
Seat 2: 6df06218 ($7.3 in chips)
Seat 3: Hero ($14.32 in chips)
Seat 4: ddf6b2fd ($5.64 in chips)
Seat 5: d4249213 ($4.98 in chips)
Seat 6: 86d57974 ($5.04 in chips)
6df06218: posts small blind $0.02
Hero: posts big blind $0.05
*** HOLE CARDS ***
Dealt to dfb00ca4 
Dealt to 6df06218 
Dealt to Hero [Jd 7s]
Dealt to ddf6b2fd 
Dealt to d4249213 
Dealt to 86d57974 
ddf6b2fd: folds
d4249213: folds
86d57974: folds
dfb00ca4: raises $0.08 to $0.13
6df06218: calls $0.11
Hero: folds
*** FLOP *** [Kc 6s 9c]
6df06218: checks
dfb00ca4: bets $0.15
6df06218: calls $0.15
*** TURN *** [Kc 6s 9c] [Ks]
6df06218: checks
dfb00ca4: checks
*** RIVER *** [Kc 6s 9c Ks] [5d]
6df06218: bets $0.31
dfb00ca4: calls $0.31
6df06218: shows [As Qs] (a pair of Kings)
dfb00ca4: shows [Ad Ah] (two pair, Aces and Kings)
*** SHOWDOWN ***
dfb00ca4 collected $1.17 from pot
*** SUMMARY ***
Total pot $1.23 | Rake $0.06 | Jackpot $0 | Bingo $0 | Fortune $0 | Tax $0
Board [Kc 6s 9c Ks 5d]
Seat 1: dfb00ca4 (button) showed [Ad Ah] and won ($1.17) with two pair, Aces and Kings
Seat 2: 6df06218 (small blind) showed [As Qs] and lost with a pair of Kings
Seat 3: Hero (big blind) folded before Flop
Seat 4: ddf6b2fd folded before Flop (didn't bet)
Seat 5: d4249213 folded before Flop (didn't bet)
Seat 6: 86d57974 folded before Flop (didn't bet)


Poker Hand #RC3795974902: Hold'em No Limit ($0.02/$0.05) - 2025/08/10 08:47:30
Table 'RushAndCash11070162' 6-max Seat #1 is the button
Seat 1: 66a574d1 ($5.57 in chips)
Seat 2: 73869740 ($6.35 in chips)
Seat 3: e0ff0229 ($6.46 in chips)
Seat 4: e2ddd0b5 ($4.71 in chips)
Seat 5: Hero ($14.25 in chips)
Seat 6: 1d8508ee ($5.36 in chips)
73869740: posts small blind $0.02
e0ff0229: posts big blind $0.05
*** HOLE CARDS ***
Dealt to 66a574d1 
Dealt to 73869740 
Dealt to e0ff0229 
Dealt to e2ddd0b5 
Dealt to Hero [Jh 9h]
Dealt to 1d8508ee 
e2ddd0b5: folds
Hero: raises $0.05 to $0.1
1d8508ee: folds
66a574d1: folds
73869740: folds
e0ff0229: folds
Uncalled bet ($0.05) returned to Hero
*** SHOWDOWN ***
Hero collected $0.12 from pot
*** SUMMARY ***
Total pot $0.12 | Rake $0 | Jackpot $0 | Bingo $0 | Fortune $0 | Tax $0
Seat 1: 66a574d1 (button) folded before Flop (didn't bet)
Seat 2: 73869740 (small blind) folded before Flop
Seat 3: e0ff0229 (big blind) folded before Flop
Seat 4: e2ddd0b5 folded before Flop (didn't bet)
Seat 5: Hero collected ($0.12)
Seat 6: 1d8508ee folded before Flop (didn't bet)


Poker Hand #RC3795934736: Hold'em No Limit ($0.02/$0.05) - 2025/08/10 08:46:48
Table 'RushAndCash11069996' 6-max Seat #1 is the button
Seat 1: 196a508f ($13.19 in chips)
Seat 2: 5e046aad ($5.04 in chips)
Seat 3: 1d8508ee ($5.25 in chips)
Seat 4: Hero ($14.35 in chips)
Seat 5: 8bac157b ($5 in chips)
Seat 6: 42c31e1a ($14.18 in chips)
5e046aad: posts small blind $0.02
1d8508ee: posts big blind $0.05
*** HOLE CARDS ***
Dealt to 196a508f 
Dealt to 5e046aad 
Dealt to 1d8508ee 
Dealt to Hero [8c Jc]
Dealt to 8bac157b 
Dealt to 42c31e1a 
Hero: raises $0.05 to $0.1
8bac157b: folds
42c31e1a: folds
196a508f: folds
5e046aad: folds
1d8508ee: calls $0.05
*** FLOP *** [9h 9s As]
1d8508ee: checks
Hero: checks
*** TURN *** [9h 9s As] [Kc]
1d8508ee: checks
Hero: checks
*** RIVER *** [9h 9s As Kc] [6d]
1d8508ee: checks
Hero: checks
1d8508ee: shows [Qc Ks] (two pair, Kings and Nines)
Hero: shows [8c Jc] (a pair of Nines)
*** SHOWDOWN ***
1d8508ee collected $0.21 from pot
*** SUMMARY ***
Total pot $0.22 | Rake $0.01 | Jackpot $0 | Bingo $0 | Fortune $0 | Tax $0
Board [9h 9s As Kc 6d]
Seat 1: 196a508f (button) folded before Flop (didn't bet)
Seat 2: 5e046aad (small blind) folded before Flop
Seat 3: 1d8508ee (big blind) showed [Qc Ks] and won ($0.21) with two pair, Kings and Nines
Seat 4: Hero showed [8c Jc] and lost with a pair of Nines
Seat 5: 8bac157b folded before Flop (didn't bet)
Seat 6: 42c31e1a folded before Flop (didn't bet)


Poker Hand #RC3795934680: Hold'em No Limit ($0.02/$0.05) - 2025/08/10 08:46:34
Table 'RushAndCash11069940' 6-max Seat #1 is the button
Seat 1: 263c886d ($4.54 in chips)
Seat 2: Hero ($14.37 in chips)
Seat 3: 7165cda2 ($5.66 in chips)
Seat 4: af0721f5 ($6.22 in chips)
Seat 5: a9ba79a ($1.28 in chips)
Seat 6: db591cd3 ($6.17 in chips)
Hero: posts small blind $0.02
7165cda2: posts big blind $0.05
*** HOLE CARDS ***
Dealt to 263c886d 
Dealt to Hero [8d 5c]
Dealt to 7165cda2 
Dealt to af0721f5 
Dealt to a9ba79a 
Dealt to db591cd3 
af0721f5: folds
a9ba79a: raises $0.07 to $0.12
db591cd3: folds
263c886d: folds
Hero: folds
7165cda2: calls $0.07
*** FLOP *** [Td As 3h]
7165cda2: checks
a9ba79a: bets $0.13
7165cda2: folds
Uncalled bet ($0.13) returned to a9ba79a
*** SHOWDOWN ***
a9ba79a collected $0.25 from pot
*** SUMMARY ***
Total pot $0.26 | Rake $0.01 | Jackpot $0 | Bingo $0 | Fortune $0 | Tax $0
Board [Td As 3h]
Seat 1: 263c886d (button) folded before Flop (didn't bet)
Seat 2: Hero (small blind) folded before Flop
Seat 3: 7165cda2 (big blind) folded on the Flop
Seat 4: af0721f5 folded before Flop (didn't bet)
Seat 5: a9ba79a won ($0.25)
Seat 6: db591cd3 folded before Flop (didn't bet)


Poker Hand #RC3795934654: Hold'em No Limit ($0.02/$0.05) - 2025/08/10 08:46:27
Table 'RushAndCash11069914' 6-max Seat #1 is the button
Seat 1: 8e04bbd3 ($5.03 in chips)
Seat 2: ec2068d4 ($5.16 in chips)
Seat 3: Hero ($14.42 in chips)
Seat 4: 61c8b0c8 ($7.55 in chips)
Seat 5: d786762e ($4.93 in chips)
Seat 6: dde92c84 ($14.53 in chips)
ec2068d4: posts small blind $0.02
Hero: posts big blind $0.05
*** HOLE CARDS ***
Dealt to 8e04bbd3 
Dealt to ec2068d4 
Dealt to Hero [Kh 8s]
Dealt to 61c8b0c8 
Dealt to d786762e 
Dealt to dde92c84 
61c8b0c8: raises $0.08 to $0.13
d786762e: folds
dde92c84: folds
8e04bbd3: folds
ec2068d4: folds
Hero: folds
Uncalled bet ($0.08) returned to 61c8b0c8
*** SHOWDOWN ***
61c8b0c8 collected $0.12 from pot
*** SUMMARY ***
Total pot $0.12 | Rake $0 | Jackpot $0 | Bingo $0 | Fortune $0 | Tax $0
Seat 1: 8e04bbd3 (button) folded before Flop (didn't bet)
Seat 2: ec2068d4 (small blind) folded before Flop
Seat 3: Hero (big blind) folded before Flop
Seat 4: 61c8b0c8 collected ($0.12)
Seat 5: d786762e folded before Flop (didn't bet)
Seat 6: dde92c84 folded before Flop (didn't bet)


Poker Hand #RC3795934639: Hold'em No Limit ($0.02/$0.05) - 2025/08/10 08:46:23
Table 'RushAndCash11069899' 6-max Seat #1 is the button
Seat 1: b8581dce ($9.39 in chips)
Seat 2: 6487a64d ($10.94 in chips)
Seat 3: 8fc6d1e4 ($6.74 in chips)
Seat 4: bc911417 ($10.71 in chips)
Seat 5: 8e04bbd3 ($5.03 in chips)
Seat 6: Hero ($14.42 in chips)
6487a64d: posts small blind $0.02
8fc6d1e4: posts big blind $0.05
*** HOLE CARDS ***
Dealt to b8581dce 
Dealt to 6487a64d 
Dealt to 8fc6d1e4 
Dealt to bc911417 
Dealt to 8e04bbd3 
Dealt to Hero [7c 9h]
bc911417: raises $0.05 to $0.1
8e04bbd3: folds
Hero: folds
b8581dce: calls $0.1
6487a64d: folds
8fc6d1e4: folds
*** FLOP *** [9s Kh Ah]
bc911417: bets $0.05
b8581dce: calls $0.05
*** TURN *** [9s Kh Ah] [6s]
bc911417: bets $0.06
b8581dce: calls $0.06
*** RIVER *** [9s Kh Ah 6s] [9c]
bc911417: bets $0.12
b8581dce: calls $0.12
bc911417: shows [Ac 3c] (two pair, Aces and Nines)
b8581dce: shows [Ad 2d] (two pair, Aces and Nines)
*** SHOWDOWN ***
bc911417 collected $0.36 from pot
b8581dce collected $0.35 from pot
*** SUMMARY ***
Total pot $0.73 | Rake $0.02 | Jackpot $0 | Bingo $0 | Fortune $0 | Tax $0
Board [9s Kh Ah 6s 9c]
Seat 1: b8581dce (button) showed [Ad 2d] and won ($0.35) with two pair, Aces and Nines
Seat 2: 6487a64d (small blind) folded before Flop
Seat 3: 8fc6d1e4 (big blind) folded before Flop
Seat 4: bc911417 showed [Ac 3c] and won ($0.36) with two pair, Aces and Nines
Seat 5: 8e04bbd3 folded before Flop (didn't bet)
Seat 6: Hero folded before Flop (didn't bet)


Poker Hand #RC3795934348: Hold'em No Limit ($0.02/$0.05) - 2025/08/10 08:44:57
Table 'RushAndCash11069608' 6-max Seat #1 is the button
Seat 1: Hero ($8.06 in chips)
Seat 2: 1ceb153 ($5.02 in chips)
Seat 3: e13d681e ($6.35 in chips)
Seat 4: f800690c ($5.55 in chips)
Seat 5: 76c981c5 ($3.75 in chips)
Seat 6: ee248a1b ($7.26 in chips)
1ceb153: posts small blind $0.02
e13d681e: posts big blind $0.05
*** HOLE CARDS ***
Dealt to Hero [Th 8h]
Dealt to 1ceb153 
Dealt to e13d681e 
Dealt to f800690c 
Dealt to 76c981c5 
Dealt to ee248a1b 
f800690c: folds
76c981c5: calls $0.05
ee248a1b: raises $0.11 to $0.16
Hero: calls $0.16
1ceb153: folds
e13d681e: raises $0.64 to $0.8
76c981c5: folds
ee248a1b: folds
Hero: calls $0.64
*** FLOP *** [Kc Ts 8c]
e13d681e: bets $1.75
Hero: calls $1.75
*** TURN *** [Kc Ts 8c] [8d]
e13d681e: bets $3.8 and is all-in
Hero: calls $3.8
e13d681e: shows [Ks Ah] (two pair, Kings and Eights)
Hero: shows [Th 8h] (a full house, Eights full of Tens)
*** RIVER *** [Kc Ts 8c 8d] [4s]
*** SHOWDOWN ***
Hero collected $12.71 from pot
*** SUMMARY ***
Total pot $12.93 | Rake $0.15 | Jackpot $0.07 | Bingo $0 | Fortune $0 | Tax $0
Board [Kc Ts 8c 8d 4s]
Seat 1: Hero (button) showed [Th 8h] and won ($12.71) with a full house, Eights full of Tens
Seat 2: 1ceb153 (small blind) folded before Flop
Seat 3: e13d681e (big blind) showed [Ks Ah] and lost with two pair, Kings and Eights
Seat 4: f800690c folded before Flop (didn't bet)
Seat 5: 76c981c5 folded before Flop
Seat 6: ee248a1b folded before Flop


Poker Hand #RC3795934330: Hold'em No Limit ($0.02/$0.05) - 2025/08/10 08:44:51
Table 'RushAndCash11069590' 6-max Seat #1 is the button
Seat 1: bbe9b1b1 ($13.19 in chips)
Seat 2: 66a574d1 ($6.46 in chips)
Seat 3: 1dafb1bc ($36.33 in chips)
Seat 4: Hero ($8.06 in chips)
Seat 5: 23739ee8 ($6.18 in chips)
Seat 6: 5c5d4a8d ($14.83 in chips)
66a574d1: posts small blind $0.02
1dafb1bc: posts big blind $0.05
*** HOLE CARDS ***
Dealt to bbe9b1b1 
Dealt to 66a574d1 
Dealt to 1dafb1bc 
Dealt to Hero [Qc 8h]
Dealt to 23739ee8 
Dealt to 5c5d4a8d 
Hero: folds
23739ee8: raises $0.05 to $0.1
5c5d4a8d: folds
bbe9b1b1: calls $0.1
66a574d1: folds
1dafb1bc: folds
*** FLOP *** [Jc 2h Kc]
23739ee8: checks
bbe9b1b1: checks
*** TURN *** [Jc 2h Kc] [4h]
23739ee8: checks
bbe9b1b1: bets $0.21
23739ee8: folds
Uncalled bet ($0.21) returned to bbe9b1b1
*** SHOWDOWN ***
bbe9b1b1 collected $0.26 from pot
*** SUMMARY ***
Total pot $0.27 | Rake $0.01 | Jackpot $0 | Bingo $0 | Fortune $0 | Tax $0
Board [Jc 2h Kc 4h]
Seat 1: bbe9b1b1 (button) won ($0.26)
Seat 2: 66a574d1 (small blind) folded before Flop
Seat 3: 1dafb1bc (big blind) folded before Flop
Seat 4: Hero folded before Flop (didn't bet)
Seat 5: 23739ee8 folded on the Turn
Seat 6: 5c5d4a8d folded before Flop (didn't bet)


Poker Hand #RC3795934301: Hold'em No Limit ($0.02/$0.05) - 2025/08/10 08:44:43
Table 'RushAndCash11069561' 6-max Seat #1 is the button
Seat 1: d62070dc ($4.29 in chips)
Seat 2: Hero ($8.08 in chips)
Seat 3: 560bbe0d ($14.6 in chips)
Seat 4: aa95eeae ($7.05 in chips)
Seat 5: 94188a14 ($5.02 in chips)
Seat 6: b87e2d9d ($5.45 in chips)
Hero: posts small blind $0.02
560bbe0d: posts big blind $0.05
*** HOLE CARDS ***
Dealt to d62070dc 
Dealt to Hero [8d 4h]
Dealt to 560bbe0d 
Dealt to aa95eeae 
Dealt to 94188a14 
Dealt to b87e2d9d 
aa95eeae: folds
94188a14: folds
b87e2d9d: folds
d62070dc: folds
Hero: folds
Uncalled bet ($0.03) returned to 560bbe0d
*** SHOWDOWN ***
560bbe0d collected $0.04 from pot
*** SUMMARY ***
Total pot $0.04 | Rake $0 | Jackpot $0 | Bingo $0 | Fortune $0 | Tax $0
Seat 1: d62070dc (button) folded before Flop (didn't bet)
Seat 2: Hero (small blind) folded before Flop
Seat 3: 560bbe0d (big blind) collected ($0.04)
Seat 4: aa95eeae folded before Flop (didn't bet)
Seat 5: 94188a14 folded before Flop (didn't bet)
Seat 6: b87e2d9d folded before Flop (didn't bet)


Poker Hand #RC3795934288: Hold'em No Limit ($0.02/$0.05) - 2025/08/10 08:44:39
Table 'RushAndCash11069548' 6-max Seat #1 is the button
Seat 1: 6487a64d ($10.62 in chips)
Seat 2: f330932 ($1.62 in chips)
Seat 3: 1d9a9697 ($5.77 in chips)
Seat 4: d30b0a9c ($5.76 in chips)
Seat 5: Hero ($8.08 in chips)
Seat 6: 7244fd77 ($5.6 in chips)
f330932: posts small blind $0.02
1d9a9697: posts big blind $0.05
*** HOLE CARDS ***
Dealt to 6487a64d 
Dealt to f330932 
Dealt to 1d9a9697 
Dealt to d30b0a9c 
Dealt to Hero [7d Jh]
Dealt to 7244fd77 
d30b0a9c: folds
Hero: folds
7244fd77: folds
6487a64d: folds
f330932: folds
Uncalled bet ($0.03) returned to 1d9a9697
*** SHOWDOWN ***
1d9a9697 collected $0.04 from pot
*** SUMMARY ***
Total pot $0.04 | Rake $0 | Jackpot $0 | Bingo $0 | Fortune $0 | Tax $0
Seat 1: 6487a64d (button) folded before Flop (didn't bet)
Seat 2: f330932 (small blind) folded before Flop
Seat 3: 1d9a9697 (big blind) collected ($0.04)
Seat 4: d30b0a9c folded before Flop (didn't bet)
Seat 5: Hero folded before Flop (didn't bet)
Seat 6: 7244fd77 folded before Flop (didn't bet)


Poker Hand #RC3795934277: Hold'em No Limit ($0.02/$0.05) - 2025/08/10 08:44:36
Table 'RushAndCash11069537' 6-max Seat #1 is the button
Seat 1: d2ef50f8 ($1.44 in chips)
Seat 2: e6b7142a ($1.74 in chips)
Seat 3: 263c886d ($4.87 in chips)
Seat 4: 18d58012 ($5.49 in chips)
Seat 5: 6487a64d ($10.62 in chips)
Seat 6: Hero ($8.08 in chips)
e6b7142a: posts small blind $0.02
263c886d: posts big blind $0.05
*** HOLE CARDS ***
Dealt to d2ef50f8 
Dealt to e6b7142a 
Dealt to 263c886d 
Dealt to 18d58012 
Dealt to 6487a64d 
Dealt to Hero [2c Js]
18d58012: folds
6487a64d: folds
Hero: folds
d2ef50f8: raises $0.05 to $0.1
e6b7142a: folds
263c886d: folds
Uncalled bet ($0.05) returned to d2ef50f8
*** SHOWDOWN ***
d2ef50f8 collected $0.12 from pot
*** SUMMARY ***
Total pot $0.12 | Rake $0 | Jackpot $0 | Bingo $0 | Fortune $0 | Tax $0
Seat 1: d2ef50f8 (button) collected ($0.12)
Seat 2: e6b7142a (small blind) folded before Flop
Seat 3: 263c886d (big blind) folded before Flop
Seat 4: 18d58012 folded before Flop (didn't bet)
Seat 5: 6487a64d folded before Flop (didn't bet)
Seat 6: Hero folded before Flop (didn't bet)


Poker Hand #RC3795934257: Hold'em No Limit ($0.02/$0.05) - 2025/08/10 08:44:30
Table 'RushAndCash11069517' 6-max Seat #1 is the button
Seat 1: e9f334c0 ($12.57 in chips)
Seat 2: ca103bdd ($4.13 in chips)
Seat 3: 513bb8fb ($5.94 in chips)
Seat 4: db3d7016 ($5.08 in chips)
Seat 5: Hero ($8.08 in chips)
Seat 6: 8a484f1f ($13.29 in chips)
ca103bdd: posts small blind $0.02
513bb8fb: posts big blind $0.05
*** HOLE CARDS ***
Dealt to e9f334c0 
Dealt to ca103bdd 
Dealt to 513bb8fb 
Dealt to db3d7016 
Dealt to Hero [Ts 6s]
Dealt to 8a484f1f 
db3d7016: folds
Hero: folds
8a484f1f: raises $0.05 to $0.1
e9f334c0: calls $0.1
ca103bdd: folds
513bb8fb: folds
*** FLOP *** [7h 9d 3c]
8a484f1f: checks
e9f334c0: bets $0.22
8a484f1f: calls $0.22
*** TURN *** [7h 9d 3c] [5s]
8a484f1f: checks
e9f334c0: checks
*** RIVER *** [7h 9d 3c 5s] [Tc]
8a484f1f: bets $0.54
e9f334c0: calls $0.54
8a484f1f: shows [Ks Kd] (a pair of Kings)
e9f334c0: shows [Jh 9h] (a pair of Nines)
*** SHOWDOWN ***
8a484f1f collected $1.64 from pot
*** SUMMARY ***
Total pot $1.79 | Rake $0.08 | Jackpot $0.07 | Bingo $0 | Fortune $0 | Tax $0
Board [7h 9d 3c 5s Tc]
Seat 1: e9f334c0 (button) showed [Jh 9h] and lost with a pair of Nines
Seat 2: ca103bdd (small blind) folded before Flop
Seat 3: 513bb8fb (big blind) folded before Flop
Seat 4: db3d7016 folded before Flop (didn't bet)
Seat 5: Hero folded before Flop (didn't bet)
Seat 6: 8a484f1f showed [Ks Kd] and won ($1.64) with a pair of Kings


Poker Hand #RC3795934180: Hold'em No Limit ($0.02/$0.05) - 2025/08/10 08:44:06
Table 'RushAndCash11069440' 6-max Seat #1 is the button
Seat 1: Hero ($8.08 in chips)
Seat 2: 99058ade ($8.4 in chips)
Seat 3: b3eab32a ($5 in chips)
Seat 4: efc0d07f ($5.15 in chips)
Seat 5: e612f091 ($7.25 in chips)
Seat 6: 5c5d4a8d ($14.95 in chips)
99058ade: posts small blind $0.02
b3eab32a: posts big blind $0.05
*** HOLE CARDS ***
Dealt to Hero [9c 5s]
Dealt to 99058ade 
Dealt to b3eab32a 
Dealt to efc0d07f 
Dealt to e612f091 
Dealt to 5c5d4a8d 
efc0d07f: folds
e612f091: raises $0.06 to $0.11
5c5d4a8d: folds
Hero: folds
99058ade: folds
b3eab32a: folds
Uncalled bet ($0.06) returned to e612f091
*** SHOWDOWN ***
e612f091 collected $0.12 from pot
*** SUMMARY ***
Total pot $0.12 | Rake $0 | Jackpot $0 | Bingo $0 | Fortune $0 | Tax $0
Seat 1: Hero (button) folded before Flop (didn't bet)
Seat 2: 99058ade (small blind) folded before Flop
Seat 3: b3eab32a (big blind) folded before Flop
Seat 4: efc0d07f folded before Flop (didn't bet)
Seat 5: e612f091 collected ($0.12)
Seat 6: 5c5d4a8d folded before Flop (didn't bet)


Poker Hand #RC3795934113: Hold'em No Limit ($0.02/$0.05) - 2025/08/10 08:43:46
Table 'RushAndCash11069373' 6-max Seat #1 is the button
Seat 1: c832e941 ($5.28 in chips)
Seat 2: 5c26b831 ($5.02 in chips)
Seat 3: Hero ($8.13 in chips)
Seat 4: 23739ee8 ($6.3 in chips)
Seat 5: a127404a ($5.77 in chips)
Seat 6: 7244fd77 ($5.53 in chips)
5c26b831: posts small blind $0.02
Hero: posts big blind $0.05
*** HOLE CARDS ***
Dealt to c832e941 
Dealt to 5c26b831 
Dealt to Hero [6d 4s]
Dealt to 23739ee8 
Dealt to a127404a 
Dealt to 7244fd77 
23739ee8: folds
a127404a: folds
7244fd77: raises $0.06 to $0.11
c832e941: folds
5c26b831: folds
Hero: folds
Uncalled bet ($0.06) returned to 7244fd77
*** SHOWDOWN ***
7244fd77 collected $0.12 from pot
*** SUMMARY ***
Total pot $0.12 | Rake $0 | Jackpot $0 | Bingo $0 | Fortune $0 | Tax $0
Seat 1: c832e941 (button) folded before Flop (didn't bet)
Seat 2: 5c26b831 (small blind) folded before Flop
Seat 3: Hero (big blind) folded before Flop
Seat 4: 23739ee8 folded before Flop (didn't bet)
Seat 5: a127404a folded before Flop (didn't bet)
Seat 6: 7244fd77 collected ($0.12)


Poker Hand #RC3795933941: Hold'em No Limit ($0.02/$0.05) - 2025/08/10 08:42:55
Table 'RushAndCash11069201' 6-max Seat #1 is the button
Seat 1: f38b69c2 ($5.53 in chips)
Seat 2: 5c5d4a8d ($15.1 in chips)
Seat 3: 23739ee8 ($6.4 in chips)
Seat 4: Hero ($8.23 in chips)
Seat 5: dde92c84 ($15.27 in chips)
Seat 6: 7244fd77 ($5.32 in chips)
5c5d4a8d: posts small blind $0.02
23739ee8: posts big blind $0.05
*** HOLE CARDS ***
Dealt to f38b69c2 
Dealt to 5c5d4a8d 
Dealt to 23739ee8 
Dealt to Hero [Ks Ah]
Dealt to dde92c84 
Dealt to 7244fd77 
Hero: raises $0.05 to $0.1
dde92c84: folds
7244fd77: calls $0.1
f38b69c2: folds
5c5d4a8d: folds
23739ee8: calls $0.05
*** FLOP *** [4h Js Qc]
23739ee8: checks
Hero: checks
7244fd77: checks
*** TURN *** [4h Js Qc] [8c]
23739ee8: checks
Hero: checks
7244fd77: checks
*** RIVER *** [4h Js Qc 8c] [8s]
23739ee8: checks
Hero: checks
7244fd77: checks
23739ee8: shows [Ts 6s] (a pair of Eights)
Hero: shows [Ks Ah] (a pair of Eights)
7244fd77: shows [9d 9c] (two pair, Nines and Eights)
*** SHOWDOWN ***
7244fd77 collected $0.31 from pot
*** SUMMARY ***
Total pot $0.32 | Rake $0.01 | Jackpot $0 | Bingo $0 | Fortune $0 | Tax $0
Board [4h Js Qc 8c 8s]
Seat 1: f38b69c2 (button) folded before Flop (didn't bet)
Seat 2: 5c5d4a8d (small blind) folded before Flop
Seat 3: 23739ee8 (big blind) showed [Ts 6s] and lost with a pair of Eights
Seat 4: Hero showed [Ks Ah] and lost with a pair of Eights
Seat 5: dde92c84 folded before Flop (didn't bet)
Seat 6: 7244fd77 showed [9d 9c] and won ($0.31) with two pair, Nines and Eights


Poker Hand #RC3795933928: Hold'em No Limit ($0.02/$0.05) - 2025/08/10 08:42:51
Table 'RushAndCash11069188' 6-max Seat #1 is the button
Seat 1: e792c630 ($6.55 in chips)
Seat 2: d27c038b ($2.76 in chips)
Seat 3: 2b56ac20 ($20.61 in chips)
Seat 4: 84b5f77e ($5.21 in chips)
Seat 5: d32d3acf ($5 in chips)
Seat 6: Hero ($8.23 in chips)
d27c038b: posts small blind $0.02
2b56ac20: posts big blind $0.05
*** HOLE CARDS ***
Dealt to e792c630 
Dealt to d27c038b 
Dealt to 2b56ac20 
Dealt to 84b5f77e 
Dealt to d32d3acf 
Dealt to Hero [Ah 7c]
84b5f77e: folds
d32d3acf: folds
Hero: folds
e792c630: folds
d27c038b: raises $0.13 to $0.18
2b56ac20: folds
Uncalled bet ($0.13) returned to d27c038b
*** SHOWDOWN ***
d27c038b collected $0.1 from pot
*** SUMMARY ***
Total pot $0.1 | Rake $0 | Jackpot $0 | Bingo $0 | Fortune $0 | Tax $0
Seat 1: e792c630 (button) folded before Flop (didn't bet)
Seat 2: d27c038b (small blind) collected ($0.1)
Seat 3: 2b56ac20 (big blind) folded before Flop
Seat 4: 84b5f77e folded before Flop (didn't bet)
Seat 5: d32d3acf folded before Flop (didn't bet)
Seat 6: Hero folded before Flop (didn't bet)


Poker Hand #RC3795933895: Hold'em No Limit ($0.02/$0.05) - 2025/08/10 08:42:42
Table 'RushAndCash11069155' 6-max Seat #1 is the button
Seat 1: ca103bdd ($4.49 in chips)
Seat 2: 1dafb1bc ($36.15 in chips)
Seat 3: Hero ($8.21 in chips)
Seat 4: 9e9f7171 ($6.94 in chips)
Seat 5: 1af7528e ($10.15 in chips)
Seat 6: fae333ee ($10.83 in chips)
1dafb1bc: posts small blind $0.02
Hero: posts big blind $0.05
*** HOLE CARDS ***
Dealt to ca103bdd 
Dealt to 1dafb1bc 
Dealt to Hero [8s Kh]
Dealt to 9e9f7171 
Dealt to 1af7528e 
Dealt to fae333ee 
9e9f7171: folds
1af7528e: folds
fae333ee: folds
ca103bdd: folds
1dafb1bc: folds
Uncalled bet ($0.03) returned to Hero
*** SHOWDOWN ***
Hero collected $0.04 from pot
*** SUMMARY ***
Total pot $0.04 | Rake $0 | Jackpot $0 | Bingo $0 | Fortune $0 | Tax $0
Seat 1: ca103bdd (button) folded before Flop (didn't bet)
Seat 2: 1dafb1bc (small blind) folded before Flop
Seat 3: Hero (big blind) collected ($0.04)
Seat 4: 9e9f7171 folded before Flop (didn't bet)
Seat 5: 1af7528e folded before Flop (didn't bet)
Seat 6: fae333ee folded before Flop (didn't bet)


Poker Hand #RC3795933861: Hold'em No Limit ($0.02/$0.05) - 2025/08/10 08:42:31
Table 'RushAndCash11069121' 6-max Seat #1 is the button
Seat 1: 6dc54533 ($43.83 in chips)
Seat 2: Hero ($8.23 in chips)
Seat 3: d62070dc ($4.25 in chips)
Seat 4: 8a89c761 ($5 in chips)
Seat 5: 70662feb ($5.7 in chips)
Seat 6: 67671ee6 ($5.02 in chips)
Hero: posts small blind $0.02
d62070dc: posts big blind $0.05
*** HOLE CARDS ***
Dealt to 6dc54533 
Dealt to Hero [7s Ad]
Dealt to d62070dc 
Dealt to 8a89c761 
Dealt to 70662feb 
Dealt to 67671ee6 
8a89c761: folds
70662feb: folds
67671ee6: folds
6dc54533: raises $0.07 to $0.12
Hero: folds
d62070dc: folds
Uncalled bet ($0.07) returned to 6dc54533
*** SHOWDOWN ***
6dc54533 collected $0.12 from pot
*** SUMMARY ***
Total pot $0.12 | Rake $0 | Jackpot $0 | Bingo $0 | Fortune $0 | Tax $0
Seat 1: 6dc54533 (button) collected ($0.12)
Seat 2: Hero (small blind) folded before Flop
Seat 3: d62070dc (big blind) folded before Flop
Seat 4: 8a89c761 folded before Flop (didn't bet)
Seat 5: 70662feb folded before Flop (didn't bet)
Seat 6: 67671ee6 folded before Flop (didn't bet)


Poker Hand #RC3795933842: Hold'em No Limit ($0.02/$0.05) - 2025/08/10 08:42:26
Table 'RushAndCash11069102' 6-max Seat #1 is the button
Seat 1: Hero ($8.23 in chips)
Seat 2: 3a68afa9 ($6.13 in chips)
Seat 3: e792c630 ($6.48 in chips)
Seat 4: db3d7016 ($5 in chips)
Seat 5: a187372 ($5.68 in chips)
Seat 6: 902f8c64 ($7.45 in chips)
3a68afa9: posts small blind $0.02
e792c630: posts big blind $0.05
*** HOLE CARDS ***
Dealt to Hero [7d Kc]
Dealt to 3a68afa9 
Dealt to e792c630 
Dealt to db3d7016 
Dealt to a187372 
Dealt to 902f8c64 
db3d7016: folds
a187372: folds
902f8c64: folds
Hero: folds
3a68afa9: folds
Uncalled bet ($0.03) returned to e792c630
*** SHOWDOWN ***
e792c630 collected $0.04 from pot
*** SUMMARY ***
Total pot $0.04 | Rake $0 | Jackpot $0 | Bingo $0 | Fortune $0 | Tax $0
Seat 1: Hero (button) folded before Flop (didn't bet)
Seat 2: 3a68afa9 (small blind) folded before Flop
Seat 3: e792c630 (big blind) collected ($0.04)
Seat 4: db3d7016 folded before Flop (didn't bet)
Seat 5: a187372 folded before Flop (didn't bet)
Seat 6: 902f8c64 folded before Flop (didn't bet)


Poker Hand #RC3795933658: Hold'em No Limit ($0.02/$0.05) - 2025/08/10 08:41:38
Table 'RushAndCash11068918' 6-max Seat #1 is the button
Seat 1: 2c28207b ($5.35 in chips)
Seat 2: d6378e6 ($5.92 in chips)
Seat 3: b8581dce ($5.18 in chips)
Seat 4: a361fe13 ($7.81 in chips)
Seat 5: Hero ($8.73 in chips)
Seat 6: 963a5888 ($9.24 in chips)
d6378e6: posts small blind $0.02
b8581dce: posts big blind $0.05
*** HOLE CARDS ***
Dealt to 2c28207b 
Dealt to d6378e6 
Dealt to b8581dce 
Dealt to a361fe13 
Dealt to Hero [As Kc]
Dealt to 963a5888 
a361fe13: folds
Hero: raises $0.05 to $0.1
963a5888: folds
2c28207b: folds
d6378e6: raises $0.4 to $0.5
b8581dce: folds
Hero: calls $0.4
*** FLOP *** [Jh 7s 8s]
d6378e6: bets $0.35
Hero: folds
Uncalled bet ($0.35) returned to d6378e6
*** SHOWDOWN ***
d6378e6 collected $1 from pot
*** SUMMARY ***
Total pot $1.05 | Rake $0.05 | Jackpot $0 | Bingo $0 | Fortune $0 | Tax $0
Board [Jh 7s 8s]
Seat 1: 2c28207b (button) folded before Flop (didn't bet)
Seat 2: d6378e6 (small blind) won ($1)
Seat 3: b8581dce (big blind) folded before Flop
Seat 4: a361fe13 folded before Flop (didn't bet)
Seat 5: Hero folded on the Flop
Seat 6: 963a5888 folded before Flop (didn't bet)


Poker Hand #RC3795933640: Hold'em No Limit ($0.02/$0.05) - 2025/08/10 08:41:32
Table 'RushAndCash11068900' 6-max Seat #1 is the button
Seat 1: a9ba79a ($1.35 in chips)
Seat 2: d32d3acf ($5 in chips)
Seat 3: 3f43d5e9 ($3.42 in chips)
Seat 4: Hero ($8.73 in chips)
Seat 5: 7fbe4590 ($4.29 in chips)
Seat 6: dc4f2a76 ($10.08 in chips)
d32d3acf: posts small blind $0.02
3f43d5e9: posts big blind $0.05
*** HOLE CARDS ***
Dealt to a9ba79a 
Dealt to d32d3acf 
Dealt to 3f43d5e9 
Dealt to Hero [Ad 3s]
Dealt to 7fbe4590 
Dealt to dc4f2a76 
Hero: folds
7fbe4590: folds
dc4f2a76: folds
a9ba79a: folds
d32d3acf: folds
Uncalled bet ($0.03) returned to 3f43d5e9
*** SHOWDOWN ***
3f43d5e9 collected $0.04 from pot
*** SUMMARY ***
Total pot $0.04 | Rake $0 | Jackpot $0 | Bingo $0 | Fortune $0 | Tax $0
Seat 1: a9ba79a (button) folded before Flop (didn't bet)
Seat 2: d32d3acf (small blind) folded before Flop
Seat 3: 3f43d5e9 (big blind) collected ($0.04)
Seat 4: Hero folded before Flop (didn't bet)
Seat 5: 7fbe4590 folded before Flop (didn't bet)
Seat 6: dc4f2a76 folded before Flop (didn't bet)


Poker Hand #RC3795933568: Hold'em No Limit ($0.02/$0.05) - 2025/08/10 08:41:12
Table 'RushAndCash11068828' 6-max Seat #1 is the button
Seat 1: f73fbb5a ($3.16 in chips)
Seat 2: 73869740 ($6.55 in chips)
Seat 3: Hero ($8.78 in chips)
Seat 4: 4b9df3fe ($9 in chips)
Seat 5: aa95eeae ($5.05 in chips)
Seat 6: 89697fca ($5.05 in chips)
73869740: posts small blind $0.02
Hero: posts big blind $0.05
*** HOLE CARDS ***
Dealt to f73fbb5a 
Dealt to 73869740 
Dealt to Hero [7s 3h]
Dealt to 4b9df3fe 
Dealt to aa95eeae 
Dealt to 89697fca 
4b9df3fe: folds
aa95eeae: folds
89697fca: raises $0.05 to $0.1
f73fbb5a: folds
73869740: folds
Hero: folds
Uncalled bet ($0.05) returned to 89697fca
*** SHOWDOWN ***
89697fca collected $0.12 from pot
*** SUMMARY ***
Total pot $0.12 | Rake $0 | Jackpot $0 | Bingo $0 | Fortune $0 | Tax $0
Seat 1: f73fbb5a (button) folded before Flop (didn't bet)
Seat 2: 73869740 (small blind) folded before Flop
Seat 3: Hero (big blind) folded before Flop
Seat 4: 4b9df3fe folded before Flop (didn't bet)
Seat 5: aa95eeae folded before Flop (didn't bet)
Seat 6: 89697fca collected ($0.12)


Poker Hand #RC3795933558: Hold'em No Limit ($0.02/$0.05) - 2025/08/10 08:41:08
Table 'RushAndCash11068818' 6-max Seat #1 is the button
Seat 1: dc4f2a76 ($10.13 in chips)
Seat 2: aa95eeae ($5.07 in chips)
Seat 3: ab33e85c ($3.77 in chips)
Seat 4: fa1b15ba ($12.18 in chips)
Seat 5: de160a56 ($9.08 in chips)
Seat 6: Hero ($8.78 in chips)
aa95eeae: posts small blind $0.02
ab33e85c: posts big blind $0.05
*** HOLE CARDS ***
Dealt to dc4f2a76 
Dealt to aa95eeae 
Dealt to ab33e85c 
Dealt to fa1b15ba 
Dealt to de160a56 
Dealt to Hero [2h 7d]
fa1b15ba: folds
de160a56: folds
Hero: folds
dc4f2a76: folds
aa95eeae: folds
Uncalled bet ($0.03) returned to ab33e85c
*** SHOWDOWN ***
ab33e85c collected $0.04 from pot
*** SUMMARY ***
Total pot $0.04 | Rake $0 | Jackpot $0 | Bingo $0 | Fortune $0 | Tax $0
Seat 1: dc4f2a76 (button) folded before Flop (didn't bet)
Seat 2: aa95eeae (small blind) folded before Flop
Seat 3: ab33e85c (big blind) collected ($0.04)
Seat 4: fa1b15ba folded before Flop (didn't bet)
Seat 5: de160a56 folded before Flop (didn't bet)
Seat 6: Hero folded before Flop (didn't bet)


Poker Hand #RC3795933540: Hold'em No Limit ($0.02/$0.05) - 2025/08/10 08:41:04
Table 'RushAndCash11068800' 6-max Seat #1 is the button
Seat 1: Hero ($8.78 in chips)
Seat 2: 9b73cb59 ($5.43 in chips)
Seat 3: ede202e3 ($6.61 in chips)
Seat 4: e90b1294 ($5 in chips)
Seat 5: 7244fd77 ($5.36 in chips)
Seat 6: d30b0a9c ($5.96 in chips)
9b73cb59: posts small blind $0.02
ede202e3: posts big blind $0.05
*** HOLE CARDS ***
Dealt to Hero [3d Ks]
Dealt to 9b73cb59 
Dealt to ede202e3 
Dealt to e90b1294 
Dealt to 7244fd77 
Dealt to d30b0a9c 
e90b1294: folds
7244fd77: folds
d30b0a9c: raises $0.07 to $0.12
Hero: folds
9b73cb59: raises $0.4 to $0.52
ede202e3: folds
d30b0a9c: folds
Uncalled bet ($0.4) returned to 9b73cb59
*** SHOWDOWN ***
9b73cb59 collected $0.28 from pot
*** SUMMARY ***
Total pot $0.29 | Rake $0.01 | Jackpot $0 | Bingo $0 | Fortune $0 | Tax $0
Seat 1: Hero (button) folded before Flop (didn't bet)
Seat 2: 9b73cb59 (small blind) collected ($0.28)
Seat 3: ede202e3 (big blind) folded before Flop
Seat 4: e90b1294 folded before Flop (didn't bet)
Seat 5: 7244fd77 folded before Flop (didn't bet)
Seat 6: d30b0a9c folded before Flop


Poker Hand #RC3795933521: Hold'em No Limit ($0.02/$0.05) - 2025/08/10 08:40:58
Table 'RushAndCash11068781' 6-max Seat #1 is the button
Seat 1: db3b59eb ($7.43 in chips)
Seat 2: Hero ($8.8 in chips)
Seat 3: 91b024bc ($10.93 in chips)
Seat 4: ab33e85c ($3.79 in chips)
Seat 5: 170dea69 ($7.03 in chips)
Seat 6: 196a508f ($12.76 in chips)
Hero: posts small blind $0.02
91b024bc: posts big blind $0.05
*** HOLE CARDS ***
Dealt to db3b59eb 
Dealt to Hero [8s Kd]
Dealt to 91b024bc 
Dealt to ab33e85c 
Dealt to 170dea69 
Dealt to 196a508f 
ab33e85c: folds
170dea69: raises $0.05 to $0.1
196a508f: folds
db3b59eb: folds
Hero: folds
91b024bc: folds
Uncalled bet ($0.05) returned to 170dea69
*** SHOWDOWN ***
170dea69 collected $0.12 from pot
*** SUMMARY ***
Total pot $0.12 | Rake $0 | Jackpot $0 | Bingo $0 | Fortune $0 | Tax $0
Seat 1: db3b59eb (button) folded before Flop (didn't bet)
Seat 2: Hero (small blind) folded before Flop
Seat 3: 91b024bc (big blind) folded before Flop
Seat 4: ab33e85c folded before Flop (didn't bet)
Seat 5: 170dea69 collected ($0.12)
Seat 6: 196a508f folded before Flop (didn't bet)


Poker Hand #RC3795933509: Hold'em No Limit ($0.02/$0.05) - 2025/08/10 08:40:54
Table 'RushAndCash11068769' 6-max Seat #1 is the button
Seat 1: 41ed372d ($5.12 in chips)
Seat 2: e612f091 ($6.71 in chips)
Seat 3: c4cbb3ef ($5 in chips)
Seat 4: Hero ($8.8 in chips)
Seat 5: cf3b419d ($4.13 in chips)
Seat 6: 33f8d3d1 ($5 in chips)
e612f091: posts small blind $0.02
c4cbb3ef: posts big blind $0.05
*** HOLE CARDS ***
Dealt to 41ed372d 
Dealt to e612f091 
Dealt to c4cbb3ef 
Dealt to Hero [4h 9d]
Dealt to cf3b419d 
Dealt to 33f8d3d1 
Hero: folds
cf3b419d: folds
33f8d3d1: folds
41ed372d: raises $0.08 to $0.13
e612f091: calls $0.11
c4cbb3ef: folds
*** FLOP *** [4c 8s 3c]
e612f091: bets $0.18
41ed372d: calls $0.18
*** TURN *** [4c 8s 3c] [2s]
e612f091: bets $0.39
41ed372d: folds
Uncalled bet ($0.39) returned to e612f091
*** SHOWDOWN ***
e612f091 collected $0.64 from pot
*** SUMMARY ***
Total pot $0.67 | Rake $0.03 | Jackpot $0 | Bingo $0 | Fortune $0 | Tax $0
Board [4c 8s 3c 2s]
Seat 1: 41ed372d (button) folded on the Turn
Seat 2: e612f091 (small blind) won ($0.64)
Seat 3: c4cbb3ef (big blind) folded before Flop
Seat 4: Hero folded before Flop (didn't bet)
Seat 5: cf3b419d folded before Flop (didn't bet)
Seat 6: 33f8d3d1 folded before Flop (didn't bet)


Poker Hand #RC3795933499: Hold'em No Limit ($0.02/$0.05) - 2025/08/10 08:40:51
Table 'RushAndCash11068759' 6-max Seat #1 is the button
Seat 1: 7165cda2 ($5.71 in chips)
Seat 2: 79f65393 ($5.76 in chips)
Seat 3: e612f091 ($6.76 in chips)
Seat 4: aa95eeae ($5 in chips)
Seat 5: c6b4a39c ($5.05 in chips)
Seat 6: Hero ($8.8 in chips)
79f65393: posts small blind $0.02
e612f091: posts big blind $0.05
*** HOLE CARDS ***
Dealt to 7165cda2 
Dealt to 79f65393 
Dealt to e612f091 
Dealt to aa95eeae 
Dealt to c6b4a39c 
Dealt to Hero [7d 9h]
aa95eeae: folds
c6b4a39c: folds
Hero: folds
7165cda2: raises $0.05 to $0.1
79f65393: calls $0.08
e612f091: folds
*** FLOP *** [Kh Jd 8c]
79f65393: checks
7165cda2: bets $0.19
79f65393: folds
Uncalled bet ($0.19) returned to 7165cda2
*** SHOWDOWN ***
7165cda2 collected $0.24 from pot
*** SUMMARY ***
Total pot $0.25 | Rake $0.01 | Jackpot $0 | Bingo $0 | Fortune $0 | Tax $0
Board [Kh Jd 8c]
Seat 1: 7165cda2 (button) won ($0.24)
Seat 2: 79f65393 (small blind) folded on the Flop
Seat 3: e612f091 (big blind) folded before Flop
Seat 4: aa95eeae folded before Flop (didn't bet)
Seat 5: c6b4a39c folded before Flop (didn't bet)
Seat 6: Hero folded before Flop (didn't bet)


Poker Hand #RC3795933488: Hold'em No Limit ($0.02/$0.05) - 2025/08/10 08:40:47
Table 'RushAndCash11068748' 6-max Seat #1 is the button
Seat 1: 79f65393 ($5.76 in chips)
Seat 2: 99058ade ($3.66 in chips)
Seat 3: 5c26b831 ($5.02 in chips)
Seat 4: Hero ($8.8 in chips)
Seat 5: fd8ef7f7 ($5 in chips)
Seat 6: bbb8a565 ($5.57 in chips)
99058ade: posts small blind $0.02
5c26b831: posts big blind $0.05
*** HOLE CARDS ***
Dealt to 79f65393 
Dealt to 99058ade 
Dealt to 5c26b831 
Dealt to Hero [6c Kc]
Dealt to fd8ef7f7 
Dealt to bbb8a565 
Hero: folds
fd8ef7f7: folds
bbb8a565: folds
79f65393: folds
99058ade: raises $0.1 to $0.15
5c26b831: folds
Uncalled bet ($0.1) returned to 99058ade
*** SHOWDOWN ***
99058ade collected $0.1 from pot
*** SUMMARY ***
Total pot $0.1 | Rake $0 | Jackpot $0 | Bingo $0 | Fortune $0 | Tax $0
Seat 1: 79f65393 (button) folded before Flop (didn't bet)
Seat 2: 99058ade (small blind) collected ($0.1)
Seat 3: 5c26b831 (big blind) folded before Flop
Seat 4: Hero folded before Flop (didn't bet)
Seat 5: fd8ef7f7 folded before Flop (didn't bet)
Seat 6: bbb8a565 folded before Flop (didn't bet)


Poker Hand #RC3795933476: Hold'em No Limit ($0.02/$0.05) - 2025/08/10 08:40:43
Table 'RushAndCash11068736' 6-max Seat #1 is the button
Seat 1: db22ee6f ($23.13 in chips)
Seat 2: d8b9a478 ($4.45 in chips)
Seat 3: a187372 ($5.68 in chips)
Seat 4: 5de4d206 ($5 in chips)
Seat 5: 3a68afa9 ($6.28 in chips)
Seat 6: Hero ($8.8 in chips)
d8b9a478: posts small blind $0.02
a187372: posts big blind $0.05
*** HOLE CARDS ***
Dealt to db22ee6f 
Dealt to d8b9a478 
Dealt to a187372 
Dealt to 5de4d206 
Dealt to 3a68afa9 
Dealt to Hero [4h Qd]
5de4d206: raises $0.1 to $0.15
3a68afa9: folds
Hero: folds
db22ee6f: folds
d8b9a478: calls $0.13
a187372: folds
*** FLOP *** [7h 6d 7c]
d8b9a478: bets $0.1
5de4d206: calls $0.1
*** TURN *** [7h 6d 7c] [3h]
d8b9a478: checks
5de4d206: bets $0.44
d8b9a478: folds
Uncalled bet ($0.44) returned to 5de4d206
*** SHOWDOWN ***
5de4d206 collected $0.53 from pot
*** SUMMARY ***
Total pot $0.55 | Rake $0.02 | Jackpot $0 | Bingo $0 | Fortune $0 | Tax $0
Board [7h 6d 7c 3h]
Seat 1: db22ee6f (button) folded before Flop (didn't bet)
Seat 2: d8b9a478 (small blind) folded on the Turn
Seat 3: a187372 (big blind) folded before Flop
Seat 4: 5de4d206 won ($0.53)
Seat 5: 3a68afa9 folded before Flop (didn't bet)
Seat 6: Hero folded before Flop (didn't bet)


Poker Hand #RC3795933442: Hold'em No Limit ($0.02/$0.05) - 2025/08/10 08:40:32
Table 'RushAndCash11068702' 6-max Seat #1 is the button
Seat 1: 5de4d206 ($5 in chips)
Seat 2: 2c53d2c7 ($6.12 in chips)
Seat 3: Hero ($8.78 in chips)
Seat 4: b3cc8379 ($5 in chips)
Seat 5: 91b024bc ($10.95 in chips)
Seat 6: 999a0f96 ($5 in chips)
2c53d2c7: posts small blind $0.02
Hero: posts big blind $0.05
*** HOLE CARDS ***
Dealt to 5de4d206 
Dealt to 2c53d2c7 
Dealt to Hero [Ks 8h]
Dealt to b3cc8379 
Dealt to 91b024bc 
Dealt to 999a0f96 
b3cc8379: folds
91b024bc: folds
999a0f96: folds
5de4d206: folds
2c53d2c7: folds
Uncalled bet ($0.03) returned to Hero
*** SHOWDOWN ***
Hero collected $0.04 from pot
*** SUMMARY ***
Total pot $0.04 | Rake $0 | Jackpot $0 | Bingo $0 | Fortune $0 | Tax $0
Seat 1: 5de4d206 (button) folded before Flop (didn't bet)
Seat 2: 2c53d2c7 (small blind) folded before Flop
Seat 3: Hero (big blind) collected ($0.04)
Seat 4: b3cc8379 folded before Flop (didn't bet)
Seat 5: 91b024bc folded before Flop (didn't bet)
Seat 6: 999a0f96 folded before Flop (didn't bet)


Poker Hand #RC3795933401: Hold'em No Limit ($0.02/$0.05) - 2025/08/10 08:40:19
Table 'RushAndCash11068661' 6-max Seat #1 is the button
Seat 1: 9d70d038 ($13.33 in chips)
Seat 2: Hero ($8.73 in chips)
Seat 3: 4844e57f ($6.04 in chips)
Seat 4: 630dda79 ($5.14 in chips)
Seat 5: 7fbe4590 ($4.66 in chips)
Seat 6: 560bbe0d ($14.02 in chips)
Hero: posts small blind $0.02
4844e57f: posts big blind $0.05
*** HOLE CARDS ***
Dealt to 9d70d038 
Dealt to Hero [5h 4h]
Dealt to 4844e57f 
Dealt to 630dda79 
Dealt to 7fbe4590 
Dealt to 560bbe0d 
630dda79: folds
7fbe4590: folds
560bbe0d: folds
9d70d038: folds
Hero: raises $0.05 to $0.1
4844e57f: folds
Uncalled bet ($0.05) returned to Hero
*** SHOWDOWN ***
Hero collected $0.1 from pot
*** SUMMARY ***
Total pot $0.1 | Rake $0 | Jackpot $0 | Bingo $0 | Fortune $0 | Tax $0
Seat 1: 9d70d038 (button) folded before Flop (didn't bet)
Seat 2: Hero (small blind) collected ($0.1)
Seat 3: 4844e57f (big blind) folded before Flop
Seat 4: 630dda79 folded before Flop (didn't bet)
Seat 5: 7fbe4590 folded before Flop (didn't bet)
Seat 6: 560bbe0d folded before Flop (didn't bet)


Poker Hand #RC3795933383: Hold'em No Limit ($0.02/$0.05) - 2025/08/10 08:40:14
Table 'RushAndCash11068643' 6-max Seat #1 is the button
Seat 1: Hero ($8.73 in chips)
Seat 2: de160a56 ($9.2 in chips)
Seat 3: c4ed83bc ($5 in chips)
Seat 4: fa1b15ba ($12.42 in chips)
Seat 5: d129d800 ($2.92 in chips)
Seat 6: 14ed52c2 ($4.78 in chips)
de160a56: posts small blind $0.02
c4ed83bc: posts big blind $0.05
*** HOLE CARDS ***
Dealt to Hero [4h 6c]
Dealt to de160a56 
Dealt to c4ed83bc 
Dealt to fa1b15ba 
Dealt to d129d800 
Dealt to 14ed52c2 
fa1b15ba: raises $0.08 to $0.13
d129d800: folds
14ed52c2: calls $0.13
Hero: folds
de160a56: folds
c4ed83bc: folds
*** FLOP *** [Qh Jh 7s]
fa1b15ba: bets $0.11
14ed52c2: raises $4.54 to $4.65 and is all-in
fa1b15ba: folds
Uncalled bet ($4.54) returned to 14ed52c2
*** SHOWDOWN ***
14ed52c2 collected $0.53 from pot
*** SUMMARY ***
Total pot $0.55 | Rake $0.02 | Jackpot $0 | Bingo $0 | Fortune $0 | Tax $0
Board [Qh Jh 7s]
Seat 1: Hero (button) folded before Flop (didn't bet)
Seat 2: de160a56 (small blind) folded before Flop
Seat 3: c4ed83bc (big blind) folded before Flop
Seat 4: fa1b15ba folded on the Flop
Seat 5: d129d800 folded before Flop (didn't bet)
Seat 6: 14ed52c2 won ($0.53)


Poker Hand #RC3795933369: Hold'em No Limit ($0.02/$0.05) - 2025/08/10 08:40:10
Table 'RushAndCash11068629' 6-max Seat #1 is the button
Seat 1: 7d7b2f21 ($5.31 in chips)
Seat 2: 4392275e ($5 in chips)
Seat 3: 8d1c252c ($9.93 in chips)
Seat 4: 14ed52c2 ($4.78 in chips)
Seat 5: 770bebf2 ($5.46 in chips)
Seat 6: Hero ($8.73 in chips)
4392275e: posts small blind $0.02
8d1c252c: posts big blind $0.05
*** HOLE CARDS ***
Dealt to 7d7b2f21 
Dealt to 4392275e 
Dealt to 8d1c252c 
Dealt to 14ed52c2 
Dealt to 770bebf2 
Dealt to Hero [9h Kd]
14ed52c2: folds
770bebf2: folds
Hero: folds
7d7b2f21: folds
4392275e: folds
Uncalled bet ($0.03) returned to 8d1c252c
*** SHOWDOWN ***
8d1c252c collected $0.04 from pot
*** SUMMARY ***
Total pot $0.04 | Rake $0 | Jackpot $0 | Bingo $0 | Fortune $0 | Tax $0
Seat 1: 7d7b2f21 (button) folded before Flop (didn't bet)
Seat 2: 4392275e (small blind) folded before Flop
Seat 3: 8d1c252c (big blind) collected ($0.04)
Seat 4: 14ed52c2 folded before Flop (didn't bet)
Seat 5: 770bebf2 folded before Flop (didn't bet)
Seat 6: Hero folded before Flop (didn't bet)


Poker Hand #RC3795933347: Hold'em No Limit ($0.02/$0.05) - 2025/08/10 08:40:03
Table 'RushAndCash11068607' 6-max Seat #1 is the button
Seat 1: 91b024bc ($11.02 in chips)
Seat 2: ac25def9 ($6.22 in chips)
Seat 3: 67671ee6 ($5 in chips)
Seat 4: Hero ($8.73 in chips)
Seat 5: 210c8e9b ($11.66 in chips)
Seat 6: 4844e57f ($6.06 in chips)
ac25def9: posts small blind $0.02
67671ee6: posts big blind $0.05
*** HOLE CARDS ***
Dealt to 91b024bc 
Dealt to ac25def9 
Dealt to 67671ee6 
Dealt to Hero [Ts Qh]
Dealt to 210c8e9b 
Dealt to 4844e57f 
Hero: folds
210c8e9b: raises $0.08 to $0.13
4844e57f: folds
91b024bc: folds
ac25def9: folds
67671ee6: folds
Uncalled bet ($0.08) returned to 210c8e9b
*** SHOWDOWN ***
210c8e9b collected $0.12 from pot
*** SUMMARY ***
Total pot $0.12 | Rake $0 | Jackpot $0 | Bingo $0 | Fortune $0 | Tax $0
Seat 1: 91b024bc (button) folded before Flop (didn't bet)
Seat 2: ac25def9 (small blind) folded before Flop
Seat 3: 67671ee6 (big blind) folded before Flop
Seat 4: Hero folded before Flop (didn't bet)
Seat 5: 210c8e9b collected ($0.12)
Seat 6: 4844e57f folded before Flop (didn't bet)


Poker Hand #RC3795933336: Hold'em No Limit ($0.02/$0.05) - 2025/08/10 08:39:59
Table 'RushAndCash11068596' 6-max Seat #1 is the button
Seat 1: da84e89d ($6.86 in chips)
Seat 2: 3a68afa9 ($6.16 in chips)
Seat 3: 4392275e ($5 in chips)
Seat 4: ac25def9 ($6.22 in chips)
Seat 5: 67671ee6 ($5 in chips)
Seat 6: Hero ($8.73 in chips)
3a68afa9: posts small blind $0.02
4392275e: posts big blind $0.05
*** HOLE CARDS ***
Dealt to da84e89d 
Dealt to 3a68afa9 
Dealt to 4392275e 
Dealt to ac25def9 
Dealt to 67671ee6 
Dealt to Hero [9s 8d]
ac25def9: folds
67671ee6: folds
Hero: folds
da84e89d: folds
3a68afa9: raises $0.1 to $0.15
4392275e: folds
Uncalled bet ($0.1) returned to 3a68afa9
*** SHOWDOWN ***
3a68afa9 collected $0.1 from pot
*** SUMMARY ***
Total pot $0.1 | Rake $0 | Jackpot $0 | Bingo $0 | Fortune $0 | Tax $0
Seat 1: da84e89d (button) folded before Flop (didn't bet)
Seat 2: 3a68afa9 (small blind) collected ($0.1)
Seat 3: 4392275e (big blind) folded before Flop
Seat 4: ac25def9 folded before Flop (didn't bet)
Seat 5: 67671ee6 folded before Flop (didn't bet)
Seat 6: Hero folded before Flop (didn't bet)


Poker Hand #RC3795933323: Hold'em No Limit ($0.02/$0.05) - 2025/08/10 08:39:56
Table 'RushAndCash11068583' 6-max Seat #1 is the button
Seat 1: 7a09703 ($5.76 in chips)
Seat 2: 85e4ce3a ($16.58 in chips)
Seat 3: 9e9f7171 ($6.59 in chips)
Seat 4: 96dde0a5 ($3.26 in chips)
Seat 5: Hero ($8.73 in chips)
Seat 6: 68db1858 ($4.73 in chips)
85e4ce3a: posts small blind $0.02
9e9f7171: posts big blind $0.05
*** HOLE CARDS ***
Dealt to 7a09703 
Dealt to 85e4ce3a 
Dealt to 9e9f7171 
Dealt to 96dde0a5 
Dealt to Hero [8s 5c]
Dealt to 68db1858 
96dde0a5: raises $0.05 to $0.1
Hero: folds
68db1858: folds
7a09703: folds
85e4ce3a: calls $0.08
9e9f7171: folds
*** FLOP *** [Qd Jh Kh]
85e4ce3a: checks
96dde0a5: bets $0.09
85e4ce3a: calls $0.09
*** TURN *** [Qd Jh Kh] [2d]
85e4ce3a: checks
96dde0a5: bets $0.6
85e4ce3a: raises $0.6 to $1.2
96dde0a5: raises $1.87 to $3.07 and is all-in
85e4ce3a: calls $1.87
96dde0a5: shows [Th 9h] (a straight, King to Nine)
85e4ce3a: shows [Jc Kc] (two pair, Kings and Jacks)
*** RIVER *** [Qd Jh Kh 2d] [Kd]
*** SHOWDOWN ***
85e4ce3a collected $6.35 from pot
*** SUMMARY ***
Total pot $6.57 | Rake $0.15 | Jackpot $0.07 | Bingo $0 | Fortune $0 | Tax $0
Board [Qd Jh Kh 2d Kd]
Seat 1: 7a09703 (button) folded before Flop (didn't bet)
Seat 2: 85e4ce3a (small blind) showed [Jc Kc] and won ($6.35) with a full house, Kings full of Jacks
Seat 3: 9e9f7171 (big blind) folded before Flop
Seat 4: 96dde0a5 showed [Th 9h] and lost with a straight, King to Nine
Seat 5: Hero folded before Flop (didn't bet)
Seat 6: 68db1858 folded before Flop (didn't bet)


Poker Hand #RC3795933239: Hold'em No Limit ($0.02/$0.05) - 2025/08/10 08:39:31
Table 'RushAndCash11068499' 6-max Seat #1 is the button
Seat 1: ffac256b ($5.11 in chips)
Seat 2: ede202e3 ($3.39 in chips)
Seat 3: Hero ($8.78 in chips)
Seat 4: 97b1f31 ($6.22 in chips)
Seat 5: fd694fda ($3.7 in chips)
Seat 6: 84a6e006 ($9.89 in chips)
ede202e3: posts small blind $0.02
Hero: posts big blind $0.05
*** HOLE CARDS ***
Dealt to ffac256b 
Dealt to ede202e3 
Dealt to Hero [6c Js]
Dealt to 97b1f31 
Dealt to fd694fda 
Dealt to 84a6e006 
97b1f31: raises $0.05 to $0.1
fd694fda: folds
84a6e006: folds
ffac256b: folds
ede202e3: folds
Hero: folds
Uncalled bet ($0.05) returned to 97b1f31
*** SHOWDOWN ***
97b1f31 collected $0.12 from pot
*** SUMMARY ***
Total pot $0.12 | Rake $0 | Jackpot $0 | Bingo $0 | Fortune $0 | Tax $0
Seat 1: ffac256b (button) folded before Flop (didn't bet)
Seat 2: ede202e3 (small blind) folded before Flop
Seat 3: Hero (big blind) folded before Flop
Seat 4: 97b1f31 collected ($0.12)
Seat 5: fd694fda folded before Flop (didn't bet)
Seat 6: 84a6e006 folded before Flop (didn't bet)


Poker Hand #RC3795933219: Hold'em No Limit ($0.02/$0.05) - 2025/08/10 08:39:27
Table 'RushAndCash11068479' 6-max Seat #1 is the button
Seat 1: ac3a4080 ($6.69 in chips)
Seat 2: Hero ($8.8 in chips)
Seat 3: a361fe13 ($5.14 in chips)
Seat 4: 18b1ecd7 ($7.95 in chips)
Seat 5: 42c31e1a ($11.98 in chips)
Seat 6: 9115c007 ($10.7 in chips)
Hero: posts small blind $0.02
a361fe13: posts big blind $0.05
*** HOLE CARDS ***
Dealt to ac3a4080 
Dealt to Hero [2h Th]
Dealt to a361fe13 
Dealt to 18b1ecd7 
Dealt to 42c31e1a 
Dealt to 9115c007 
18b1ecd7: folds
42c31e1a: raises $0.07 to $0.12
9115c007: folds
ac3a4080: folds
Hero: folds
a361fe13: folds
Uncalled bet ($0.07) returned to 42c31e1a
*** SHOWDOWN ***
42c31e1a collected $0.12 from pot
*** SUMMARY ***
Total pot $0.12 | Rake $0 | Jackpot $0 | Bingo $0 | Fortune $0 | Tax $0
Seat 1: ac3a4080 (button) folded before Flop (didn't bet)
Seat 2: Hero (small blind) folded before Flop
Seat 3: a361fe13 (big blind) folded before Flop
Seat 4: 18b1ecd7 folded before Flop (didn't bet)
Seat 5: 42c31e1a collected ($0.12)
Seat 6: 9115c007 folded before Flop (didn't bet)


Poker Hand #RC3795933175: Hold'em No Limit ($0.02/$0.05) - 2025/08/10 08:39:14
Table 'RushAndCash11068435' 6-max Seat #1 is the button
Seat 1: f76279b5 ($7.19 in chips)
Seat 2: Hero ($8.82 in chips)
Seat 3: e0ff0229 ($7.47 in chips)
Seat 4: 8fc6d1e4 ($5.14 in chips)
Seat 5: 662fd34 ($5.4 in chips)
Seat 6: bc8475a8 ($6.39 in chips)
Hero: posts small blind $0.02
e0ff0229: posts big blind $0.05
*** HOLE CARDS ***
Dealt to f76279b5 
Dealt to Hero [8h 6s]
Dealt to e0ff0229 
Dealt to 8fc6d1e4 
Dealt to 662fd34 
Dealt to bc8475a8 
8fc6d1e4: folds
662fd34: raises $0.05 to $0.1
bc8475a8: folds
f76279b5: folds
Hero: folds
e0ff0229: folds
Uncalled bet ($0.05) returned to 662fd34
*** SHOWDOWN ***
662fd34 collected $0.12 from pot
*** SUMMARY ***
Total pot $0.12 | Rake $0 | Jackpot $0 | Bingo $0 | Fortune $0 | Tax $0
Seat 1: f76279b5 (button) folded before Flop (didn't bet)
Seat 2: Hero (small blind) folded before Flop
Seat 3: e0ff0229 (big blind) folded before Flop
Seat 4: 8fc6d1e4 folded before Flop (didn't bet)
Seat 5: 662fd34 collected ($0.12)
Seat 6: bc8475a8 folded before Flop (didn't bet)


Poker Hand #RC3795933157: Hold'em No Limit ($0.02/$0.05) - 2025/08/10 08:39:08
Table 'RushAndCash11068417' 6-max Seat #1 is the button
Seat 1: 7fbe4590 ($4.73 in chips)
Seat 2: f9c2033b ($5.69 in chips)
Seat 3: fccf4928 ($12.87 in chips)
Seat 4: d89f942b ($5 in chips)
Seat 5: 9095f6a6 ($5.03 in chips)
Seat 6: Hero ($8.82 in chips)
f9c2033b: posts small blind $0.02
fccf4928: posts big blind $0.05
*** HOLE CARDS ***
Dealt to 7fbe4590 
Dealt to f9c2033b 
Dealt to fccf4928 
Dealt to d89f942b 
Dealt to 9095f6a6 
Dealt to Hero [9c Js]
d89f942b: raises $0.1 to $0.15
9095f6a6: folds
Hero: folds
7fbe4590: folds
f9c2033b: folds
fccf4928: folds
Uncalled bet ($0.1) returned to d89f942b
*** SHOWDOWN ***
d89f942b collected $0.12 from pot
*** SUMMARY ***
Total pot $0.12 | Rake $0 | Jackpot $0 | Bingo $0 | Fortune $0 | Tax $0
Seat 1: 7fbe4590 (button) folded before Flop (didn't bet)
Seat 2: f9c2033b (small blind) folded before Flop
Seat 3: fccf4928 (big blind) folded before Flop
Seat 4: d89f942b collected ($0.12)
Seat 5: 9095f6a6 folded before Flop (didn't bet)
Seat 6: Hero folded before Flop (didn't bet)


Poker Hand #RC3795933119: Hold'em No Limit ($0.02/$0.05) - 2025/08/10 08:38:56
Table 'RushAndCash11068379' 6-max Seat #1 is the button
Seat 1: Hero ($8.82 in chips)
Seat 2: aad7b238 ($3.44 in chips)
Seat 3: bf4e2b6b ($22.09 in chips)
Seat 4: 770bebf2 ($5 in chips)
Seat 5: 79f65393 ($5.51 in chips)
Seat 6: 7fbe4590 ($4.73 in chips)
aad7b238: posts small blind $0.02
bf4e2b6b: posts big blind $0.05
*** HOLE CARDS ***
Dealt to Hero [7h 9s]
Dealt to aad7b238 
Dealt to bf4e2b6b 
Dealt to 770bebf2 
Dealt to 79f65393 
Dealt to 7fbe4590 
770bebf2: folds
79f65393: folds
7fbe4590: folds
Hero: folds
aad7b238: folds
Uncalled bet ($0.03) returned to bf4e2b6b
*** SHOWDOWN ***
bf4e2b6b collected $0.04 from pot
*** SUMMARY ***
Total pot $0.04 | Rake $0 | Jackpot $0 | Bingo $0 | Fortune $0 | Tax $0
Seat 1: Hero (button) folded before Flop (didn't bet)
Seat 2: aad7b238 (small blind) folded before Flop
Seat 3: bf4e2b6b (big blind) collected ($0.04)
Seat 4: 770bebf2 folded before Flop (didn't bet)
Seat 5: 79f65393 folded before Flop (didn't bet)
Seat 6: 7fbe4590 folded before Flop (didn't bet)


Poker Hand #RC3795933106: Hold'em No Limit ($0.02/$0.05) - 2025/08/10 08:38:53
Table 'RushAndCash11068366' 6-max Seat #1 is the button
Seat 1: 40729ff5 ($5.07 in chips)
Seat 2: 7fbe4590 ($4.75 in chips)
Seat 3: 55b6c449 ($5.94 in chips)
Seat 4: 6e6d6019 ($6.72 in chips)
Seat 5: Hero ($8.82 in chips)
Seat 6: 391d0c67 ($7.46 in chips)
7fbe4590: posts small blind $0.02
55b6c449: posts big blind $0.05
*** HOLE CARDS ***
Dealt to 40729ff5 
Dealt to 7fbe4590 
Dealt to 55b6c449 
Dealt to 6e6d6019 
Dealt to Hero [6c Tc]
Dealt to 391d0c67 
6e6d6019: raises $0.05 to $0.1
Hero: folds
391d0c67: folds
40729ff5: folds
7fbe4590: folds
55b6c449: folds
Uncalled bet ($0.05) returned to 6e6d6019
*** SHOWDOWN ***
6e6d6019 collected $0.12 from pot
*** SUMMARY ***
Total pot $0.12 | Rake $0 | Jackpot $0 | Bingo $0 | Fortune $0 | Tax $0
Seat 1: 40729ff5 (button) folded before Flop (didn't bet)
Seat 2: 7fbe4590 (small blind) folded before Flop
Seat 3: 55b6c449 (big blind) folded before Flop
Seat 4: 6e6d6019 collected ($0.12)
Seat 5: Hero folded before Flop (didn't bet)
Seat 6: 391d0c67 folded before Flop (didn't bet)


Poker Hand #RC3795933081: Hold'em No Limit ($0.02/$0.05) - 2025/08/10 08:38:46
Table 'RushAndCash11068341' 6-max Seat #1 is the button
Seat 1: Hero ($8.82 in chips)
Seat 2: f6bf8dfb ($11.52 in chips)
Seat 3: 5b54e251 ($12.62 in chips)
Seat 4: ccbf95f3 ($5 in chips)
Seat 5: f3b2c7e8 ($5 in chips)
Seat 6: 453d8970 ($5 in chips)
f6bf8dfb: posts small blind $0.02
5b54e251: posts big blind $0.05
*** HOLE CARDS ***
Dealt to Hero [6s Td]
Dealt to f6bf8dfb 
Dealt to 5b54e251 
Dealt to ccbf95f3 
Dealt to f3b2c7e8 
Dealt to 453d8970 
ccbf95f3: folds
f3b2c7e8: folds
453d8970: folds
Hero: folds
f6bf8dfb: folds
Uncalled bet ($0.03) returned to 5b54e251
*** SHOWDOWN ***
5b54e251 collected $0.04 from pot
*** SUMMARY ***
Total pot $0.04 | Rake $0 | Jackpot $0 | Bingo $0 | Fortune $0 | Tax $0
Seat 1: Hero (button) folded before Flop (didn't bet)
Seat 2: f6bf8dfb (small blind) folded before Flop
Seat 3: 5b54e251 (big blind) collected ($0.04)
Seat 4: ccbf95f3 folded before Flop (didn't bet)
Seat 5: f3b2c7e8 folded before Flop (didn't bet)
Seat 6: 453d8970 folded before Flop (didn't bet)


Poker Hand #RC3795932790: Hold'em No Limit ($0.02/$0.05) - 2025/08/10 08:37:16
Table 'RushAndCash11068050' 6-max Seat #1 is the button
Seat 1: ccbf95f3 ($5.09 in chips)
Seat 2: 9ae53275 ($5.64 in chips)
Seat 3: 391d0c67 ($7.66 in chips)
Seat 4: Hero ($9.06 in chips)
Seat 5: f6bf8dfb ($10.96 in chips)
Seat 6: db3d7016 ($5.25 in chips)
9ae53275: posts small blind $0.02
391d0c67: posts big blind $0.05
*** HOLE CARDS ***
Dealt to ccbf95f3 
Dealt to 9ae53275 
Dealt to 391d0c67 
Dealt to Hero [Kh Jd]
Dealt to f6bf8dfb 
Dealt to db3d7016 
Hero: raises $0.05 to $0.1
f6bf8dfb: calls $0.1
db3d7016: folds
ccbf95f3: calls $0.1
9ae53275: folds
391d0c67: calls $0.05
*** FLOP *** [Ah 5c Td]
391d0c67: checks
Hero: checks
f6bf8dfb: bets $0.14
ccbf95f3: calls $0.14
391d0c67: folds
Hero: calls $0.14
*** TURN *** [Ah 5c Td] [Tc]
Hero: checks
f6bf8dfb: checks
ccbf95f3: checks
*** RIVER *** [Ah 5c Td Tc] [2d]
Hero: checks
f6bf8dfb: checks
ccbf95f3: checks
Hero: shows [Kh Jd] (a pair of Tens)
f6bf8dfb: shows [As 9s] (two pair, Aces and Tens)
ccbf95f3: shows [3c 3h] (two pair, Tens and Threes)
*** SHOWDOWN ***
f6bf8dfb collected $0.8 from pot
*** SUMMARY ***
Total pot $0.84 | Rake $0.04 | Jackpot $0 | Bingo $0 | Fortune $0 | Tax $0
Board [Ah 5c Td Tc 2d]
Seat 1: ccbf95f3 (button) showed [3c 3h] and lost with two pair, Tens and Threes
Seat 2: 9ae53275 (small blind) folded before Flop
Seat 3: 391d0c67 (big blind) folded on the Flop
Seat 4: Hero showed [Kh Jd] and lost with a pair of Tens
Seat 5: f6bf8dfb showed [As 9s] and won ($0.8) with two pair, Aces and Tens
Seat 6: db3d7016 folded before Flop (didn't bet)


Poker Hand #RC3795932707: Hold'em No Limit ($0.02/$0.05) - 2025/08/10 08:36:49
Table 'RushAndCash11067967' 6-max Seat #1 is the button
Seat 1: ffac256b ($5.14 in chips)
Seat 2: 7e9b978a ($5.92 in chips)
Seat 3: Hero ($9.11 in chips)
Seat 4: bcd5617c ($5.3 in chips)
Seat 5: 63124400 ($13.26 in chips)
Seat 6: c47206f4 ($18.81 in chips)
7e9b978a: posts small blind $0.02
Hero: posts big blind $0.05
*** HOLE CARDS ***
Dealt to ffac256b 
Dealt to 7e9b978a 
Dealt to Hero [6h Jh]
Dealt to bcd5617c 
Dealt to 63124400 
Dealt to c47206f4 
bcd5617c: raises $0.05 to $0.1
63124400: folds
c47206f4: folds
ffac256b: folds
7e9b978a: folds
Hero: folds
Uncalled bet ($0.05) returned to bcd5617c
*** SHOWDOWN ***
bcd5617c collected $0.12 from pot
*** SUMMARY ***
Total pot $0.12 | Rake $0 | Jackpot $0 | Bingo $0 | Fortune $0 | Tax $0
Seat 1: ffac256b (button) folded before Flop (didn't bet)
Seat 2: 7e9b978a (small blind) folded before Flop
Seat 3: Hero (big blind) folded before Flop
Seat 4: bcd5617c collected ($0.12)
Seat 5: 63124400 folded before Flop (didn't bet)
Seat 6: c47206f4 folded before Flop (didn't bet)


Poker Hand #RC3795932530: Hold'em No Limit ($0.02/$0.05) - 2025/08/10 08:35:58
Table 'RushAndCash11067790' 6-max Seat #1 is the button
Seat 1: fa76288b ($4.95 in chips)
Seat 2: c47898d9 ($5 in chips)
Seat 3: 7e9b978a ($6.02 in chips)
Seat 4: 5c5d4a8d ($16.52 in chips)
Seat 5: Hero ($9 in chips)
Seat 6: bbb8a565 ($5.12 in chips)
c47898d9: posts small blind $0.02
7e9b978a: posts big blind $0.05
*** HOLE CARDS ***
Dealt to fa76288b 
Dealt to c47898d9 
Dealt to 7e9b978a 
Dealt to 5c5d4a8d 
Dealt to Hero [Tc Kd]
Dealt to bbb8a565 
5c5d4a8d: folds
Hero: raises $0.05 to $0.1
bbb8a565: folds
fa76288b: folds
c47898d9: folds
7e9b978a: calls $0.05
*** FLOP *** [7c 4s 3c]
7e9b978a: checks
Hero: checks
*** TURN *** [7c 4s 3c] [7s]
7e9b978a: checks
Hero: checks
*** RIVER *** [7c 4s 3c 7s] [5s]
7e9b978a: checks
Hero: bets $0.26
7e9b978a: folds
Uncalled bet ($0.26) returned to Hero
*** SHOWDOWN ***
Hero collected $0.21 from pot
*** SUMMARY ***
Total pot $0.22 | Rake $0.01 | Jackpot $0 | Bingo $0 | Fortune $0 | Tax $0
Board [7c 4s 3c 7s 5s]
Seat 1: fa76288b (button) folded before Flop (didn't bet)
Seat 2: c47898d9 (small blind) folded before Flop
Seat 3: 7e9b978a (big blind) folded on the River
Seat 4: 5c5d4a8d folded before Flop (didn't bet)
Seat 5: Hero won ($0.21)
Seat 6: bbb8a565 folded before Flop (didn't bet)


Poker Hand #RC3795932481: Hold'em No Limit ($0.02/$0.05) - 2025/08/10 08:35:43
Table 'RushAndCash11067741' 6-max Seat #1 is the button
Seat 1: 66a574d1 ($5 in chips)
Seat 2: b527583c ($8.99 in chips)
Seat 3: fa76288b ($5.07 in chips)
Seat 4: d27c038b ($2.43 in chips)
Seat 5: f1d249e2 ($5.05 in chips)
Seat 6: Hero ($8.93 in chips)
b527583c: posts small blind $0.02
fa76288b: posts big blind $0.05
*** HOLE CARDS ***
Dealt to 66a574d1 
Dealt to b527583c 
Dealt to fa76288b 
Dealt to d27c038b 
Dealt to f1d249e2 
Dealt to Hero [6s 6d]
d27c038b: folds
f1d249e2: folds
Hero: raises $0.05 to $0.1
66a574d1: folds
b527583c: folds
fa76288b: folds
Uncalled bet ($0.05) returned to Hero
*** SHOWDOWN ***
Hero collected $0.12 from pot
*** SUMMARY ***
Total pot $0.12 | Rake $0 | Jackpot $0 | Bingo $0 | Fortune $0 | Tax $0
Seat 1: 66a574d1 (button) folded before Flop (didn't bet)
Seat 2: b527583c (small blind) folded before Flop
Seat 3: fa76288b (big blind) folded before Flop
Seat 4: d27c038b folded before Flop (didn't bet)
Seat 5: f1d249e2 folded before Flop (didn't bet)
Seat 6: Hero collected ($0.12)


Poker Hand #RC3795932462: Hold'em No Limit ($0.02/$0.05) - 2025/08/10 08:35:37
Table 'RushAndCash11067722' 6-max Seat #1 is the button
Seat 1: 35c42e8c ($6.5 in chips)
Seat 2: Hero ($8.95 in chips)
Seat 3: b68395fc ($2.5 in chips)
Seat 4: d3b2bf87 ($7.47 in chips)
Seat 5: dc34d8ca ($5.3 in chips)
Seat 6: afbe94ee ($6.73 in chips)
Hero: posts small blind $0.02
b68395fc: posts big blind $0.05
*** HOLE CARDS ***
Dealt to 35c42e8c 
Dealt to Hero [Kh 6h]
Dealt to b68395fc 
Dealt to d3b2bf87 
Dealt to dc34d8ca 
Dealt to afbe94ee 
d3b2bf87: raises $0.06 to $0.11
dc34d8ca: folds
afbe94ee: folds
35c42e8c: folds
Hero: folds
b68395fc: folds
Uncalled bet ($0.06) returned to d3b2bf87
*** SHOWDOWN ***
d3b2bf87 collected $0.12 from pot
*** SUMMARY ***
Total pot $0.12 | Rake $0 | Jackpot $0 | Bingo $0 | Fortune $0 | Tax $0
Seat 1: 35c42e8c (button) folded before Flop (didn't bet)
Seat 2: Hero (small blind) folded before Flop
Seat 3: b68395fc (big blind) folded before Flop
Seat 4: d3b2bf87 collected ($0.12)
Seat 5: dc34d8ca folded before Flop (didn't bet)
Seat 6: afbe94ee folded before Flop (didn't bet)


Poker Hand #RC3795932439: Hold'em No Limit ($0.02/$0.05) - 2025/08/10 08:35:28
Table 'RushAndCash11067699' 6-max Seat #1 is the button
Seat 1: db3b59eb ($8.2 in chips)
Seat 2: f76279b5 ($12.5 in chips)
Seat 3: Hero ($9 in chips)
Seat 4: 73869740 ($5.09 in chips)
Seat 5: fe6e4f5c ($6.6 in chips)
Seat 6: d4249213 ($5 in chips)
f76279b5: posts small blind $0.02
Hero: posts big blind $0.05
*** HOLE CARDS ***
Dealt to db3b59eb 
Dealt to f76279b5 
Dealt to Hero [Qc 4h]
Dealt to 73869740 
Dealt to fe6e4f5c 
Dealt to d4249213 
73869740: raises $0.06 to $0.11
fe6e4f5c: folds
d4249213: folds
db3b59eb: folds
f76279b5: folds
Hero: folds
Uncalled bet ($0.06) returned to 73869740
*** SHOWDOWN ***
73869740 collected $0.12 from pot
*** SUMMARY ***
Total pot $0.12 | Rake $0 | Jackpot $0 | Bingo $0 | Fortune $0 | Tax $0
Seat 1: db3b59eb (button) folded before Flop (didn't bet)
Seat 2: f76279b5 (small blind) folded before Flop
Seat 3: Hero (big blind) folded before Flop
Seat 4: 73869740 collected ($0.12)
Seat 5: fe6e4f5c folded before Flop (didn't bet)
Seat 6: d4249213 folded before Flop (didn't bet)


Poker Hand #RC3795932424: Hold'em No Limit ($0.02/$0.05) - 2025/08/10 08:35:23
Table 'RushAndCash11067684' 6-max Seat #1 is the button
Seat 1: Hero ($9 in chips)
Seat 2: 2a76f9f5 ($8.73 in chips)
Seat 3: f9c2033b ($5.11 in chips)
Seat 4: bf4e2b6b ($21.9 in chips)
Seat 5: 69bc96d4 ($6.38 in chips)
Seat 6: 2b5a7a1b ($12.3 in chips)
2a76f9f5: posts small blind $0.02
f9c2033b: posts big blind $0.05
*** HOLE CARDS ***
Dealt to Hero [2d 9s]
Dealt to 2a76f9f5 
Dealt to f9c2033b 
Dealt to bf4e2b6b 
Dealt to 69bc96d4 
Dealt to 2b5a7a1b 
bf4e2b6b: folds
69bc96d4: folds
2b5a7a1b: folds
Hero: folds
2a76f9f5: folds
Uncalled bet ($0.03) returned to f9c2033b
*** SHOWDOWN ***
f9c2033b collected $0.04 from pot
*** SUMMARY ***
Total pot $0.04 | Rake $0 | Jackpot $0 | Bingo $0 | Fortune $0 | Tax $0
Seat 1: Hero (button) folded before Flop (didn't bet)
Seat 2: 2a76f9f5 (small blind) folded before Flop
Seat 3: f9c2033b (big blind) collected ($0.04)
Seat 4: bf4e2b6b folded before Flop (didn't bet)
Seat 5: 69bc96d4 folded before Flop (didn't bet)
Seat 6: 2b5a7a1b folded before Flop (didn't bet)


Poker Hand #RC3795932413: Hold'em No Limit ($0.02/$0.05) - 2025/08/10 08:35:20
Table 'RushAndCash11067673' 6-max Seat #1 is the button
Seat 1: 1dafb1bc ($38.09 in chips)
Seat 2: 9a343d90 ($6.32 in chips)
Seat 3: 42c31e1a ($11.82 in chips)
Seat 4: e6b7142a ($5.53 in chips)
Seat 5: Hero ($9 in chips)
Seat 6: f9c2033b ($5.11 in chips)
9a343d90: posts small blind $0.02
42c31e1a: posts big blind $0.05
*** HOLE CARDS ***
Dealt to 1dafb1bc 
Dealt to 9a343d90 
Dealt to 42c31e1a 
Dealt to e6b7142a 
Dealt to Hero [2s Jc]
Dealt to f9c2033b 
e6b7142a: raises $0.08 to $0.13
Hero: folds
f9c2033b: folds
1dafb1bc: folds
9a343d90: folds
42c31e1a: calls $0.08
*** FLOP *** [8c 3d 6d]
42c31e1a: checks
e6b7142a: checks
*** TURN *** [8c 3d 6d] [7s]
42c31e1a: checks
e6b7142a: checks
*** RIVER *** [8c 3d 6d 7s] [9h]
42c31e1a: checks
e6b7142a: checks
42c31e1a: shows [Ts Ad] (a straight, Ten to Six)
e6b7142a: shows [Qc Ks] (King high)
*** SHOWDOWN ***
42c31e1a collected $0.27 from pot
*** SUMMARY ***
Total pot $0.28 | Rake $0.01 | Jackpot $0 | Bingo $0 | Fortune $0 | Tax $0
Board [8c 3d 6d 7s 9h]
Seat 1: 1dafb1bc (button) folded before Flop (didn't bet)
Seat 2: 9a343d90 (small blind) folded before Flop
Seat 3: 42c31e1a (big blind) showed [Ts Ad] and won ($0.27) with a straight, Ten to Six
Seat 4: e6b7142a showed [Qc Ks] and lost with King high
Seat 5: Hero folded before Flop (didn't bet)
Seat 6: f9c2033b folded before Flop (didn't bet)


Poker Hand #RC3795932400: Hold'em No Limit ($0.02/$0.05) - 2025/08/10 08:35:16
Table 'RushAndCash11067660' 6-max Seat #1 is the button
Seat 1: e96f7e51 ($5.13 in chips)
Seat 2: ac25def9 ($6.41 in chips)
Seat 3: 5fc6009a ($5.37 in chips)
Seat 4: Hero ($9 in chips)
Seat 5: 29035a3b ($5 in chips)
Seat 6: 81fae1fb ($5.27 in chips)
ac25def9: posts small blind $0.02
5fc6009a: posts big blind $0.05
*** HOLE CARDS ***
Dealt to e96f7e51 
Dealt to ac25def9 
Dealt to 5fc6009a 
Dealt to Hero [6h Ac]
Dealt to 29035a3b 
Dealt to 81fae1fb 
Hero: folds
29035a3b: folds
81fae1fb: folds
e96f7e51: folds
ac25def9: folds
Uncalled bet ($0.03) returned to 5fc6009a
*** SHOWDOWN ***
5fc6009a collected $0.04 from pot
*** SUMMARY ***
Total pot $0.04 | Rake $0 | Jackpot $0 | Bingo $0 | Fortune $0 | Tax $0
Seat 1: e96f7e51 (button) folded before Flop (didn't bet)
Seat 2: ac25def9 (small blind) folded before Flop
Seat 3: 5fc6009a (big blind) collected ($0.04)
Seat 4: Hero folded before Flop (didn't bet)
Seat 5: 29035a3b folded before Flop (didn't bet)
Seat 6: 81fae1fb folded before Flop (didn't bet)


Poker Hand #RC3795932386: Hold'em No Limit ($0.02/$0.05) - 2025/08/10 08:35:12
Table 'RushAndCash11067646' 6-max Seat #1 is the button
Seat 1: Hero ($9 in chips)
Seat 2: 9d70d038 ($14.47 in chips)
Seat 3: 6780a6cb ($5 in chips)
Seat 4: b1b3930a ($5.11 in chips)
Seat 5: e9f334c0 ($9.59 in chips)
Seat 6: 92d348ff ($13.87 in chips)
9d70d038: posts small blind $0.02
6780a6cb: posts big blind $0.05
*** HOLE CARDS ***
Dealt to Hero [9s 6c]
Dealt to 9d70d038 
Dealt to 6780a6cb 
Dealt to b1b3930a 
Dealt to e9f334c0 
Dealt to 92d348ff 
b1b3930a: folds
e9f334c0: folds
92d348ff: folds
Hero: folds
9d70d038: raises $0.05 to $0.1
6780a6cb: calls $0.05
*** FLOP *** [8h Tc 7h]
9d70d038: checks
6780a6cb: checks
*** TURN *** [8h Tc 7h] [Jd]
9d70d038: checks
6780a6cb: checks
*** RIVER *** [8h Tc 7h Jd] [9h]
9d70d038: bets $0.07
6780a6cb: calls $0.07
9d70d038: shows [Qs Js] (a straight, Queen to Eight)
6780a6cb: shows [Jc Ah] (a straight, Jack to Seven)
*** SHOWDOWN ***
9d70d038 collected $0.33 from pot
*** SUMMARY ***
Total pot $0.34 | Rake $0.01 | Jackpot $0 | Bingo $0 | Fortune $0 | Tax $0
Board [8h Tc 7h Jd 9h]
Seat 1: Hero (button) folded before Flop (didn't bet)
Seat 2: 9d70d038 (small blind) showed [Qs Js] and won ($0.33) with a straight, Queen to Eight
Seat 3: 6780a6cb (big blind) showed [Jc Ah] and lost with a straight, Jack to Seven
Seat 4: b1b3930a folded before Flop (didn't bet)
Seat 5: e9f334c0 folded before Flop (didn't bet)
Seat 6: 92d348ff folded before Flop (didn't bet)


Poker Hand #RC3795932276: Hold'em No Limit ($0.02/$0.05) - 2025/08/10 08:34:36
Table 'RushAndCash11067536' 6-max Seat #1 is the button
Seat 1: 7a09703 ($5.94 in chips)
Seat 2: Hero ($8.95 in chips)
Seat 3: 9d70d038 ($14.52 in chips)
Seat 4: 170dea69 ($5.02 in chips)
Seat 5: bf4e2b6b ($21.9 in chips)
Seat 6: 2b56ac20 ($11.96 in chips)
Hero: posts small blind $0.02
9d70d038: posts big blind $0.05
*** HOLE CARDS ***
Dealt to 7a09703 
Dealt to Hero [Th Qh]
Dealt to 9d70d038 
Dealt to 170dea69 
Dealt to bf4e2b6b 
Dealt to 2b56ac20 
170dea69: folds
bf4e2b6b: folds
2b56ac20: folds
7a09703: folds
Hero: calls $0.03
9d70d038: checks
*** FLOP *** [4d Kc Qd]
Hero: checks
9d70d038: checks
*** TURN *** [4d Kc Qd] [Kd]
Hero: checks
9d70d038: checks
*** RIVER *** [4d Kc Qd Kd] [8s]
Hero: checks
9d70d038: checks
Hero: shows [Th Qh] (two pair, Kings and Queens)
9d70d038: shows [8d 9h] (two pair, Kings and Eights)
*** SHOWDOWN ***
Hero collected $0.1 from pot
*** SUMMARY ***
Total pot $0.1 | Rake $0 | Jackpot $0 | Bingo $0 | Fortune $0 | Tax $0
Board [4d Kc Qd Kd 8s]
Seat 1: 7a09703 (button) folded before Flop (didn't bet)
Seat 2: Hero (small blind) showed [Th Qh] and won ($0.1) with two pair, Kings and Queens
Seat 3: 9d70d038 (big blind) showed [8d 9h] and lost with two pair, Kings and Eights
Seat 4: 170dea69 folded before Flop (didn't bet)
Seat 5: bf4e2b6b folded before Flop (didn't bet)
Seat 6: 2b56ac20 folded before Flop (didn't bet)


Poker Hand #RC3795932134: Hold'em No Limit ($0.02/$0.05) - 2025/08/10 08:33:51
Table 'RushAndCash11067394' 6-max Seat #1 is the button
Seat 1: 98e1d0ba ($4.77 in chips)
Seat 2: ca103bdd ($4.81 in chips)
Seat 3: 662fd34 ($5.87 in chips)
Seat 4: e13d681e ($5.38 in chips)
Seat 5: 9e9f7171 ($12.05 in chips)
Seat 6: Hero ($8.74 in chips)
ca103bdd: posts small blind $0.02
662fd34: posts big blind $0.05
*** HOLE CARDS ***
Dealt to 98e1d0ba 
Dealt to ca103bdd 
Dealt to 662fd34 
Dealt to e13d681e 
Dealt to 9e9f7171 
Dealt to Hero [Kc Ks]
e13d681e: folds
9e9f7171: folds
Hero: raises $0.05 to $0.1
98e1d0ba: folds
ca103bdd: folds
662fd34: calls $0.05
*** FLOP *** [Qh 7h 9c]
662fd34: bets $0.11
Hero: raises $0.39 to $0.5
662fd34: folds
Uncalled bet ($0.39) returned to Hero
*** SHOWDOWN ***
Hero collected $0.42 from pot
*** SUMMARY ***
Total pot $0.44 | Rake $0.02 | Jackpot $0 | Bingo $0 | Fortune $0 | Tax $0
Board [Qh 7h 9c]
Seat 1: 98e1d0ba (button) folded before Flop (didn't bet)
Seat 2: ca103bdd (small blind) folded before Flop
Seat 3: 662fd34 (big blind) folded on the Flop
Seat 4: e13d681e folded before Flop (didn't bet)
Seat 5: 9e9f7171 folded before Flop (didn't bet)
Seat 6: Hero won ($0.42)


Poker Hand #RC3795931898: Hold'em No Limit ($0.02/$0.05) - 2025/08/10 08:32:40
Table 'RushAndCash11067158' 6-max Seat #1 is the button
Seat 1: e792c630 ($5 in chips)
Seat 2: fd4b11f ($5.78 in chips)
Seat 3: Hero ($8.24 in chips)
Seat 4: e39c6e6a ($10.21 in chips)
Seat 5: 902f8c64 ($6.44 in chips)
Seat 6: 196a508f ($12 in chips)
fd4b11f: posts small blind $0.02
Hero: posts big blind $0.05
*** HOLE CARDS ***
Dealt to e792c630 
Dealt to fd4b11f 
Dealt to Hero [3d Ad]
Dealt to e39c6e6a 
Dealt to 902f8c64 
Dealt to 196a508f 
e39c6e6a: folds
902f8c64: folds
196a508f: folds
e792c630: folds
fd4b11f: raises $0.08 to $0.13
Hero: calls $0.08
*** FLOP *** [7c As Qh]
fd4b11f: checks
Hero: checks
*** TURN *** [7c As Qh] [7d]
fd4b11f: bets $0.09
Hero: calls $0.09
*** RIVER *** [7c As Qh 7d] [8d]
fd4b11f: bets $0.33
Hero: calls $0.33
fd4b11f: shows [Qs Ks] (two pair, Queens and Sevens)
Hero: shows [3d Ad] (two pair, Aces and Sevens)
*** SHOWDOWN ***
Hero collected $1.05 from pot
*** SUMMARY ***
Total pot $1.1 | Rake $0.05 | Jackpot $0 | Bingo $0 | Fortune $0 | Tax $0
Board [7c As Qh 7d 8d]
Seat 1: e792c630 (button) folded before Flop (didn't bet)
Seat 2: fd4b11f (small blind) showed [Qs Ks] and lost with two pair, Queens and Sevens
Seat 3: Hero (big blind) showed [3d Ad] and won ($1.05) with two pair, Aces and Sevens
Seat 4: e39c6e6a folded before Flop (didn't bet)
Seat 5: 902f8c64 folded before Flop (didn't bet)
Seat 6: 196a508f folded before Flop (didn't bet)


Poker Hand #RC3795931885: Hold'em No Limit ($0.02/$0.05) - 2025/08/10 08:32:37
Table 'RushAndCash11067145' 6-max Seat #1 is the button
Seat 1: bd170b4b ($9.84 in chips)
Seat 2: b1c861b6 ($7.01 in chips)
Seat 3: 85ecd2b ($5.47 in chips)
Seat 4: 2c53d2c7 ($6.34 in chips)
Seat 5: Hero ($8.24 in chips)
Seat 6: ede202e3 ($2.43 in chips)
b1c861b6: posts small blind $0.02
85ecd2b: posts big blind $0.05
*** HOLE CARDS ***
Dealt to bd170b4b 
Dealt to b1c861b6 
Dealt to 85ecd2b 
Dealt to 2c53d2c7 
Dealt to Hero [4d 5c]
Dealt to ede202e3 
2c53d2c7: folds
Hero: folds
ede202e3: folds
bd170b4b: folds
b1c861b6: folds
Uncalled bet ($0.03) returned to 85ecd2b
*** SHOWDOWN ***
85ecd2b collected $0.04 from pot
*** SUMMARY ***
Total pot $0.04 | Rake $0 | Jackpot $0 | Bingo $0 | Fortune $0 | Tax $0
Seat 1: bd170b4b (button) folded before Flop (didn't bet)
Seat 2: b1c861b6 (small blind) folded before Flop
Seat 3: 85ecd2b (big blind) collected ($0.04)
Seat 4: 2c53d2c7 folded before Flop (didn't bet)
Seat 5: Hero folded before Flop (didn't bet)
Seat 6: ede202e3 folded before Flop (didn't bet)


Poker Hand #RC3795931860: Hold'em No Limit ($0.02/$0.05) - 2025/08/10 08:32:29
Table 'RushAndCash11067120' 6-max Seat #1 is the button
Seat 1: cbd251ea ($6.24 in chips)
Seat 2: Hero ($8.26 in chips)
Seat 3: 3817bfda ($22.63 in chips)
Seat 4: fdfc54bf ($14.1 in chips)
Seat 5: 949b5efc ($5 in chips)
Seat 6: f6fdd16d ($5.26 in chips)
Hero: posts small blind $0.02
3817bfda: posts big blind $0.05
*** HOLE CARDS ***
Dealt to cbd251ea 
Dealt to Hero [4h 7d]
Dealt to 3817bfda 
Dealt to fdfc54bf 
Dealt to 949b5efc 
Dealt to f6fdd16d 
fdfc54bf: folds
949b5efc: folds
f6fdd16d: folds
cbd251ea: folds
Hero: folds
Uncalled bet ($0.03) returned to 3817bfda
*** SHOWDOWN ***
3817bfda collected $0.04 from pot
*** SUMMARY ***
Total pot $0.04 | Rake $0 | Jackpot $0 | Bingo $0 | Fortune $0 | Tax $0
Seat 1: cbd251ea (button) folded before Flop (didn't bet)
Seat 2: Hero (small blind) folded before Flop
Seat 3: 3817bfda (big blind) collected ($0.04)
Seat 4: fdfc54bf folded before Flop (didn't bet)
Seat 5: 949b5efc folded before Flop (didn't bet)
Seat 6: f6fdd16d folded before Flop (didn't bet)


Poker Hand #RC3795931847: Hold'em No Limit ($0.02/$0.05) - 2025/08/10 08:32:25
Table 'RushAndCash11067107' 6-max Seat #1 is the button
Seat 1: 999a0f96 ($11.13 in chips)
Seat 2: efe6e02c ($5.05 in chips)
Seat 3: 884cadd0 ($5 in chips)
Seat 4: Hero ($8.26 in chips)
Seat 5: ddd082ae ($4.97 in chips)
Seat 6: fa76288b ($3.79 in chips)
efe6e02c: posts small blind $0.02
884cadd0: posts big blind $0.05
*** HOLE CARDS ***
Dealt to 999a0f96 
Dealt to efe6e02c 
Dealt to 884cadd0 
Dealt to Hero [Kc 7d]
Dealt to ddd082ae 
Dealt to fa76288b 
Hero: folds
ddd082ae: folds
fa76288b: raises $0.07 to $0.12
999a0f96: folds
efe6e02c: raises $0.36 to $0.48
884cadd0: folds
fa76288b: calls $0.36
*** FLOP *** [5h Qd Ts]
efe6e02c: bets $0.69
fa76288b: calls $0.69
*** TURN *** [5h Qd Ts] [Jc]
efe6e02c: bets $1.63
fa76288b: calls $1.63
*** RIVER *** [5h Qd Ts Jc] [Ac]
efe6e02c: bets $2.15
fa76288b: calls $0.99 and is all-in
Uncalled bet ($1.16) returned to efe6e02c
efe6e02c: shows [As Ks] (a straight, Ace to Ten)
fa76288b: shows [Qc Qs] (three of a kind, Queens)
*** SHOWDOWN ***
efe6e02c collected $7.41 from pot
*** SUMMARY ***
Total pot $7.63 | Rake $0.15 | Jackpot $0.07 | Bingo $0 | Fortune $0 | Tax $0
Board [5h Qd Ts Jc Ac]
Seat 1: 999a0f96 (button) folded before Flop (didn't bet)
Seat 2: efe6e02c (small blind) showed [As Ks] and won ($7.41) with a straight, Ace to Ten
Seat 3: 884cadd0 (big blind) folded before Flop
Seat 4: Hero folded before Flop (didn't bet)
Seat 5: ddd082ae folded before Flop (didn't bet)
Seat 6: fa76288b showed [Qc Qs] and lost with three of a kind, Queens


Poker Hand #RC3795931731: Hold'em No Limit ($0.02/$0.05) - 2025/08/10 08:31:48
Table 'RushAndCash11066991' 6-max Seat #1 is the button
Seat 1: afbe94ee ($5.77 in chips)
Seat 2: b527583c ($8.46 in chips)
Seat 3: Hero ($8.39 in chips)
Seat 4: 279a8e9f ($5.09 in chips)
Seat 5: 999a0f96 ($10.99 in chips)
Seat 6: 5e046aad ($5.11 in chips)
b527583c: posts small blind $0.02
Hero: posts big blind $0.05
*** HOLE CARDS ***
Dealt to afbe94ee 
Dealt to b527583c 
Dealt to Hero [Ts As]
Dealt to 279a8e9f 
Dealt to 999a0f96 
Dealt to 5e046aad 
279a8e9f: folds
999a0f96: raises $0.08 to $0.13
5e046aad: folds
afbe94ee: folds
b527583c: folds
Hero: calls $0.08
*** FLOP *** [Qh 6h 4c]
Hero: checks
999a0f96: bets $0.1
Hero: folds
Uncalled bet ($0.1) returned to 999a0f96
*** SHOWDOWN ***
999a0f96 collected $0.27 from pot
*** SUMMARY ***
Total pot $0.28 | Rake $0.01 | Jackpot $0 | Bingo $0 | Fortune $0 | Tax $0
Board [Qh 6h 4c]
Seat 1: afbe94ee (button) folded before Flop (didn't bet)
Seat 2: b527583c (small blind) folded before Flop
Seat 3: Hero (big blind) folded on the Flop
Seat 4: 279a8e9f folded before Flop (didn't bet)
Seat 5: 999a0f96 won ($0.27)
Seat 6: 5e046aad folded before Flop (didn't bet)


Poker Hand #RC3795931718: Hold'em No Limit ($0.02/$0.05) - 2025/08/10 08:31:45
Table 'RushAndCash11066978' 6-max Seat #1 is the button
Seat 1: ca103bdd ($5.1 in chips)
Seat 2: 9095f6a6 ($5 in chips)
Seat 3: 29035a3b ($5 in chips)
Seat 4: 999a0f96 ($10.99 in chips)
Seat 5: Hero ($8.39 in chips)
Seat 6: 6e6d6019 ($7.18 in chips)
9095f6a6: posts small blind $0.02
29035a3b: posts big blind $0.05
*** HOLE CARDS ***
Dealt to ca103bdd 
Dealt to 9095f6a6 
Dealt to 29035a3b 
Dealt to 999a0f96 
Dealt to Hero [6h 8c]
Dealt to 6e6d6019 
999a0f96: folds
Hero: folds
6e6d6019: folds
ca103bdd: folds
9095f6a6: folds
Uncalled bet ($0.03) returned to 29035a3b
*** SHOWDOWN ***
29035a3b collected $0.04 from pot
*** SUMMARY ***
Total pot $0.04 | Rake $0 | Jackpot $0 | Bingo $0 | Fortune $0 | Tax $0
Seat 1: ca103bdd (button) folded before Flop (didn't bet)
Seat 2: 9095f6a6 (small blind) folded before Flop
Seat 3: 29035a3b (big blind) collected ($0.04)
Seat 4: 999a0f96 folded before Flop (didn't bet)
Seat 5: Hero folded before Flop (didn't bet)
Seat 6: 6e6d6019 folded before Flop (didn't bet)


Poker Hand #RC3795931705: Hold'em No Limit ($0.02/$0.05) - 2025/08/10 08:31:41
Table 'RushAndCash11066965' 6-max Seat #1 is the button
Seat 1: Hero ($8.39 in chips)
Seat 2: 453d8970 ($4.95 in chips)
Seat 3: 68c48621 ($5.17 in chips)
Seat 4: 999a0f96 ($10.99 in chips)
Seat 5: 1eef3559 ($10.58 in chips)
Seat 6: 6369b6bc ($6.14 in chips)
453d8970: posts small blind $0.02
68c48621: posts big blind $0.05
*** HOLE CARDS ***
Dealt to Hero [2s 9h]
Dealt to 453d8970 
Dealt to 68c48621 
Dealt to 999a0f96 
Dealt to 1eef3559 
Dealt to 6369b6bc 
999a0f96: folds
1eef3559: folds
6369b6bc: folds
Hero: folds
453d8970: calls $0.03
68c48621: raises $0.15 to $0.2
453d8970: calls $0.15
*** FLOP *** [Qc 6s 7d]
453d8970: bets $0.2
68c48621: calls $0.2
*** TURN *** [Qc 6s 7d] [Kd]
453d8970: checks
68c48621: bets $0.27
453d8970: calls $0.27
*** RIVER *** [Qc 6s 7d Kd] [5c]
453d8970: bets $0.67
68c48621: calls $0.67
453d8970: shows [Ks 9s] (a pair of Kings)
68c48621: shows [Kh 6d] (two pair, Kings and Sixes)
*** SHOWDOWN ***
68c48621 collected $2.48 from pot
*** SUMMARY ***
Total pot $2.68 | Rake $0.13 | Jackpot $0.07 | Bingo $0 | Fortune $0 | Tax $0
Board [Qc 6s 7d Kd 5c]
Seat 1: Hero (button) folded before Flop (didn't bet)
Seat 2: 453d8970 (small blind) showed [Ks 9s] and lost with a pair of Kings
Seat 3: 68c48621 (big blind) showed [Kh 6d] and won ($2.48) with two pair, Kings and Sixes
Seat 4: 999a0f96 folded before Flop (didn't bet)
Seat 5: 1eef3559 folded before Flop (didn't bet)
Seat 6: 6369b6bc folded before Flop (didn't bet)


Poker Hand #RC3795931616: Hold'em No Limit ($0.02/$0.05) - 2025/08/10 08:31:15
Table 'RushAndCash11066876' 6-max Seat #1 is the button
Seat 1: 69bc96d4 ($5.63 in chips)
Seat 2: f0e15475 ($8.07 in chips)
Seat 3: f2e3feac ($11.09 in chips)
Seat 4: 8afb6429 ($7.5 in chips)
Seat 5: 29035a3b ($5 in chips)
Seat 6: Hero ($8.32 in chips)
f0e15475: posts small blind $0.02
f2e3feac: posts big blind $0.05
*** HOLE CARDS ***
Dealt to 69bc96d4 
Dealt to f0e15475 
Dealt to f2e3feac 
Dealt to 8afb6429 
Dealt to 29035a3b 
Dealt to Hero [Kc Tc]
8afb6429: folds
29035a3b: folds
Hero: raises $0.05 to $0.1
69bc96d4: folds
f0e15475: folds
f2e3feac: folds
Uncalled bet ($0.05) returned to Hero
*** SHOWDOWN ***
Hero collected $0.12 from pot
*** SUMMARY ***
Total pot $0.12 | Rake $0 | Jackpot $0 | Bingo $0 | Fortune $0 | Tax $0
Seat 1: 69bc96d4 (button) folded before Flop (didn't bet)
Seat 2: f0e15475 (small blind) folded before Flop
Seat 3: f2e3feac (big blind) folded before Flop
Seat 4: 8afb6429 folded before Flop (didn't bet)
Seat 5: 29035a3b folded before Flop (didn't bet)
Seat 6: Hero collected ($0.12)


Poker Hand #RC3795931605: Hold'em No Limit ($0.02/$0.05) - 2025/08/10 08:31:12
Table 'RushAndCash11066865' 6-max Seat #1 is the button
Seat 1: 84c84dd4 ($7.68 in chips)
Seat 2: 4bc03111 ($3.16 in chips)
Seat 3: b87e2d9d ($5.42 in chips)
Seat 4: 2b56ac20 ($12.05 in chips)
Seat 5: Hero ($8.32 in chips)
Seat 6: e90b1294 ($5 in chips)
4bc03111: posts small blind $0.02
b87e2d9d: posts big blind $0.05
*** HOLE CARDS ***
Dealt to 84c84dd4 
Dealt to 4bc03111 
Dealt to b87e2d9d 
Dealt to 2b56ac20 
Dealt to Hero [Qs 6c]
Dealt to e90b1294 
2b56ac20: folds
Hero: folds
e90b1294: raises $0.06 to $0.11
84c84dd4: folds
4bc03111: folds
b87e2d9d: folds
Uncalled bet ($0.06) returned to e90b1294
*** SHOWDOWN ***
e90b1294 collected $0.12 from pot
*** SUMMARY ***
Total pot $0.12 | Rake $0 | Jackpot $0 | Bingo $0 | Fortune $0 | Tax $0
Seat 1: 84c84dd4 (button) folded before Flop (didn't bet)
Seat 2: 4bc03111 (small blind) folded before Flop
Seat 3: b87e2d9d (big blind) folded before Flop
Seat 4: 2b56ac20 folded before Flop (didn't bet)
Seat 5: Hero folded before Flop (didn't bet)
Seat 6: e90b1294 collected ($0.12)


Poker Hand #RC3795931590: Hold'em No Limit ($0.02/$0.05) - 2025/08/10 08:31:07
Table 'RushAndCash11066850' 6-max Seat #1 is the button
Seat 1: 16283873 ($5.64 in chips)
Seat 2: 3f5c4b90 ($7.95 in chips)
Seat 3: 91579c91 ($5.04 in chips)
Seat 4: fd4f7f89 ($5.95 in chips)
Seat 5: Hero ($8.32 in chips)
Seat 6: 7a953fd0 ($6.44 in chips)
3f5c4b90: posts small blind $0.02
91579c91: posts big blind $0.05
*** HOLE CARDS ***
Dealt to 16283873 
Dealt to 3f5c4b90 
Dealt to 91579c91 
Dealt to fd4f7f89 
Dealt to Hero [Th 7s]
Dealt to 7a953fd0 
fd4f7f89: raises $0.05 to $0.1
Hero: folds
7a953fd0: folds
16283873: folds
3f5c4b90: folds
91579c91: calls $0.05
*** FLOP *** [Ts 3c 5d]
91579c91: checks
fd4f7f89: checks
*** TURN *** [Ts 3c 5d] [Js]
91579c91: checks
fd4f7f89: checks
*** RIVER *** [Ts 3c 5d Js] [2c]
91579c91: bets $0.19
fd4f7f89: calls $0.19
91579c91: shows [As Jh] (a pair of Jacks)
fd4f7f89: shows [Td Ad] (a pair of Tens)
*** SHOWDOWN ***
91579c91 collected $0.57 from pot
*** SUMMARY ***
Total pot $0.6 | Rake $0.03 | Jackpot $0 | Bingo $0 | Fortune $0 | Tax $0
Board [Ts 3c 5d Js 2c]
Seat 1: 16283873 (button) folded before Flop (didn't bet)
Seat 2: 3f5c4b90 (small blind) folded before Flop
Seat 3: 91579c91 (big blind) showed [As Jh] and won ($0.57) with a pair of Jacks
Seat 4: fd4f7f89 showed [Td Ad] and lost with a pair of Tens
Seat 5: Hero folded before Flop (didn't bet)
Seat 6: 7a953fd0 folded before Flop (didn't bet)


Poker Hand #RC3795931509: Hold'em No Limit ($0.02/$0.05) - 2025/08/10 08:30:45
Table 'RushAndCash11066769' 6-max Seat #1 is the button
Seat 1: 63124400 ($14.07 in chips)
Seat 2: 8b390e1e ($5 in chips)
Seat 3: Hero ($8.37 in chips)
Seat 4: 67671ee6 ($5.02 in chips)
Seat 5: 22b1f4df ($10.42 in chips)
Seat 6: 7d1f43e4 ($6.82 in chips)
8b390e1e: posts small blind $0.02
Hero: posts big blind $0.05
*** HOLE CARDS ***
Dealt to 63124400 
Dealt to 8b390e1e 
Dealt to Hero [7d Kh]
Dealt to 67671ee6 
Dealt to 22b1f4df 
Dealt to 7d1f43e4 
67671ee6: folds
22b1f4df: folds
7d1f43e4: folds
63124400: raises $0.08 to $0.13
8b390e1e: raises $0.34 to $0.47
Hero: folds
63124400: folds
Uncalled bet ($0.34) returned to 8b390e1e
*** SHOWDOWN ***
8b390e1e collected $0.3 from pot
*** SUMMARY ***
Total pot $0.31 | Rake $0.01 | Jackpot $0 | Bingo $0 | Fortune $0 | Tax $0
Seat 1: 63124400 (button) folded before Flop
Seat 2: 8b390e1e (small blind) collected ($0.3)
Seat 3: Hero (big blind) folded before Flop
Seat 4: 67671ee6 folded before Flop (didn't bet)
Seat 5: 22b1f4df folded before Flop (didn't bet)
Seat 6: 7d1f43e4 folded before Flop (didn't bet)


Poker Hand #RC3795931486: Hold'em No Limit ($0.02/$0.05) - 2025/08/10 08:30:38
Table 'RushAndCash11066746' 6-max Seat #1 is the button
Seat 1: bbe9b1b1 ($5.04 in chips)
Seat 2: Hero ($8.39 in chips)
Seat 3: 902f8c64 ($5.07 in chips)
Seat 4: 3a68afa9 ($5.43 in chips)
Seat 5: 6a3842ba ($6.91 in chips)
Seat 6: 97f832bf ($12.91 in chips)
Hero: posts small blind $0.02
902f8c64: posts big blind $0.05
*** HOLE CARDS ***
Dealt to bbe9b1b1 
Dealt to Hero [2h 4c]
Dealt to 902f8c64 
Dealt to 3a68afa9 
Dealt to 6a3842ba 
Dealt to 97f832bf 
3a68afa9: folds
6a3842ba: raises $0.05 to $0.1
97f832bf: folds
bbe9b1b1: folds
Hero: folds
902f8c64: folds
Uncalled bet ($0.05) returned to 6a3842ba
*** SHOWDOWN ***
6a3842ba collected $0.12 from pot
*** SUMMARY ***
Total pot $0.12 | Rake $0 | Jackpot $0 | Bingo $0 | Fortune $0 | Tax $0
Seat 1: bbe9b1b1 (button) folded before Flop (didn't bet)
Seat 2: Hero (small blind) folded before Flop
Seat 3: 902f8c64 (big blind) folded before Flop
Seat 4: 3a68afa9 folded before Flop (didn't bet)
Seat 5: 6a3842ba collected ($0.12)
Seat 6: 97f832bf folded before Flop (didn't bet)


Poker Hand #RC3795931433: Hold'em No Limit ($0.02/$0.05) - 2025/08/10 08:30:22
Table 'RushAndCash11066693' 6-max Seat #1 is the button
Seat 1: 8a484f1f ($5 in chips)
Seat 2: b527583c ($8.75 in chips)
Seat 3: 848c5954 ($6.13 in chips)
Seat 4: 8d67d790 ($10.97 in chips)
Seat 5: Hero ($8.32 in chips)
Seat 6: 6a3842ba ($6.84 in chips)
b527583c: posts small blind $0.02
848c5954: posts big blind $0.05
*** HOLE CARDS ***
Dealt to 8a484f1f 
Dealt to b527583c 
Dealt to 848c5954 
Dealt to 8d67d790 
Dealt to Hero [Ks Qh]
Dealt to 6a3842ba 
8d67d790: folds
Hero: raises $0.05 to $0.1
6a3842ba: folds
8a484f1f: folds
b527583c: folds
848c5954: folds
Uncalled bet ($0.05) returned to Hero
*** SHOWDOWN ***
Hero collected $0.12 from pot
*** SUMMARY ***
Total pot $0.12 | Rake $0 | Jackpot $0 | Bingo $0 | Fortune $0 | Tax $0
Seat 1: 8a484f1f (button) folded before Flop (didn't bet)
Seat 2: b527583c (small blind) folded before Flop
Seat 3: 848c5954 (big blind) folded before Flop
Seat 4: 8d67d790 folded before Flop (didn't bet)
Seat 5: Hero collected ($0.12)
Seat 6: 6a3842ba folded before Flop (didn't bet)


Poker Hand #RC3795931419: Hold'em No Limit ($0.02/$0.05) - 2025/08/10 08:30:19
Table 'RushAndCash11066679' 6-max Seat #1 is the button
Seat 1: Hero ($8.32 in chips)
Seat 2: 85ecd2b ($5.02 in chips)
Seat 3: d8b9a478 ($5.57 in chips)
Seat 4: f0e15475 ($8.21 in chips)
Seat 5: 4a025b26 ($5.07 in chips)
Seat 6: b527583c ($8.75 in chips)
85ecd2b: posts small blind $0.02
d8b9a478: posts big blind $0.05
*** HOLE CARDS ***
Dealt to Hero [Kd 9s]
Dealt to 85ecd2b 
Dealt to d8b9a478 
Dealt to f0e15475 
Dealt to 4a025b26 
Dealt to b527583c 
f0e15475: folds
4a025b26: folds
b527583c: folds
Hero: folds
85ecd2b: raises $0.1 to $0.15
d8b9a478: folds
Uncalled bet ($0.1) returned to 85ecd2b
*** SHOWDOWN ***
85ecd2b collected $0.1 from pot
*** SUMMARY ***
Total pot $0.1 | Rake $0 | Jackpot $0 | Bingo $0 | Fortune $0 | Tax $0
Seat 1: Hero (button) folded before Flop (didn't bet)
Seat 2: 85ecd2b (small blind) collected ($0.1)
Seat 3: d8b9a478 (big blind) folded before Flop
Seat 4: f0e15475 folded before Flop (didn't bet)
Seat 5: 4a025b26 folded before Flop (didn't bet)
Seat 6: b527583c folded before Flop (didn't bet)


Poker Hand #RC3795931406: Hold'em No Limit ($0.02/$0.05) - 2025/08/10 08:30:15
Table 'RushAndCash11066666' 6-max Seat #1 is the button
Seat 1: d8b9a478 ($5.57 in chips)
Seat 2: 18b1ecd7 ($4.83 in chips)
Seat 3: 8afb6429 ($7.58 in chips)
Seat 4: Hero ($8.32 in chips)
Seat 5: f76279b5 ($13.71 in chips)
Seat 6: 9ae53275 ($5.66 in chips)
18b1ecd7: posts small blind $0.02
8afb6429: posts big blind $0.05
*** HOLE CARDS ***
Dealt to d8b9a478 
Dealt to 18b1ecd7 
Dealt to 8afb6429 
Dealt to Hero [Qs 7c]
Dealt to f76279b5 
Dealt to 9ae53275 
Hero: folds
f76279b5: folds
9ae53275: folds
d8b9a478: folds
18b1ecd7: folds
Uncalled bet ($0.03) returned to 8afb6429
*** SHOWDOWN ***
8afb6429 collected $0.04 from pot
*** SUMMARY ***
Total pot $0.04 | Rake $0 | Jackpot $0 | Bingo $0 | Fortune $0 | Tax $0
Seat 1: d8b9a478 (button) folded before Flop (didn't bet)
Seat 2: 18b1ecd7 (small blind) folded before Flop
Seat 3: 8afb6429 (big blind) collected ($0.04)
Seat 4: Hero folded before Flop (didn't bet)
Seat 5: f76279b5 folded before Flop (didn't bet)
Seat 6: 9ae53275 folded before Flop (didn't bet)


Poker Hand #RC3795931373: Hold'em No Limit ($0.02/$0.05) - 2025/08/10 08:30:06
Table 'RushAndCash11066633' 6-max Seat #1 is the button
Seat 1: f0e15475 ($8.21 in chips)
Seat 2: 8b390e1e ($5 in chips)
Seat 3: 85ecd2b ($5 in chips)
Seat 4: f38b69c2 ($5 in chips)
Seat 5: 5fc6009a ($5.52 in chips)
Seat 6: Hero ($8.32 in chips)
8b390e1e: posts small blind $0.02
85ecd2b: posts big blind $0.05
*** HOLE CARDS ***
Dealt to f0e15475 
Dealt to 8b390e1e 
Dealt to 85ecd2b 
Dealt to f38b69c2 
Dealt to 5fc6009a 
Dealt to Hero [8d Qd]
f38b69c2: folds
5fc6009a: folds
Hero: folds
f0e15475: folds
8b390e1e: folds
Uncalled bet ($0.03) returned to 85ecd2b
*** SHOWDOWN ***
85ecd2b collected $0.04 from pot
*** SUMMARY ***
Total pot $0.04 | Rake $0 | Jackpot $0 | Bingo $0 | Fortune $0 | Tax $0
Seat 1: f0e15475 (button) folded before Flop (didn't bet)
Seat 2: 8b390e1e (small blind) folded before Flop
Seat 3: 85ecd2b (big blind) collected ($0.04)
Seat 4: f38b69c2 folded before Flop (didn't bet)
Seat 5: 5fc6009a folded before Flop (didn't bet)
Seat 6: Hero folded before Flop (didn't bet)


Poker Hand #RC3795931334: Hold'em No Limit ($0.02/$0.05) - 2025/08/10 08:29:56
Table 'RushAndCash11066594' 6-max Seat #1 is the button
Seat 1: e59624ff ($4.21 in chips)
Seat 2: 5fc6009a ($5.59 in chips)
Seat 3: Hero ($8.37 in chips)
Seat 4: a1651cdc ($8.17 in chips)
Seat 5: 279a8e9f ($5.12 in chips)
Seat 6: 12269029 ($5.7 in chips)
5fc6009a: posts small blind $0.02
Hero: posts big blind $0.05
*** HOLE CARDS ***
Dealt to e59624ff 
Dealt to 5fc6009a 
Dealt to Hero [4h As]
Dealt to a1651cdc 
Dealt to 279a8e9f 
Dealt to 12269029 
a1651cdc: folds
279a8e9f: raises $0.05 to $0.1
12269029: folds
e59624ff: calls $0.1
5fc6009a: folds
Hero: folds
*** FLOP *** [8d Js Kd]
279a8e9f: bets $0.14
e59624ff: folds
Uncalled bet ($0.14) returned to 279a8e9f
*** SHOWDOWN ***
279a8e9f collected $0.26 from pot
*** SUMMARY ***
Total pot $0.27 | Rake $0.01 | Jackpot $0 | Bingo $0 | Fortune $0 | Tax $0
Board [8d Js Kd]
Seat 1: e59624ff (button) folded on the Flop
Seat 2: 5fc6009a (small blind) folded before Flop
Seat 3: Hero (big blind) folded before Flop
Seat 4: a1651cdc folded before Flop (didn't bet)
Seat 5: 279a8e9f won ($0.26)
Seat 6: 12269029 folded before Flop (didn't bet)


Poker Hand #RC3795931322: Hold'em No Limit ($0.02/$0.05) - 2025/08/10 08:29:52
Table 'RushAndCash11066582' 6-max Seat #1 is the button
Seat 1: bbe9b1b1 ($5.11 in chips)
Seat 2: cd7dffc4 ($5.06 in chips)
Seat 3: fc8d15be ($4.91 in chips)
Seat 4: d62070dc ($8.2 in chips)
Seat 5: Hero ($8.37 in chips)
Seat 6: a187372 ($7.21 in chips)
cd7dffc4: posts small blind $0.02
fc8d15be: posts big blind $0.05
*** HOLE CARDS ***
Dealt to bbe9b1b1 
Dealt to cd7dffc4 
Dealt to fc8d15be 
Dealt to d62070dc 
Dealt to Hero [2s Jh]
Dealt to a187372 
d62070dc: raises $0.05 to $0.1
Hero: folds
a187372: folds
bbe9b1b1: folds
cd7dffc4: folds
fc8d15be: folds
Uncalled bet ($0.05) returned to d62070dc
*** SHOWDOWN ***
d62070dc collected $0.12 from pot
*** SUMMARY ***
Total pot $0.12 | Rake $0 | Jackpot $0 | Bingo $0 | Fortune $0 | Tax $0
Seat 1: bbe9b1b1 (button) folded before Flop (didn't bet)
Seat 2: cd7dffc4 (small blind) folded before Flop
Seat 3: fc8d15be (big blind) folded before Flop
Seat 4: d62070dc collected ($0.12)
Seat 5: Hero folded before Flop (didn't bet)
Seat 6: a187372 folded before Flop (didn't bet)


Poker Hand #RC3795931268: Hold'em No Limit ($0.02/$0.05) - 2025/08/10 08:29:36
Table 'RushAndCash11066528' 6-max Seat #1 is the button
Seat 1: f0e15475 ($8.31 in chips)
Seat 2: Hero ($8.32 in chips)
Seat 3: 2b5a7a1b ($10.83 in chips)
Seat 4: 5b54e251 ($12.08 in chips)
Seat 5: 481a7d6 ($5.19 in chips)
Seat 6: fc8d15be ($4.91 in chips)
Hero: posts small blind $0.02
2b5a7a1b: posts big blind $0.05
*** HOLE CARDS ***
Dealt to f0e15475 
Dealt to Hero [Kc Ac]
Dealt to 2b5a7a1b 
Dealt to 5b54e251 
Dealt to 481a7d6 
Dealt to fc8d15be 
5b54e251: folds
481a7d6: folds
fc8d15be: folds
f0e15475: folds
Hero: raises $0.1 to $0.15
2b5a7a1b: folds
Uncalled bet ($0.1) returned to Hero
*** SHOWDOWN ***
Hero collected $0.1 from pot
*** SUMMARY ***
Total pot $0.1 | Rake $0 | Jackpot $0 | Bingo $0 | Fortune $0 | Tax $0
Seat 1: f0e15475 (button) folded before Flop (didn't bet)
Seat 2: Hero (small blind) collected ($0.1)
Seat 3: 2b5a7a1b (big blind) folded before Flop
Seat 4: 5b54e251 folded before Flop (didn't bet)
Seat 5: 481a7d6 folded before Flop (didn't bet)
Seat 6: fc8d15be folded before Flop (didn't bet)


Poker Hand #RC3795931095: Hold'em No Limit ($0.02/$0.05) - 2025/08/10 08:28:48
Table 'RushAndCash11066355' 6-max Seat #1 is the button
Seat 1: 5b54e251 ($11.92 in chips)
Seat 2: fa76288b ($4.3 in chips)
Seat 3: b00a0b81 ($7.89 in chips)
Seat 4: 54cd1b65 ($14.71 in chips)
Seat 5: 42c31e1a ($12.47 in chips)
Seat 6: Hero ($8.42 in chips)
fa76288b: posts small blind $0.02
b00a0b81: posts big blind $0.05
*** HOLE CARDS ***
Dealt to 5b54e251 
Dealt to fa76288b 
Dealt to b00a0b81 
Dealt to 54cd1b65 
Dealt to 42c31e1a 
Dealt to Hero [As 5c]
54cd1b65: folds
42c31e1a: folds
Hero: raises $0.05 to $0.1
5b54e251: raises $0.21 to $0.31
fa76288b: folds
b00a0b81: folds
Hero: folds
Uncalled bet ($0.21) returned to 5b54e251
*** SHOWDOWN ***
5b54e251 collected $0.26 from pot
*** SUMMARY ***
Total pot $0.27 | Rake $0.01 | Jackpot $0 | Bingo $0 | Fortune $0 | Tax $0
Seat 1: 5b54e251 (button) collected ($0.26)
Seat 2: fa76288b (small blind) folded before Flop
Seat 3: b00a0b81 (big blind) folded before Flop
Seat 4: 54cd1b65 folded before Flop (didn't bet)
Seat 5: 42c31e1a folded before Flop (didn't bet)
Seat 6: Hero folded before Flop


Poker Hand #RC3795931037: Hold'em No Limit ($0.02/$0.05) - 2025/08/10 08:28:34
Table 'RushAndCash11066297' 6-max Seat #1 is the button
Seat 1: Hero ($8.42 in chips)
Seat 2: 5fc6009a ($5.45 in chips)
Seat 3: 6780a6cb ($5 in chips)
Seat 4: 4844e57f ($8.77 in chips)
Seat 5: fa76288b ($4.35 in chips)
Seat 6: b3cc8379 ($5.01 in chips)
5fc6009a: posts small blind $0.02
6780a6cb: posts big blind $0.05
*** HOLE CARDS ***
Dealt to Hero [Qs 8s]
Dealt to 5fc6009a 
Dealt to 6780a6cb 
Dealt to 4844e57f 
Dealt to fa76288b 
Dealt to b3cc8379 
4844e57f: raises $0.05 to $0.1
fa76288b: folds
b3cc8379: folds
Hero: folds
5fc6009a: folds
6780a6cb: calls $0.05
*** FLOP *** [Ah 4s Ad]
6780a6cb: checks
4844e57f: bets $0.08
6780a6cb: calls $0.08
*** TURN *** [Ah 4s Ad] [8d]
6780a6cb: checks
4844e57f: bets $0.15
6780a6cb: folds
Uncalled bet ($0.15) returned to 4844e57f
*** SHOWDOWN ***
4844e57f collected $0.37 from pot
*** SUMMARY ***
Total pot $0.38 | Rake $0.01 | Jackpot $0 | Bingo $0 | Fortune $0 | Tax $0
Board [Ah 4s Ad 8d]
Seat 1: Hero (button) folded before Flop (didn't bet)
Seat 2: 5fc6009a (small blind) folded before Flop
Seat 3: 6780a6cb (big blind) folded on the Turn
Seat 4: 4844e57f won ($0.37)
Seat 5: fa76288b folded before Flop (didn't bet)
Seat 6: b3cc8379 folded before Flop (didn't bet)


Poker Hand #RC3795930798: Hold'em No Limit ($0.02/$0.05) - 2025/08/10 08:27:26
Table 'RushAndCash11066058' 6-max Seat #1 is the button
Seat 1: Hero ($7.52 in chips)
Seat 2: 6780a6cb ($5 in chips)
Seat 3: 902f8c64 ($5 in chips)
Seat 4: 6412bd28 ($4.72 in chips)
Seat 5: f6bf8dfb ($11.55 in chips)
Seat 6: 339cbf14 ($4.9 in chips)
6780a6cb: posts small blind $0.02
902f8c64: posts big blind $0.05
*** HOLE CARDS ***
Dealt to Hero [As 3s]
Dealt to 6780a6cb 
Dealt to 902f8c64 
Dealt to 6412bd28 
Dealt to f6bf8dfb 
Dealt to 339cbf14 
6412bd28: folds
f6bf8dfb: folds
339cbf14: folds
Hero: raises $0.07 to $0.12
6780a6cb: raises $0.48 to $0.6
902f8c64: folds
Hero: calls $0.48
*** FLOP *** [4d 8s 6c]
6780a6cb: bets $0.42
Hero: calls $0.42
*** TURN *** [4d 8s 6c] [4c]
6780a6cb: checks
Hero: bets $1.26
6780a6cb: folds
Uncalled bet ($1.26) returned to Hero
*** SHOWDOWN ***
Hero collected $1.92 from pot
*** SUMMARY ***
Total pot $2.09 | Rake $0.1 | Jackpot $0.07 | Bingo $0 | Fortune $0 | Tax $0
Board [4d 8s 6c 4c]
Seat 1: Hero (button) won ($1.92)
Seat 2: 6780a6cb (small blind) folded on the Turn
Seat 3: 902f8c64 (big blind) folded before Flop
Seat 4: 6412bd28 folded before Flop (didn't bet)
Seat 5: f6bf8dfb folded before Flop (didn't bet)
Seat 6: 339cbf14 folded before Flop (didn't bet)


Poker Hand #RC3795930697: Hold'em No Limit ($0.02/$0.05) - 2025/08/10 08:26:58
Table 'RushAndCash11065957' 6-max Seat #1 is the button
Seat 1: cbd251ea ($5.77 in chips)
Seat 2: b2532ba1 ($6.98 in chips)
Seat 3: Hero ($7.57 in chips)
Seat 4: f6bf8dfb ($11.62 in chips)
Seat 5: 6780a6cb ($5 in chips)
Seat 6: fc8d15be ($4.93 in chips)
b2532ba1: posts small blind $0.02
Hero: posts big blind $0.05
*** HOLE CARDS ***
Dealt to cbd251ea 
Dealt to b2532ba1 
Dealt to Hero [2s 9c]
Dealt to f6bf8dfb 
Dealt to 6780a6cb 
Dealt to fc8d15be 
f6bf8dfb: folds
6780a6cb: raises $0.05 to $0.1
fc8d15be: calls $0.1
cbd251ea: raises $0.28 to $0.38
b2532ba1: folds
Hero: folds
6780a6cb: folds
fc8d15be: calls $0.28
*** FLOP *** [Ah Ts 9s]
fc8d15be: checks
cbd251ea: bets $0.31
fc8d15be: folds
Uncalled bet ($0.31) returned to cbd251ea
*** SHOWDOWN ***
cbd251ea collected $0.89 from pot
*** SUMMARY ***
Total pot $0.93 | Rake $0.04 | Jackpot $0 | Bingo $0 | Fortune $0 | Tax $0
Board [Ah Ts 9s]
Seat 1: cbd251ea (button) won ($0.89)
Seat 2: b2532ba1 (small blind) folded before Flop
Seat 3: Hero (big blind) folded before Flop
Seat 4: f6bf8dfb folded before Flop (didn't bet)
Seat 5: 6780a6cb folded before Flop
Seat 6: fc8d15be folded on the Flop


Poker Hand #RC3795930653: Hold'em No Limit ($0.02/$0.05) - 2025/08/10 08:26:46
Table 'RushAndCash11065913' 6-max Seat #1 is the button
Seat 1: 97f832bf ($10.83 in chips)
Seat 2: Hero ($7.59 in chips)
Seat 3: ac25def9 ($5 in chips)
Seat 4: f2e3feac ($9.86 in chips)
Seat 5: e39c6e6a ($5.1 in chips)
Seat 6: b527583c ($9.24 in chips)
Hero: posts small blind $0.02
ac25def9: posts big blind $0.05
*** HOLE CARDS ***
Dealt to 97f832bf 
Dealt to Hero [Qs 8h]
Dealt to ac25def9 
Dealt to f2e3feac 
Dealt to e39c6e6a 
Dealt to b527583c 
f2e3feac: folds
e39c6e6a: folds
b527583c: raises $0.05 to $0.1
97f832bf: raises $0.41 to $0.51
Hero: folds
ac25def9: folds
b527583c: folds
Uncalled bet ($0.41) returned to 97f832bf
*** SHOWDOWN ***
97f832bf collected $0.26 from pot
*** SUMMARY ***
Total pot $0.27 | Rake $0.01 | Jackpot $0 | Bingo $0 | Fortune $0 | Tax $0
Seat 1: 97f832bf (button) collected ($0.26)
Seat 2: Hero (small blind) folded before Flop
Seat 3: ac25def9 (big blind) folded before Flop
Seat 4: f2e3feac folded before Flop (didn't bet)
Seat 5: e39c6e6a folded before Flop (didn't bet)
Seat 6: b527583c folded before Flop


Poker Hand #RC3795930579: Hold'em No Limit ($0.02/$0.05) - 2025/08/10 08:26:27
Table 'RushAndCash11065839' 6-max Seat #1 is the button
Seat 1: 12269029 ($5.37 in chips)
Seat 2: e5d47869 ($7.47 in chips)
Seat 3: 70a7a795 ($4 in chips)
Seat 4: 8afb6429 ($6.77 in chips)
Seat 5: Hero ($7.59 in chips)
Seat 6: 949b5efc ($5.07 in chips)
e5d47869: posts small blind $0.02
70a7a795: posts big blind $0.05
*** HOLE CARDS ***
Dealt to 12269029 
Dealt to e5d47869 
Dealt to 70a7a795 
Dealt to 8afb6429 
Dealt to Hero [Jd 6s]
Dealt to 949b5efc 
8afb6429: raises $0.05 to $0.1
Hero: folds
949b5efc: folds
12269029: folds
e5d47869: folds
70a7a795: calls $0.05
*** FLOP *** [7d 7h 9s]
70a7a795: checks
8afb6429: checks
*** TURN *** [7d 7h 9s] [4c]
70a7a795: bets $0.17
8afb6429: folds
Uncalled bet ($0.17) returned to 70a7a795
*** SHOWDOWN ***
70a7a795 collected $0.21 from pot
*** SUMMARY ***
Total pot $0.22 | Rake $0.01 | Jackpot $0 | Bingo $0 | Fortune $0 | Tax $0
Board [7d 7h 9s 4c]
Seat 1: 12269029 (button) folded before Flop (didn't bet)
Seat 2: e5d47869 (small blind) folded before Flop
Seat 3: 70a7a795 (big blind) won ($0.21)
Seat 4: 8afb6429 folded on the Turn
Seat 5: Hero folded before Flop (didn't bet)
Seat 6: 949b5efc folded before Flop (didn't bet)


Poker Hand #RC3795930568: Hold'em No Limit ($0.02/$0.05) - 2025/08/10 08:26:24
Table 'RushAndCash11065828' 6-max Seat #1 is the button
Seat 1: bbb8a565 ($5.44 in chips)
Seat 2: 9ae53275 ($5 in chips)
Seat 3: 8e04bbd3 ($5.89 in chips)
Seat 4: Hero ($7.59 in chips)
Seat 5: d5bb3acb ($9.15 in chips)
Seat 6: 949b5efc ($5 in chips)
9ae53275: posts small blind $0.02
8e04bbd3: posts big blind $0.05
*** HOLE CARDS ***
Dealt to bbb8a565 
Dealt to 9ae53275 
Dealt to 8e04bbd3 
Dealt to Hero [6d Jd]
Dealt to d5bb3acb 
Dealt to 949b5efc 
Hero: folds
d5bb3acb: folds
949b5efc: folds
bbb8a565: folds
9ae53275: folds
Uncalled bet ($0.03) returned to 8e04bbd3
*** SHOWDOWN ***
8e04bbd3 collected $0.04 from pot
*** SUMMARY ***
Total pot $0.04 | Rake $0 | Jackpot $0 | Bingo $0 | Fortune $0 | Tax $0
Seat 1: bbb8a565 (button) folded before Flop (didn't bet)
Seat 2: 9ae53275 (small blind) folded before Flop
Seat 3: 8e04bbd3 (big blind) collected ($0.04)
Seat 4: Hero folded before Flop (didn't bet)
Seat 5: d5bb3acb folded before Flop (didn't bet)
Seat 6: 949b5efc folded before Flop (didn't bet)


Poker Hand #RC3795930554: Hold'em No Limit ($0.02/$0.05) - 2025/08/10 08:26:20
Table 'RushAndCash11065814' 6-max Seat #1 is the button
Seat 1: 170dea69 ($5 in chips)
Seat 2: f76279b5 ($14.24 in chips)
Seat 3: bc8475a8 ($7.66 in chips)
Seat 4: 8d1c252c ($5.77 in chips)
Seat 5: 43ab8974 ($6.96 in chips)
Seat 6: Hero ($7.59 in chips)
f76279b5: posts small blind $0.02
bc8475a8: posts big blind $0.05
*** HOLE CARDS ***
Dealt to 170dea69 
Dealt to f76279b5 
Dealt to bc8475a8 
Dealt to 8d1c252c 
Dealt to 43ab8974 
Dealt to Hero [6s 2h]
8d1c252c: folds
43ab8974: folds
Hero: folds
170dea69: folds
f76279b5: folds
Uncalled bet ($0.03) returned to bc8475a8
*** SHOWDOWN ***
bc8475a8 collected $0.04 from pot
*** SUMMARY ***
Total pot $0.04 | Rake $0 | Jackpot $0 | Bingo $0 | Fortune $0 | Tax $0
Seat 1: 170dea69 (button) folded before Flop (didn't bet)
Seat 2: f76279b5 (small blind) folded before Flop
Seat 3: bc8475a8 (big blind) collected ($0.04)
Seat 4: 8d1c252c folded before Flop (didn't bet)
Seat 5: 43ab8974 folded before Flop (didn't bet)
Seat 6: Hero folded before Flop (didn't bet)


Poker Hand #RC3795930373: Hold'em No Limit ($0.02/$0.05) - 2025/08/10 08:25:31
Table 'RushAndCash11065633' 6-max Seat #1 is the button
Seat 1: Hero ($7.74 in chips)
Seat 2: 7d1f43e4 ($10.06 in chips)
Seat 3: 43ab8974 ($6.8 in chips)
Seat 4: d4249213 ($7.1 in chips)
Seat 5: c70d3b17 ($9.82 in chips)
Seat 6: 5e046aad ($5.03 in chips)
7d1f43e4: posts small blind $0.02
43ab8974: posts big blind $0.05
*** HOLE CARDS ***
Dealt to Hero [5s Ah]
Dealt to 7d1f43e4 
Dealt to 43ab8974 
Dealt to d4249213 
Dealt to c70d3b17 
Dealt to 5e046aad 
d4249213: folds
c70d3b17: folds
5e046aad: folds
Hero: raises $0.1 to $0.15
7d1f43e4: folds
43ab8974: calls $0.1
*** FLOP *** [Jd Td 2s]
43ab8974: checks
Hero: checks
*** TURN *** [Jd Td 2s] [2c]
43ab8974: checks
Hero: checks
*** RIVER *** [Jd Td 2s 2c] [5d]
43ab8974: checks
Hero: checks
43ab8974: shows [2d Qd] (a flush Queen high)
Hero: shows [5s Ah] (two pair, Fives and Twos)
*** SHOWDOWN ***
43ab8974 collected $0.31 from pot
*** SUMMARY ***
Total pot $0.32 | Rake $0.01 | Jackpot $0 | Bingo $0 | Fortune $0 | Tax $0
Board [Jd Td 2s 2c 5d]
Seat 1: Hero (button) showed [5s Ah] and lost with two pair, Fives and Twos
Seat 2: 7d1f43e4 (small blind) folded before Flop
Seat 3: 43ab8974 (big blind) showed [2d Qd] and won ($0.31) with a flush Queen high
Seat 4: d4249213 folded before Flop (didn't bet)
Seat 5: c70d3b17 folded before Flop (didn't bet)
Seat 6: 5e046aad folded before Flop (didn't bet)


Poker Hand #RC3795930305: Hold'em No Limit ($0.02/$0.05) - 2025/08/10 08:25:15
Table 'RushAndCash11065565' 6-max Seat #1 is the button
Seat 1: 1af7528e ($5.62 in chips)
Seat 2: 52c49e29 ($12.27 in chips)
Seat 3: Hero ($7.79 in chips)
Seat 4: 483f17c3 ($16.13 in chips)
Seat 5: 70a7a795 ($4.79 in chips)
Seat 6: 79f65393 ($4.78 in chips)
52c49e29: posts small blind $0.02
Hero: posts big blind $0.05
*** HOLE CARDS ***
Dealt to 1af7528e 
Dealt to 52c49e29 
Dealt to Hero [5h Ac]
Dealt to 483f17c3 
Dealt to 70a7a795 
Dealt to 79f65393 
483f17c3: folds
70a7a795: folds
79f65393: raises $0.05 to $0.1
1af7528e: raises $0.26 to $0.36
52c49e29: folds
Hero: folds
79f65393: raises $0.64 to $1
1af7528e: calls $0.64
*** FIRST FLOP *** [9c Qd Ad]
79f65393: bets $0.65
1af7528e: calls $0.65
*** FIRST TURN *** [9c Qd Ad] [Jd]
79f65393: checks
1af7528e: bets $3.97 and is all-in
79f65393: calls $3.13 and is all-in
Uncalled bet ($0.84) returned to 1af7528e
1af7528e: shows [Qc Ah] (two pair, Aces and Queens)
79f65393: shows [Ks Kd] (a pair of Kings)
*** FIRST RIVER *** [9c Qd Ad Jd] [7c]
*** SECOND RIVER *** [9c Qd Ad Jd] [2h]
*** FIRST SHOWDOWN ***
1af7528e collected $4.71 from pot
*** SECOND SHOWDOWN ***
1af7528e collected $4.71 from pot
*** SUMMARY ***
Total pot $9.63 | Rake $0.14 | Jackpot $0.07 | Bingo $0 | Fortune $0 | Tax $0
Hand was run two times
FIRST Board [9c Qd Ad Jd 7c]
SECOND Board [2h]
Seat 1: 1af7528e (button) showed [Qc Ah] and won ($4.71) with two pair, Aces and Queens, and won ($4.71)
Seat 2: 52c49e29 (small blind) folded before Flop
Seat 3: Hero (big blind) folded before Flop
Seat 4: 483f17c3 folded before Flop (didn't bet)
Seat 5: 70a7a795 folded before Flop (didn't bet)
Seat 6: 79f65393 showed [Ks Kd] and lost with a pair of Kings, and lost


Poker Hand #RC3795930288: Hold'em No Limit ($0.02/$0.05) - 2025/08/10 08:25:10
Table 'RushAndCash11065548' 6-max Seat #1 is the button
Seat 1: 83bc5fa2 ($5.23 in chips)
Seat 2: 45a89215 ($12.8 in chips)
Seat 3: 8e04bbd3 ($5.28 in chips)
Seat 4: 8b390e1e ($5.05 in chips)
Seat 5: 667b62d6 ($11.54 in chips)
Seat 6: Hero ($7.79 in chips)
45a89215: posts small blind $0.02
8e04bbd3: posts big blind $0.05
*** HOLE CARDS ***
Dealt to 83bc5fa2 
Dealt to 45a89215 
Dealt to 8e04bbd3 
Dealt to 8b390e1e 
Dealt to 667b62d6 
Dealt to Hero [Ad 6h]
8b390e1e: folds
667b62d6: raises $0.05 to $0.1
Hero: folds
83bc5fa2: calls $0.1
45a89215: folds
8e04bbd3: folds
*** FLOP *** [8h 8s 9s]
667b62d6: bets $0.09
83bc5fa2: calls $0.09
*** TURN *** [8h 8s 9s] [2s]
667b62d6: checks
83bc5fa2: bets $0.15
667b62d6: calls $0.15
*** RIVER *** [8h 8s 9s 2s] [6c]
667b62d6: bets $0.25
83bc5fa2: calls $0.25
667b62d6: shows [Tc Th] (two pair, Tens and Eights)
83bc5fa2: shows [Ah 9h] (two pair, Nines and Eights)
*** SHOWDOWN ***
667b62d6 collected $1.19 from pot
*** SUMMARY ***
Total pot $1.25 | Rake $0.06 | Jackpot $0 | Bingo $0 | Fortune $0 | Tax $0
Board [8h 8s 9s 2s 6c]
Seat 1: 83bc5fa2 (button) showed [Ah 9h] and lost with two pair, Nines and Eights
Seat 2: 45a89215 (small blind) folded before Flop
Seat 3: 8e04bbd3 (big blind) folded before Flop
Seat 4: 8b390e1e folded before Flop (didn't bet)
Seat 5: 667b62d6 showed [Tc Th] and won ($1.19) with two pair, Tens and Eights
Seat 6: Hero folded before Flop (didn't bet)


Poker Hand #RC3795930240: Hold'em No Limit ($0.02/$0.05) - 2025/08/10 08:24:58
Table 'RushAndCash11065500' 6-max Seat #1 is the button
Seat 1: a127404a ($6 in chips)
Seat 2: Hero ($7.81 in chips)
Seat 3: f6bf8dfb ($11.41 in chips)
Seat 4: 196c1899 ($25.28 in chips)
Seat 5: f3a1d090 ($23.62 in chips)
Seat 6: af0721f5 ($7.21 in chips)
Hero: posts small blind $0.02
f6bf8dfb: posts big blind $0.05
*** HOLE CARDS ***
Dealt to a127404a 
Dealt to Hero [Qd 8c]
Dealt to f6bf8dfb 
Dealt to 196c1899 
Dealt to f3a1d090 
Dealt to af0721f5 
196c1899: folds
f3a1d090: folds
af0721f5: folds
a127404a: folds
Hero: folds
Uncalled bet ($0.03) returned to f6bf8dfb
*** SHOWDOWN ***
f6bf8dfb collected $0.04 from pot
*** SUMMARY ***
Total pot $0.04 | Rake $0 | Jackpot $0 | Bingo $0 | Fortune $0 | Tax $0
Seat 1: a127404a (button) folded before Flop (didn't bet)
Seat 2: Hero (small blind) folded before Flop
Seat 3: f6bf8dfb (big blind) collected ($0.04)
Seat 4: 196c1899 folded before Flop (didn't bet)
Seat 5: f3a1d090 folded before Flop (didn't bet)
Seat 6: af0721f5 folded before Flop (didn't bet)


Poker Hand #RC3795930228: Hold'em No Limit ($0.02/$0.05) - 2025/08/10 08:24:54
Table 'RushAndCash11065488' 6-max Seat #1 is the button
Seat 1: dfd46061 ($2.79 in chips)
Seat 2: 9d70d038 ($16.75 in chips)
Seat 3: 55b6c449 ($5.07 in chips)
Seat 4: Hero ($7.81 in chips)
Seat 5: de5456c0 ($5.68 in chips)
Seat 6: b527583c ($9.03 in chips)
9d70d038: posts small blind $0.02
55b6c449: posts big blind $0.05
*** HOLE CARDS ***
Dealt to dfd46061 
Dealt to 9d70d038 
Dealt to 55b6c449 
Dealt to Hero [Qs 7s]
Dealt to de5456c0 
Dealt to b527583c 
Hero: folds
de5456c0: folds
b527583c: folds
dfd46061: calls $0.05
9d70d038: calls $0.03
55b6c449: checks
*** FLOP *** [6s 2c 2d]
9d70d038: checks
55b6c449: checks
dfd46061: bets $0.15
9d70d038: folds
55b6c449: folds
Uncalled bet ($0.15) returned to dfd46061
*** SHOWDOWN ***
dfd46061 collected $0.15 from pot
*** SUMMARY ***
Total pot $0.15 | Rake $0 | Jackpot $0 | Bingo $0 | Fortune $0 | Tax $0
Board [6s 2c 2d]
Seat 1: dfd46061 (button) won ($0.15)
Seat 2: 9d70d038 (small blind) folded on the Flop
Seat 3: 55b6c449 (big blind) folded on the Flop
Seat 4: Hero folded before Flop (didn't bet)
Seat 5: de5456c0 folded before Flop (didn't bet)
Seat 6: b527583c folded before Flop (didn't bet)


Poker Hand #RC3795930215: Hold'em No Limit ($0.02/$0.05) - 2025/08/10 08:24:50
Table 'RushAndCash11065475' 6-max Seat #1 is the button
Seat 1: 17b790ab ($6.91 in chips)
Seat 2: 6412bd28 ($3.82 in chips)
Seat 3: 5b54e251 ($12.17 in chips)
Seat 4: Hero ($7.81 in chips)
Seat 5: 560bbe0d ($16.11 in chips)
Seat 6: 7e9b978a ($5.76 in chips)
6412bd28: posts small blind $0.02
5b54e251: posts big blind $0.05
*** HOLE CARDS ***
Dealt to 17b790ab 
Dealt to 6412bd28 
Dealt to 5b54e251 
Dealt to Hero [5h 6d]
Dealt to 560bbe0d 
Dealt to 7e9b978a 
Hero: folds
560bbe0d: folds
7e9b978a: folds
17b790ab: raises $0.05 to $0.1
6412bd28: folds
5b54e251: folds
Uncalled bet ($0.05) returned to 17b790ab
*** SHOWDOWN ***
17b790ab collected $0.12 from pot
*** SUMMARY ***
Total pot $0.12 | Rake $0 | Jackpot $0 | Bingo $0 | Fortune $0 | Tax $0
Seat 1: 17b790ab (button) collected ($0.12)
Seat 2: 6412bd28 (small blind) folded before Flop
Seat 3: 5b54e251 (big blind) folded before Flop
Seat 4: Hero folded before Flop (didn't bet)
Seat 5: 560bbe0d folded before Flop (didn't bet)
Seat 6: 7e9b978a folded before Flop (didn't bet)


Poker Hand #RC3795929963: Hold'em No Limit ($0.02/$0.05) - 2025/08/10 08:23:43
Table 'RushAndCash11065223' 6-max Seat #1 is the button
Seat 1: fa1b15ba ($12.16 in chips)
Seat 2: 210c8e9b ($15.77 in chips)
Seat 3: 17b790ab ($7.55 in chips)
Seat 4: a1651cdc ($6.96 in chips)
Seat 5: 34f17b0d ($7.53 in chips)
Seat 6: Hero ($7.21 in chips)
210c8e9b: posts small blind $0.02
17b790ab: posts big blind $0.05
*** HOLE CARDS ***
Dealt to fa1b15ba 
Dealt to 210c8e9b 
Dealt to 17b790ab 
Dealt to a1651cdc 
Dealt to 34f17b0d 
Dealt to Hero [As 7s]
a1651cdc: folds
34f17b0d: folds
Hero: raises $0.05 to $0.1
fa1b15ba: folds
210c8e9b: folds
17b790ab: calls $0.05
*** FLOP *** [6s 3c Ah]
17b790ab: checks
Hero: checks
*** TURN *** [6s 3c Ah] [4h]
17b790ab: bets $0.11
Hero: calls $0.11
*** RIVER *** [6s 3c Ah 4h] [5c]
17b790ab: bets $0.43
Hero: raises $1.47 to $1.9
17b790ab: folds
Uncalled bet ($1.47) returned to Hero
*** SHOWDOWN ***
Hero collected $1.24 from pot
*** SUMMARY ***
Total pot $1.3 | Rake $0.06 | Jackpot $0 | Bingo $0 | Fortune $0 | Tax $0
Board [6s 3c Ah 4h 5c]
Seat 1: fa1b15ba (button) folded before Flop (didn't bet)
Seat 2: 210c8e9b (small blind) folded before Flop
Seat 3: 17b790ab (big blind) folded on the River
Seat 4: a1651cdc folded before Flop (didn't bet)
Seat 5: 34f17b0d folded before Flop (didn't bet)
Seat 6: Hero won ($1.24)


Poker Hand #RC3795929940: Hold'em No Limit ($0.02/$0.05) - 2025/08/10 08:23:36
Table 'RushAndCash11065200' 6-max Seat #1 is the button
Seat 1: 9d70d038 ($17.24 in chips)
Seat 2: Hero ($7.23 in chips)
Seat 3: 45a89215 ($8.14 in chips)
Seat 4: ac3a4080 ($6.75 in chips)
Seat 5: 36b7c554 ($5.8 in chips)
Seat 6: 6bfa288d ($5.95 in chips)
Hero: posts small blind $0.02
45a89215: posts big blind $0.05
*** HOLE CARDS ***
Dealt to 9d70d038 
Dealt to Hero [2s 4d]
Dealt to 45a89215 
Dealt to ac3a4080 
Dealt to 36b7c554 
Dealt to 6bfa288d 
ac3a4080: raises $0.05 to $0.1
36b7c554: folds
6bfa288d: folds
9d70d038: calls $0.1
Hero: folds
45a89215: calls $0.05
*** FLOP *** [Qd Ad 8h]
45a89215: checks
ac3a4080: bets $0.11
9d70d038: folds
45a89215: folds
Uncalled bet ($0.11) returned to ac3a4080
*** SHOWDOWN ***
ac3a4080 collected $0.31 from pot
*** SUMMARY ***
Total pot $0.32 | Rake $0.01 | Jackpot $0 | Bingo $0 | Fortune $0 | Tax $0
Board [Qd Ad 8h]
Seat 1: 9d70d038 (button) folded on the Flop
Seat 2: Hero (small blind) folded before Flop
Seat 3: 45a89215 (big blind) folded on the Flop
Seat 4: ac3a4080 won ($0.31)
Seat 5: 36b7c554 folded before Flop (didn't bet)
Seat 6: 6bfa288d folded before Flop (didn't bet)


Poker Hand #RC3795929901: Hold'em No Limit ($0.02/$0.05) - 2025/08/10 08:23:25
Table 'RushAndCash11065161' 6-max Seat #1 is the button
Seat 1: 808de8ec ($2.3 in chips)
Seat 2: 69e805cf ($13.77 in chips)
Seat 3: Hero ($7.28 in chips)
Seat 4: 637628c5 ($8.84 in chips)
Seat 5: e400ddd3 ($5.12 in chips)
Seat 6: 4844e57f ($11.43 in chips)
69e805cf: posts small blind $0.02
Hero: posts big blind $0.05
*** HOLE CARDS ***
Dealt to 808de8ec 
Dealt to 69e805cf 
Dealt to Hero [8s Jd]
Dealt to 637628c5 
Dealt to e400ddd3 
Dealt to 4844e57f 
637628c5: raises $0.1 to $0.15
e400ddd3: folds
4844e57f: folds
808de8ec: calls $0.15
69e805cf: folds
Hero: folds
*** FLOP *** [Tc 6c Qd]
637628c5: checks
808de8ec: checks
*** TURN *** [Tc 6c Qd] [Js]
637628c5: checks
808de8ec: checks
*** RIVER *** [Tc 6c Qd Js] [7h]
637628c5: bets $0.13
808de8ec: calls $0.13
637628c5: shows [Jh Ah] (a pair of Jacks)
808de8ec: shows [Ts 9s] (a pair of Tens)
*** SHOWDOWN ***
637628c5 collected $0.6 from pot
*** SUMMARY ***
Total pot $0.63 | Rake $0.03 | Jackpot $0 | Bingo $0 | Fortune $0 | Tax $0
Board [Tc 6c Qd Js 7h]
Seat 1: 808de8ec (button) showed [Ts 9s] and lost with a pair of Tens
Seat 2: 69e805cf (small blind) folded before Flop
Seat 3: Hero (big blind) folded before Flop
Seat 4: 637628c5 showed [Jh Ah] and won ($0.6) with a pair of Jacks
Seat 5: e400ddd3 folded before Flop (didn't bet)
Seat 6: 4844e57f folded before Flop (didn't bet)


Poker Hand #RC3795929888: Hold'em No Limit ($0.02/$0.05) - 2025/08/10 08:23:21
Table 'RushAndCash11065148' 6-max Seat #1 is the button
Seat 1: 2c53d2c7 ($6.92 in chips)
Seat 2: a127404a ($6.37 in chips)
Seat 3: 9999c04f ($3.31 in chips)
Seat 4: 8d67d790 ($11.24 in chips)
Seat 5: Hero ($7.28 in chips)
Seat 6: 31da014d ($7.39 in chips)
a127404a: posts small blind $0.02
9999c04f: posts big blind $0.05
*** HOLE CARDS ***
Dealt to 2c53d2c7 
Dealt to a127404a 
Dealt to 9999c04f 
Dealt to 8d67d790 
Dealt to Hero [4c Th]
Dealt to 31da014d 
8d67d790: folds
Hero: folds
31da014d: folds
2c53d2c7: folds
a127404a: folds
Uncalled bet ($0.03) returned to 9999c04f
*** SHOWDOWN ***
9999c04f collected $0.04 from pot
*** SUMMARY ***
Total pot $0.04 | Rake $0 | Jackpot $0 | Bingo $0 | Fortune $0 | Tax $0
Seat 1: 2c53d2c7 (button) folded before Flop (didn't bet)
Seat 2: a127404a (small blind) folded before Flop
Seat 3: 9999c04f (big blind) collected ($0.04)
Seat 4: 8d67d790 folded before Flop (didn't bet)
Seat 5: Hero folded before Flop (didn't bet)
Seat 6: 31da014d folded before Flop (didn't bet)


Poker Hand #RC3795929853: Hold'em No Limit ($0.02/$0.05) - 2025/08/10 08:23:09
Table 'RushAndCash11065113' 6-max Seat #1 is the button
Seat 1: Hero ($7.28 in chips)
Seat 2: a57b331d ($24.25 in chips)
Seat 3: 483f17c3 ($14.5 in chips)
Seat 4: 1cfd181b ($5.42 in chips)
Seat 5: 560bbe0d ($15.88 in chips)
Seat 6: 339cbf14 ($4.91 in chips)
a57b331d: posts small blind $0.02
483f17c3: posts big blind $0.05
*** HOLE CARDS ***
Dealt to Hero [5c Kd]
Dealt to a57b331d 
Dealt to 483f17c3 
Dealt to 1cfd181b 
Dealt to 560bbe0d 
Dealt to 339cbf14 
1cfd181b: raises $0.08 to $0.13
560bbe0d: folds
339cbf14: folds
Hero: folds
a57b331d: calls $0.11
483f17c3: folds
*** FLOP *** [3d Ah Kc]
a57b331d: checks
1cfd181b: checks
*** TURN *** [3d Ah Kc] [8d]
a57b331d: checks
1cfd181b: bets $0.07
a57b331d: calls $0.07
*** RIVER *** [3d Ah Kc 8d] [5h]
a57b331d: checks
1cfd181b: bets $0.7
a57b331d: folds
Uncalled bet ($0.7) returned to 1cfd181b
*** SHOWDOWN ***
1cfd181b collected $0.43 from pot
*** SUMMARY ***
Total pot $0.45 | Rake $0.02 | Jackpot $0 | Bingo $0 | Fortune $0 | Tax $0
Board [3d Ah Kc 8d 5h]
Seat 1: Hero (button) folded before Flop (didn't bet)
Seat 2: a57b331d (small blind) folded on the River
Seat 3: 483f17c3 (big blind) folded before Flop
Seat 4: 1cfd181b won ($0.43)
Seat 5: 560bbe0d folded before Flop (didn't bet)
Seat 6: 339cbf14 folded before Flop (didn't bet)


Poker Hand #RC3795929827: Hold'em No Limit ($0.02/$0.05) - 2025/08/10 08:23:01
Table 'RushAndCash11065087' 6-max Seat #1 is the button
Seat 1: Hero ($7.28 in chips)
Seat 2: 7e7c2fa7 ($2.35 in chips)
Seat 3: 7c3a91fe ($7.63 in chips)
Seat 4: f2e3feac ($9.32 in chips)
Seat 5: 5d71c963 ($9.16 in chips)
Seat 6: 22b1f4df ($10.33 in chips)
7e7c2fa7: posts small blind $0.02
7c3a91fe: posts big blind $0.05
*** HOLE CARDS ***
Dealt to Hero [Qd 6h]
Dealt to 7e7c2fa7 
Dealt to 7c3a91fe 
Dealt to f2e3feac 
Dealt to 5d71c963 
Dealt to 22b1f4df 
f2e3feac: folds
5d71c963: folds
22b1f4df: folds
Hero: folds
7e7c2fa7: calls $0.03
7c3a91fe: checks
*** FLOP *** [5c Kc 9h]
7e7c2fa7: checks
7c3a91fe: checks
*** TURN *** [5c Kc 9h] [Ts]
7e7c2fa7: checks
7c3a91fe: checks
*** RIVER *** [5c Kc 9h Ts] [Qs]
7e7c2fa7: checks
7c3a91fe: bets $0.07
7e7c2fa7: calls $0.07
7c3a91fe: shows [3d 6d] (King high)
7e7c2fa7: shows [As 8d] (Ace high)
*** SHOWDOWN ***
7e7c2fa7 collected $0.23 from pot
*** SUMMARY ***
Total pot $0.24 | Rake $0.01 | Jackpot $0 | Bingo $0 | Fortune $0 | Tax $0
Board [5c Kc 9h Ts Qs]
Seat 1: Hero (button) folded before Flop (didn't bet)
Seat 2: 7e7c2fa7 (small blind) showed [As 8d] and won ($0.23) with Ace high
Seat 3: 7c3a91fe (big blind) showed [3d 6d] and lost with King high
Seat 4: f2e3feac folded before Flop (didn't bet)
Seat 5: 5d71c963 folded before Flop (didn't bet)
Seat 6: 22b1f4df folded before Flop (didn't bet)


Poker Hand #RC3795929816: Hold'em No Limit ($0.02/$0.05) - 2025/08/10 08:22:58
Table 'RushAndCash11065076' 6-max Seat #1 is the button
Seat 1: 20f74a86 ($5.21 in chips)
Seat 2: 79f65393 ($4.6 in chips)
Seat 3: 170dea69 ($5 in chips)
Seat 4: 59da8582 ($12.67 in chips)
Seat 5: 63f3fdb ($5.2 in chips)
Seat 6: Hero ($7.28 in chips)
79f65393: posts small blind $0.02
170dea69: posts big blind $0.05
*** HOLE CARDS ***
Dealt to 20f74a86 
Dealt to 79f65393 
Dealt to 170dea69 
Dealt to 59da8582 
Dealt to 63f3fdb 
Dealt to Hero [6s 5h]
59da8582: folds
63f3fdb: raises $0.07 to $0.12
Hero: folds
20f74a86: folds
79f65393: folds
170dea69: folds
Uncalled bet ($0.07) returned to 63f3fdb
*** SHOWDOWN ***
63f3fdb collected $0.12 from pot
*** SUMMARY ***
Total pot $0.12 | Rake $0 | Jackpot $0 | Bingo $0 | Fortune $0 | Tax $0
Seat 1: 20f74a86 (button) folded before Flop (didn't bet)
Seat 2: 79f65393 (small blind) folded before Flop
Seat 3: 170dea69 (big blind) folded before Flop
Seat 4: 59da8582 folded before Flop (didn't bet)
Seat 5: 63f3fdb collected ($0.12)
Seat 6: Hero folded before Flop (didn't bet)


Poker Hand #RC3795929802: Hold'em No Limit ($0.02/$0.05) - 2025/08/10 08:22:54
Table 'RushAndCash11065062' 6-max Seat #1 is the button
Seat 1: 6412bd28 ($3.76 in chips)
Seat 2: 5c5d4a8d ($15.24 in chips)
Seat 3: 7d1f43e4 ($9.62 in chips)
Seat 4: Hero ($7.28 in chips)
Seat 5: 5d71c963 ($9.16 in chips)
Seat 6: 391d0c67 ($6.13 in chips)
5c5d4a8d: posts small blind $0.02
7d1f43e4: posts big blind $0.05
*** HOLE CARDS ***
Dealt to 6412bd28 
Dealt to 5c5d4a8d 
Dealt to 7d1f43e4 
Dealt to Hero [Jc 5d]
Dealt to 5d71c963 
Dealt to 391d0c67 
Hero: folds
5d71c963: folds
391d0c67: folds
6412bd28: calls $0.05
5c5d4a8d: folds
7d1f43e4: checks
*** FLOP *** [Qc Js 5c]
7d1f43e4: checks
6412bd28: checks
*** TURN *** [Qc Js 5c] [3d]
7d1f43e4: checks
6412bd28: checks
*** RIVER *** [Qc Js 5c 3d] [5h]
7d1f43e4: checks
6412bd28: checks
7d1f43e4: shows [6d Ah] (a pair of Fives)
6412bd28: shows [2s 2c] (two pair, Fives and Twos)
*** SHOWDOWN ***
6412bd28 collected $0.12 from pot
*** SUMMARY ***
Total pot $0.12 | Rake $0 | Jackpot $0 | Bingo $0 | Fortune $0 | Tax $0
Board [Qc Js 5c 3d 5h]
Seat 1: 6412bd28 (button) showed [2s 2c] and won ($0.12) with two pair, Fives and Twos
Seat 2: 5c5d4a8d (small blind) folded before Flop
Seat 3: 7d1f43e4 (big blind) showed [6d Ah] and lost with a pair of Fives
Seat 4: Hero folded before Flop (didn't bet)
Seat 5: 5d71c963 folded before Flop (didn't bet)
Seat 6: 391d0c67 folded before Flop (didn't bet)


Poker Hand #RC3795929709: Hold'em No Limit ($0.02/$0.05) - 2025/08/10 08:22:28
Table 'RushAndCash11064969' 6-max Seat #1 is the button
Seat 1: e4544ec8 ($5 in chips)
Seat 2: db22ee6f ($5 in chips)
Seat 3: Hero ($7.41 in chips)
Seat 4: 97f832bf ($9.61 in chips)
Seat 5: dc12e899 ($5.27 in chips)
Seat 6: 8493c72d ($5.27 in chips)
db22ee6f: posts small blind $0.02
Hero: posts big blind $0.05
*** HOLE CARDS ***
Dealt to e4544ec8 
Dealt to db22ee6f 
Dealt to Hero [7s 8h]
Dealt to 97f832bf 
Dealt to dc12e899 
Dealt to 8493c72d 
97f832bf: folds
dc12e899: raises $0.08 to $0.13
8493c72d: folds
e4544ec8: folds
db22ee6f: calls $0.11
Hero: calls $0.08
*** FLOP *** [4d Kd 2h]
db22ee6f: checks
Hero: checks
dc12e899: bets $0.14
db22ee6f: calls $0.14
Hero: folds
*** TURN *** [4d Kd 2h] [8s]
db22ee6f: checks
dc12e899: bets $0.52
db22ee6f: calls $0.52
*** RIVER *** [4d Kd 2h 8s] [Qd]
db22ee6f: checks
dc12e899: bets $1.72
db22ee6f: raises $2.49 to $4.21 and is all-in
dc12e899: calls $2.49
db22ee6f: shows [6d 5d] (a flush King high)
dc12e899: shows [Td Ad] (a flush Ace high)
*** SHOWDOWN ***
dc12e899 collected $9.91 from pot
*** SUMMARY ***
Total pot $10.13 | Rake $0.15 | Jackpot $0.07 | Bingo $0 | Fortune $0 | Tax $0
Board [4d Kd 2h 8s Qd]
Seat 1: e4544ec8 (button) folded before Flop (didn't bet)
Seat 2: db22ee6f (small blind) showed [6d 5d] and lost with a flush King high
Seat 3: Hero (big blind) folded on the Flop
Seat 4: 97f832bf folded before Flop (didn't bet)
Seat 5: dc12e899 showed [Td Ad] and won ($9.91) with a flush Ace high
Seat 6: 8493c72d folded before Flop (didn't bet)


Poker Hand #RC3795929691: Hold'em No Limit ($0.02/$0.05) - 2025/08/10 08:22:22
Table 'RushAndCash11064951' 6-max Seat #1 is the button
Seat 1: 2d1b3dec ($6.74 in chips)
Seat 2: Hero ($7.43 in chips)
Seat 3: 509dbe09 ($8.56 in chips)
Seat 4: 1dafb1bc ($32.53 in chips)
Seat 5: 65914450 ($22.76 in chips)
Seat 6: 79f65393 ($4.72 in chips)
Hero: posts small blind $0.02
509dbe09: posts big blind $0.05
*** HOLE CARDS ***
Dealt to 2d1b3dec 
Dealt to Hero [Kh 5d]
Dealt to 509dbe09 
Dealt to 1dafb1bc 
Dealt to 65914450 
Dealt to 79f65393 
1dafb1bc: folds
65914450: folds
79f65393: folds
2d1b3dec: folds
Hero: folds
Uncalled bet ($0.03) returned to 509dbe09
*** SHOWDOWN ***
509dbe09 collected $0.04 from pot
*** SUMMARY ***
Total pot $0.04 | Rake $0 | Jackpot $0 | Bingo $0 | Fortune $0 | Tax $0
Seat 1: 2d1b3dec (button) folded before Flop (didn't bet)
Seat 2: Hero (small blind) folded before Flop
Seat 3: 509dbe09 (big blind) collected ($0.04)
Seat 4: 1dafb1bc folded before Flop (didn't bet)
Seat 5: 65914450 folded before Flop (didn't bet)
Seat 6: 79f65393 folded before Flop (didn't bet)


Poker Hand #RC3795929678: Hold'em No Limit ($0.02/$0.05) - 2025/08/10 08:22:19
Table 'RushAndCash11064938' 6-max Seat #1 is the button
Seat 1: a9536656 ($5.82 in chips)
Seat 2: be93df25 ($5.16 in chips)
Seat 3: ef16305 ($4.87 in chips)
Seat 4: f9038b45 ($4.93 in chips)
Seat 5: 2fd706a9 ($12.25 in chips)
Seat 6: Hero ($7.43 in chips)
be93df25: posts small blind $0.02
ef16305: posts big blind $0.05
*** HOLE CARDS ***
Dealt to a9536656 
Dealt to be93df25 
Dealt to ef16305 
Dealt to f9038b45 
Dealt to 2fd706a9 
Dealt to Hero [Qd 3d]
f9038b45: folds
2fd706a9: folds
Hero: folds
a9536656: folds
be93df25: raises $0.06 to $0.11
ef16305: raises $0.19 to $0.3
be93df25: calls $0.19
*** FLOP *** [8d 4d 9h]
be93df25: checks
ef16305: checks
*** TURN *** [8d 4d 9h] [4c]
be93df25: bets $0.2
ef16305: calls $0.2
*** RIVER *** [8d 4d 9h 4c] [4s]
be93df25: bets $0.72
ef16305: calls $0.72
be93df25: shows [5s Js] (three of a kind, Fours)
ef16305: shows [7c 7d] (a full house, Fours full of Sevens)
*** SHOWDOWN ***
ef16305 collected $2.26 from pot
*** SUMMARY ***
Total pot $2.44 | Rake $0.11 | Jackpot $0.07 | Bingo $0 | Fortune $0 | Tax $0
Board [8d 4d 9h 4c 4s]
Seat 1: a9536656 (button) folded before Flop (didn't bet)
Seat 2: be93df25 (small blind) showed [5s Js] and lost with three of a kind, Fours
Seat 3: ef16305 (big blind) showed [7c 7d] and won ($2.26) with a full house, Fours full of Sevens
Seat 4: f9038b45 folded before Flop (didn't bet)
Seat 5: 2fd706a9 folded before Flop (didn't bet)
Seat 6: Hero folded before Flop (didn't bet)


Poker Hand #RC3795929663: Hold'em No Limit ($0.02/$0.05) - 2025/08/10 08:22:15
Table 'RushAndCash11064923' 6-max Seat #1 is the button
Seat 1: 3f43d5e9 ($3.44 in chips)
Seat 2: 18b1ecd7 ($5.21 in chips)
Seat 3: e0ff0229 ($4.76 in chips)
Seat 4: 85e4ce3a ($16.11 in chips)
Seat 5: Hero ($7.43 in chips)
Seat 6: 1cfd181b ($5.3 in chips)
18b1ecd7: posts small blind $0.02
e0ff0229: posts big blind $0.05
*** HOLE CARDS ***
Dealt to 3f43d5e9 
Dealt to 18b1ecd7 
Dealt to e0ff0229 
Dealt to 85e4ce3a 
Dealt to Hero [5h 3d]
Dealt to 1cfd181b 
85e4ce3a: folds
Hero: folds
1cfd181b: folds
3f43d5e9: folds
18b1ecd7: folds
Uncalled bet ($0.03) returned to e0ff0229
*** SHOWDOWN ***
e0ff0229 collected $0.04 from pot
*** SUMMARY ***
Total pot $0.04 | Rake $0 | Jackpot $0 | Bingo $0 | Fortune $0 | Tax $0
Seat 1: 3f43d5e9 (button) folded before Flop (didn't bet)
Seat 2: 18b1ecd7 (small blind) folded before Flop
Seat 3: e0ff0229 (big blind) collected ($0.04)
Seat 4: 85e4ce3a folded before Flop (didn't bet)
Seat 5: Hero folded before Flop (didn't bet)
Seat 6: 1cfd181b folded before Flop (didn't bet)


Poker Hand #RC3795929460: Hold'em No Limit ($0.02/$0.05) - 2025/08/10 08:21:13
Table 'RushAndCash11064720' 6-max Seat #1 is the button
Seat 1: 1cfd181b ($5.41 in chips)
Seat 2: Hero ($5.97 in chips)
Seat 3: 3f43d5e9 ($5.01 in chips)
Seat 4: f394f7bb ($4.71 in chips)
Seat 5: cb83453e ($8.96 in chips)
Seat 6: 6f8f726b ($16.1 in chips)
Hero: posts small blind $0.02
3f43d5e9: posts big blind $0.05
*** HOLE CARDS ***
Dealt to 1cfd181b 
Dealt to Hero [As Kh]
Dealt to 3f43d5e9 
Dealt to f394f7bb 
Dealt to cb83453e 
Dealt to 6f8f726b 
f394f7bb: folds
cb83453e: folds
6f8f726b: folds
1cfd181b: raises $0.06 to $0.11
Hero: raises $0.32 to $0.43
3f43d5e9: raises $0.57 to $1
1cfd181b: folds
Hero: raises $0.57 to $1.57
3f43d5e9: calls $0.57
*** FLOP *** [2c Qc 9c]
Hero: bets $1
3f43d5e9: folds
Uncalled bet ($1) returned to Hero
*** SHOWDOWN ***
Hero collected $3.03 from pot
*** SUMMARY ***
Total pot $3.25 | Rake $0.15 | Jackpot $0.07 | Bingo $0 | Fortune $0 | Tax $0
Board [2c Qc 9c]
Seat 1: 1cfd181b (button) folded before Flop
Seat 2: Hero (small blind) won ($3.03)
Seat 3: 3f43d5e9 (big blind) folded on the Flop
Seat 4: f394f7bb folded before Flop (didn't bet)
Seat 5: cb83453e folded before Flop (didn't bet)
Seat 6: 6f8f726b folded before Flop (didn't bet)


Poker Hand #RC3795929404: Hold'em No Limit ($0.02/$0.05) - 2025/08/10 08:20:54
Table 'RushAndCash11064664' 6-max Seat #1 is the button
Seat 1: Hero ($5.9 in chips)
Seat 2: 424436d ($7.03 in chips)
Seat 3: 9b73cb59 ($5 in chips)
Seat 4: 4328ce0 ($4.05 in chips)
Seat 5: bbe9b1b1 ($5.18 in chips)
Seat 6: d27c038b ($5.34 in chips)
424436d: posts small blind $0.02
9b73cb59: posts big blind $0.05
*** HOLE CARDS ***
Dealt to Hero [Td 8d]
Dealt to 424436d 
Dealt to 9b73cb59 
Dealt to 4328ce0 
Dealt to bbe9b1b1 
Dealt to d27c038b 
4328ce0: folds
bbe9b1b1: folds
d27c038b: folds
Hero: raises $0.06 to $0.11
424436d: folds
9b73cb59: folds
Uncalled bet ($0.06) returned to Hero
*** SHOWDOWN ***
Hero collected $0.12 from pot
*** SUMMARY ***
Total pot $0.12 | Rake $0 | Jackpot $0 | Bingo $0 | Fortune $0 | Tax $0
Seat 1: Hero (button) collected ($0.12)
Seat 2: 424436d (small blind) folded before Flop
Seat 3: 9b73cb59 (big blind) folded before Flop
Seat 4: 4328ce0 folded before Flop (didn't bet)
Seat 5: bbe9b1b1 folded before Flop (didn't bet)
Seat 6: d27c038b folded before Flop (didn't bet)


Poker Hand #RC3795929379: Hold'em No Limit ($0.02/$0.05) - 2025/08/10 08:20:45
Table 'RushAndCash11064639' 6-max Seat #1 is the button
Seat 1: f2e3feac ($8.37 in chips)
Seat 2: d62070dc ($6.49 in chips)
Seat 3: Hero ($5.88 in chips)
Seat 4: fa1b15ba ($13.31 in chips)
Seat 5: fd4f7f89 ($6 in chips)
Seat 6: ae904d2 ($5.81 in chips)
d62070dc: posts small blind $0.02
Hero: posts big blind $0.05
*** HOLE CARDS ***
Dealt to f2e3feac 
Dealt to d62070dc 
Dealt to Hero [2c Qd]
Dealt to fa1b15ba 
Dealt to fd4f7f89 
Dealt to ae904d2 
fa1b15ba: folds
fd4f7f89: folds
ae904d2: folds
f2e3feac: folds
d62070dc: folds
Uncalled bet ($0.03) returned to Hero
*** SHOWDOWN ***
Hero collected $0.04 from pot
*** SUMMARY ***
Total pot $0.04 | Rake $0 | Jackpot $0 | Bingo $0 | Fortune $0 | Tax $0
Seat 1: f2e3feac (button) folded before Flop (didn't bet)
Seat 2: d62070dc (small blind) folded before Flop
Seat 3: Hero (big blind) collected ($0.04)
Seat 4: fa1b15ba folded before Flop (didn't bet)
Seat 5: fd4f7f89 folded before Flop (didn't bet)
Seat 6: ae904d2 folded before Flop (didn't bet)


Poker Hand #RC3795929368: Hold'em No Limit ($0.02/$0.05) - 2025/08/10 08:20:41
Table 'RushAndCash11064628' 6-max Seat #1 is the button
Seat 1: e248cbd0 ($2.48 in chips)
Seat 2: 2a76f9f5 ($6.12 in chips)
Seat 3: de5456c0 ($5 in chips)
Seat 4: ac25def9 ($5.16 in chips)
Seat 5: Hero ($5.88 in chips)
Seat 6: fab46f2c ($11.69 in chips)
2a76f9f5: posts small blind $0.02
de5456c0: posts big blind $0.05
*** HOLE CARDS ***
Dealt to e248cbd0 
Dealt to 2a76f9f5 
Dealt to de5456c0 
Dealt to ac25def9 
Dealt to Hero [9s 3c]
Dealt to fab46f2c 
ac25def9: folds
Hero: folds
fab46f2c: folds
e248cbd0: raises $0.1 to $0.15
2a76f9f5: raises $0.32 to $0.47
de5456c0: folds
e248cbd0: raises $2.01 to $2.48 and is all-in
2a76f9f5: calls $2.01
e248cbd0: shows [Ah 6d]
2a76f9f5: shows [Ad Kh]
*** FLOP *** [9d 9h 3s]
*** TURN *** [9d 9h 3s] [7h]
*** RIVER *** [9d 9h 3s 7h] [2h]
*** SHOWDOWN ***
2a76f9f5 collected $4.79 from pot
*** SUMMARY ***
Total pot $5.01 | Rake $0.15 | Jackpot $0.07 | Bingo $0 | Fortune $0 | Tax $0
Board [9d 9h 3s 7h 2h]
Seat 1: e248cbd0 (button) showed [Ah 6d] and lost with a pair of Nines
Seat 2: 2a76f9f5 (small blind) showed [Ad Kh] and won ($4.79) with a pair of Nines
Seat 3: de5456c0 (big blind) folded before Flop
Seat 4: ac25def9 folded before Flop (didn't bet)
Seat 5: Hero folded before Flop (didn't bet)
Seat 6: fab46f2c folded before Flop (didn't bet)


Poker Hand #RC3795929359: Hold'em No Limit ($0.02/$0.05) - 2025/08/10 08:20:38
Table 'RushAndCash11064619' 6-max Seat #1 is the button
Seat 1: de5456c0 ($5 in chips)
Seat 2: d7fd8492 ($23.03 in chips)
Seat 3: bcd5617c ($5 in chips)
Seat 4: 3817bfda ($21.83 in chips)
Seat 5: cf24dfe4 ($6.05 in chips)
Seat 6: Hero ($5.88 in chips)
d7fd8492: posts small blind $0.02
bcd5617c: posts big blind $0.05
*** HOLE CARDS ***
Dealt to de5456c0 
Dealt to d7fd8492 
Dealt to bcd5617c 
Dealt to 3817bfda 
Dealt to cf24dfe4 
Dealt to Hero [4h 8s]
3817bfda: raises $0.07 to $0.12
cf24dfe4: folds
Hero: folds
de5456c0: folds
d7fd8492: folds
bcd5617c: calls $0.07
*** FLOP *** [4d 2d 5d]
bcd5617c: checks
3817bfda: bets $0.13
bcd5617c: calls $0.13
*** TURN *** [4d 2d 5d] [6d]
bcd5617c: checks
3817bfda: bets $0.39
bcd5617c: calls $0.39
*** RIVER *** [4d 2d 5d 6d] [Kc]
bcd5617c: checks
3817bfda: bets $21.19 and is all-in
bcd5617c: folds
Uncalled bet ($21.19) returned to 3817bfda
*** SHOWDOWN ***
3817bfda collected $1.24 from pot
*** SUMMARY ***
Total pot $1.3 | Rake $0.06 | Jackpot $0 | Bingo $0 | Fortune $0 | Tax $0
Board [4d 2d 5d 6d Kc]
Seat 1: de5456c0 (button) folded before Flop (didn't bet)
Seat 2: d7fd8492 (small blind) folded before Flop
Seat 3: bcd5617c (big blind) folded on the River
Seat 4: 3817bfda won ($1.24)
Seat 5: cf24dfe4 folded before Flop (didn't bet)
Seat 6: Hero folded before Flop (didn't bet)


Poker Hand #RC3795929347: Hold'em No Limit ($0.02/$0.05) - 2025/08/10 08:20:34
Table 'RushAndCash11064607' 6-max Seat #1 is the button
Seat 1: 4cadf508 ($5.05 in chips)
Seat 2: e248cbd0 ($2.55 in chips)
Seat 3: 8afb6429 ($6.97 in chips)
Seat 4: 68db1858 ($4.69 in chips)
Seat 5: Hero ($5.88 in chips)
Seat 6: 1f81ea21 ($1.11 in chips)
e248cbd0: posts small blind $0.02
8afb6429: posts big blind $0.05
*** HOLE CARDS ***
Dealt to 4cadf508 
Dealt to e248cbd0 
Dealt to 8afb6429 
Dealt to 68db1858 
Dealt to Hero [8c Qh]
Dealt to 1f81ea21 
68db1858: raises $0.05 to $0.1
Hero: folds
1f81ea21: calls $0.1
4cadf508: folds
e248cbd0: folds
8afb6429: folds
*** FLOP *** [Kd Th Kh]
68db1858: checks
1f81ea21: checks
*** TURN *** [Kd Th Kh] [Jd]
68db1858: checks
1f81ea21: checks
*** RIVER *** [Kd Th Kh Jd] [4h]
68db1858: checks
1f81ea21: checks
68db1858: shows [8s As] (a pair of Kings)
1f81ea21: shows [3s 5s] (a pair of Kings)
*** SHOWDOWN ***
68db1858 collected $0.26 from pot
*** SUMMARY ***
Total pot $0.27 | Rake $0.01 | Jackpot $0 | Bingo $0 | Fortune $0 | Tax $0
Board [Kd Th Kh Jd 4h]
Seat 1: 4cadf508 (button) folded before Flop (didn't bet)
Seat 2: e248cbd0 (small blind) folded before Flop
Seat 3: 8afb6429 (big blind) folded before Flop
Seat 4: 68db1858 showed [8s As] and won ($0.26) with a pair of Kings
Seat 5: Hero folded before Flop (didn't bet)
Seat 6: 1f81ea21 showed [3s 5s] and lost with a pair of Kings


Poker Hand #RC3795929336: Hold'em No Limit ($0.02/$0.05) - 2025/08/10 08:20:30
Table 'RushAndCash11064596' 6-max Seat #1 is the button
Seat 1: 31da014d ($7.1 in chips)
Seat 2: 8afb6429 ($6.99 in chips)
Seat 3: 28c1300c ($5.06 in chips)
Seat 4: 73869740 ($5.01 in chips)
Seat 5: Hero ($5.88 in chips)
Seat 6: e90b1294 ($6.01 in chips)
8afb6429: posts small blind $0.02
28c1300c: posts big blind $0.05
*** HOLE CARDS ***
Dealt to 31da014d 
Dealt to 8afb6429 
Dealt to 28c1300c 
Dealt to 73869740 
Dealt to Hero [7s Ts]
Dealt to e90b1294 
73869740: raises $0.06 to $0.11
Hero: folds
e90b1294: folds
31da014d: folds
8afb6429: folds
28c1300c: folds
Uncalled bet ($0.06) returned to 73869740
*** SHOWDOWN ***
73869740 collected $0.12 from pot
*** SUMMARY ***
Total pot $0.12 | Rake $0 | Jackpot $0 | Bingo $0 | Fortune $0 | Tax $0
Seat 1: 31da014d (button) folded before Flop (didn't bet)
Seat 2: 8afb6429 (small blind) folded before Flop
Seat 3: 28c1300c (big blind) folded before Flop
Seat 4: 73869740 collected ($0.12)
Seat 5: Hero folded before Flop (didn't bet)
Seat 6: e90b1294 folded before Flop (didn't bet)


Poker Hand #RC3795929287: Hold'em No Limit ($0.02/$0.05) - 2025/08/10 08:20:16
Table 'RushAndCash11064547' 6-max Seat #1 is the button
Seat 1: 3baac59e ($4.93 in chips)
Seat 2: Hero ($5.83 in chips)
Seat 3: 72e119cc ($3.49 in chips)
Seat 4: c506571 ($5 in chips)
Seat 5: 3f382755 ($6.12 in chips)
Seat 6: d7fd8492 ($23.05 in chips)
Hero: posts small blind $0.02
72e119cc: posts big blind $0.05
*** HOLE CARDS ***
Dealt to 3baac59e 
Dealt to Hero [Ad Ts]
Dealt to 72e119cc 
Dealt to c506571 
Dealt to 3f382755 
Dealt to d7fd8492 
c506571: folds
3f382755: folds
d7fd8492: folds
3baac59e: folds
Hero: raises $0.05 to $0.1
72e119cc: folds
Uncalled bet ($0.05) returned to Hero
*** SHOWDOWN ***
Hero collected $0.1 from pot
*** SUMMARY ***
Total pot $0.1 | Rake $0 | Jackpot $0 | Bingo $0 | Fortune $0 | Tax $0
Seat 1: 3baac59e (button) folded before Flop (didn't bet)
Seat 2: Hero (small blind) collected ($0.1)
Seat 3: 72e119cc (big blind) folded before Flop
Seat 4: c506571 folded before Flop (didn't bet)
Seat 5: 3f382755 folded before Flop (didn't bet)
Seat 6: d7fd8492 folded before Flop (didn't bet)


Poker Hand #RC3795929244: Hold'em No Limit ($0.02/$0.05) - 2025/08/10 08:20:03
Table 'RushAndCash11064504' 6-max Seat #1 is the button
Seat 1: Hero ($5.83 in chips)
Seat 2: dc4f2a76 ($5.41 in chips)
Seat 3: af0721f5 ($8.03 in chips)
Seat 4: 52c49e29 ($11.69 in chips)
Seat 5: 35c42e8c ($7.38 in chips)
Seat 6: 8afb6429 ($6.94 in chips)
dc4f2a76: posts small blind $0.02
af0721f5: posts big blind $0.05
*** HOLE CARDS ***
Dealt to Hero [4d 9s]
Dealt to dc4f2a76 
Dealt to af0721f5 
Dealt to 52c49e29 
Dealt to 35c42e8c 
Dealt to 8afb6429 
52c49e29: folds
35c42e8c: folds
8afb6429: raises $0.1 to $0.15
Hero: folds
dc4f2a76: folds
af0721f5: folds
Uncalled bet ($0.1) returned to 8afb6429
*** SHOWDOWN ***
8afb6429 collected $0.12 from pot
*** SUMMARY ***
Total pot $0.12 | Rake $0 | Jackpot $0 | Bingo $0 | Fortune $0 | Tax $0
Seat 1: Hero (button) folded before Flop (didn't bet)
Seat 2: dc4f2a76 (small blind) folded before Flop
Seat 3: af0721f5 (big blind) folded before Flop
Seat 4: 52c49e29 folded before Flop (didn't bet)
Seat 5: 35c42e8c folded before Flop (didn't bet)
Seat 6: 8afb6429 collected ($0.12)


Poker Hand #RC3795929195: Hold'em No Limit ($0.02/$0.05) - 2025/08/10 08:19:48
Table 'RushAndCash11064455' 6-max Seat #1 is the button
Seat 1: 43f64b9b ($6.97 in chips)
Seat 2: 85e4ce3a ($16.65 in chips)
Seat 3: Hero ($5.88 in chips)
Seat 4: 87171343 ($8.34 in chips)
Seat 5: e533c044 ($5.05 in chips)
Seat 6: 41ed372d ($5.5 in chips)
85e4ce3a: posts small blind $0.02
Hero: posts big blind $0.05
*** HOLE CARDS ***
Dealt to 43f64b9b 
Dealt to 85e4ce3a 
Dealt to Hero [9h 2h]
Dealt to 87171343 
Dealt to e533c044 
Dealt to 41ed372d 
87171343: folds
e533c044: folds
41ed372d: folds
43f64b9b: raises $0.05 to $0.1
85e4ce3a: folds
Hero: folds
Uncalled bet ($0.05) returned to 43f64b9b
*** SHOWDOWN ***
43f64b9b collected $0.12 from pot
*** SUMMARY ***
Total pot $0.12 | Rake $0 | Jackpot $0 | Bingo $0 | Fortune $0 | Tax $0
Seat 1: 43f64b9b (button) collected ($0.12)
Seat 2: 85e4ce3a (small blind) folded before Flop
Seat 3: Hero (big blind) folded before Flop
Seat 4: 87171343 folded before Flop (didn't bet)
Seat 5: e533c044 folded before Flop (didn't bet)
Seat 6: 41ed372d folded before Flop (didn't bet)


Poker Hand #RC3795929184: Hold'em No Limit ($0.02/$0.05) - 2025/08/10 08:19:45
Table 'RushAndCash11064444' 6-max Seat #1 is the button
Seat 1: 880ef146 ($9.21 in chips)
Seat 2: 5c5d4a8d ($15.34 in chips)
Seat 3: fdfc54bf ($15.04 in chips)
Seat 4: Hero ($5.88 in chips)
Seat 5: c509d9d8 ($2.22 in chips)
Seat 6: 827e3595 ($7.42 in chips)
5c5d4a8d: posts small blind $0.02
fdfc54bf: posts big blind $0.05
*** HOLE CARDS ***
Dealt to 880ef146 
Dealt to 5c5d4a8d 
Dealt to fdfc54bf 
Dealt to Hero [3d Ts]
Dealt to c509d9d8 
Dealt to 827e3595 
Hero: folds
c509d9d8: folds
827e3595: raises $0.1 to $0.15
880ef146: folds
5c5d4a8d: folds
fdfc54bf: folds
Uncalled bet ($0.1) returned to 827e3595
*** SHOWDOWN ***
827e3595 collected $0.12 from pot
*** SUMMARY ***
Total pot $0.12 | Rake $0 | Jackpot $0 | Bingo $0 | Fortune $0 | Tax $0
Seat 1: 880ef146 (button) folded before Flop (didn't bet)
Seat 2: 5c5d4a8d (small blind) folded before Flop
Seat 3: fdfc54bf (big blind) folded before Flop
Seat 4: Hero folded before Flop (didn't bet)
Seat 5: c509d9d8 folded before Flop (didn't bet)
Seat 6: 827e3595 collected ($0.12)


Poker Hand #RC3795929172: Hold'em No Limit ($0.02/$0.05) - 2025/08/10 08:19:41
Table 'RushAndCash11064432' 6-max Seat #1 is the button
Seat 1: 80630135 ($5.19 in chips)
Seat 2: 6412bd28 ($3.67 in chips)
Seat 3: 6f8f726b ($15.96 in chips)
Seat 4: Hero ($5.88 in chips)
Seat 5: 9ae53275 ($5.17 in chips)
Seat 6: 2b56ac20 ($15.37 in chips)
6412bd28: posts small blind $0.02
6f8f726b: posts big blind $0.05
*** HOLE CARDS ***
Dealt to 80630135 
Dealt to 6412bd28 
Dealt to 6f8f726b 
Dealt to Hero [8h 4c]
Dealt to 9ae53275 
Dealt to 2b56ac20 
Hero: folds
9ae53275: raises $0.05 to $0.1
2b56ac20: folds
80630135: folds
6412bd28: folds
6f8f726b: calls $0.05
*** FLOP *** [8s Qd 6h]
6f8f726b: checks
9ae53275: bets $0.08
6f8f726b: calls $0.08
*** TURN *** [8s Qd 6h] [Qc]
6f8f726b: checks
9ae53275: checks
*** RIVER *** [8s Qd 6h Qc] [2h]
6f8f726b: bets $0.64
9ae53275: folds
Uncalled bet ($0.64) returned to 6f8f726b
*** SHOWDOWN ***
6f8f726b collected $0.37 from pot
*** SUMMARY ***
Total pot $0.38 | Rake $0.01 | Jackpot $0 | Bingo $0 | Fortune $0 | Tax $0
Board [8s Qd 6h Qc 2h]
Seat 1: 80630135 (button) folded before Flop (didn't bet)
Seat 2: 6412bd28 (small blind) folded before Flop
Seat 3: 6f8f726b (big blind) won ($0.37)
Seat 4: Hero folded before Flop (didn't bet)
Seat 5: 9ae53275 folded on the River
Seat 6: 2b56ac20 folded before Flop (didn't bet)


Poker Hand #RC3795929159: Hold'em No Limit ($0.02/$0.05) - 2025/08/10 08:19:37
Table 'RushAndCash11064419' 6-max Seat #1 is the button
Seat 1: 36b7c554 ($5.74 in chips)
Seat 2: ed99f05f ($8.37 in chips)
Seat 3: 65914450 ($23.95 in chips)
Seat 4: 827e3595 ($7.47 in chips)
Seat 5: db22ee6f ($6.24 in chips)
Seat 6: Hero ($5.88 in chips)
ed99f05f: posts small blind $0.02
65914450: posts big blind $0.05
*** HOLE CARDS ***
Dealt to 36b7c554 
Dealt to ed99f05f 
Dealt to 65914450 
Dealt to 827e3595 
Dealt to db22ee6f 
Dealt to Hero [5s Tc]
827e3595: folds
db22ee6f: folds
Hero: folds
36b7c554: raises $0.08 to $0.13
ed99f05f: folds
65914450: calls $0.08
*** FLOP *** [Js 2h Jc]
65914450: checks
36b7c554: bets $0.07
65914450: calls $0.07
*** TURN *** [Js 2h Jc] [8h]
65914450: checks
36b7c554: checks
*** RIVER *** [Js 2h Jc 8h] [Ac]
65914450: checks
36b7c554: bets $0.24
65914450: folds
Uncalled bet ($0.24) returned to 36b7c554
*** SHOWDOWN ***
36b7c554 collected $0.4 from pot
*** SUMMARY ***
Total pot $0.42 | Rake $0.02 | Jackpot $0 | Bingo $0 | Fortune $0 | Tax $0
Board [Js 2h Jc 8h Ac]
Seat 1: 36b7c554 (button) won ($0.4)
Seat 2: ed99f05f (small blind) folded before Flop
Seat 3: 65914450 (big blind) folded on the River
Seat 4: 827e3595 folded before Flop (didn't bet)
Seat 5: db22ee6f folded before Flop (didn't bet)
Seat 6: Hero folded before Flop (didn't bet)


Poker Hand #RC3795929133: Hold'em No Limit ($0.02/$0.05) - 2025/08/10 08:19:29
Table 'RushAndCash11064393' 6-max Seat #1 is the button
Seat 1: Hero ($5.88 in chips)
Seat 2: 1cc4b631 ($6.77 in chips)
Seat 3: 45a89215 ($8.69 in chips)
Seat 4: e90b1294 ($5.87 in chips)
Seat 5: 35c42e8c ($7.45 in chips)
Seat 6: 71c02919 ($5 in chips)
1cc4b631: posts small blind $0.02
45a89215: posts big blind $0.05
*** HOLE CARDS ***
Dealt to Hero [4c Qh]
Dealt to 1cc4b631 
Dealt to 45a89215 
Dealt to e90b1294 
Dealt to 35c42e8c 
Dealt to 71c02919 
e90b1294: raises $0.06 to $0.11
35c42e8c: folds
71c02919: folds
Hero: folds
1cc4b631: folds
45a89215: folds
Uncalled bet ($0.06) returned to e90b1294
*** SHOWDOWN ***
e90b1294 collected $0.12 from pot
*** SUMMARY ***
Total pot $0.12 | Rake $0 | Jackpot $0 | Bingo $0 | Fortune $0 | Tax $0
Seat 1: Hero (button) folded before Flop (didn't bet)
Seat 2: 1cc4b631 (small blind) folded before Flop
Seat 3: 45a89215 (big blind) folded before Flop
Seat 4: e90b1294 collected ($0.12)
Seat 5: 35c42e8c folded before Flop (didn't bet)
Seat 6: 71c02919 folded before Flop (didn't bet)


Poker Hand #RC3795929028: Hold'em No Limit ($0.02/$0.05) - 2025/08/10 08:18:55
Table 'RushAndCash11064288' 6-max Seat #1 is the button
Seat 1: be93df25 ($5.12 in chips)
Seat 2: 1eef3559 ($8.83 in chips)
Seat 3: Hero ($4.98 in chips)
Seat 4: 39ec7bc7 ($5.35 in chips)
Seat 5: 45a89215 ($9.53 in chips)
Seat 6: 6a3842ba ($5.09 in chips)
1eef3559: posts small blind $0.02
Hero: posts big blind $0.05
*** HOLE CARDS ***
Dealt to be93df25 
Dealt to 1eef3559 
Dealt to Hero [Kh Kd]
Dealt to 39ec7bc7 
Dealt to 45a89215 
Dealt to 6a3842ba 
39ec7bc7: folds
45a89215: raises $0.07 to $0.12
6a3842ba: raises $0.08 to $0.2
be93df25: folds
1eef3559: folds
Hero: raises $0.64 to $0.84
45a89215: calls $0.72
6a3842ba: folds
*** FLOP *** [Ks As 2d]
Hero: bets $0.54
45a89215: folds
Uncalled bet ($0.54) returned to Hero
*** SHOWDOWN ***
Hero collected $1.74 from pot
*** SUMMARY ***
Total pot $1.9 | Rake $0.09 | Jackpot $0.07 | Bingo $0 | Fortune $0 | Tax $0
Board [Ks As 2d]
Seat 1: be93df25 (button) folded before Flop (didn't bet)
Seat 2: 1eef3559 (small blind) folded before Flop
Seat 3: Hero (big blind) won ($1.74)
Seat 4: 39ec7bc7 folded before Flop (didn't bet)
Seat 5: 45a89215 folded on the Flop
Seat 6: 6a3842ba folded before Flop


Poker Hand #RC3795929011: Hold'em No Limit ($0.02/$0.05) - 2025/08/10 08:18:50
Table 'RushAndCash11064271' 6-max Seat #1 is the button
Seat 1: 2b5a7a1b ($11.35 in chips)
Seat 2: Hero ($3.23 in chips)
Seat 3: 9999c04f ($4.53 in chips)
Seat 4: 6ac064ee ($6.75 in chips)
Seat 5: 71c02919 ($4.86 in chips)
Seat 6: c74f6781 ($7.23 in chips)
Hero: posts small blind $0.02
9999c04f: posts big blind $0.05
*** HOLE CARDS ***
Dealt to 2b5a7a1b 
Dealt to Hero [Js 4d]
Dealt to 9999c04f 
Dealt to 6ac064ee 
Dealt to 71c02919 
Dealt to c74f6781 
6ac064ee: folds
71c02919: folds
c74f6781: folds
2b5a7a1b: raises $0.06 to $0.11
Hero: folds
9999c04f: raises $0.24 to $0.35
2b5a7a1b: folds
Uncalled bet ($0.24) returned to 9999c04f
*** SHOWDOWN ***
9999c04f collected $0.23 from pot
*** SUMMARY ***
Total pot $0.24 | Rake $0.01 | Jackpot $0 | Bingo $0 | Fortune $0 | Tax $0
Seat 1: 2b5a7a1b (button) folded before Flop
Seat 2: Hero (small blind) folded before Flop
Seat 3: 9999c04f (big blind) collected ($0.23)
Seat 4: 6ac064ee folded before Flop (didn't bet)
Seat 5: 71c02919 folded before Flop (didn't bet)
Seat 6: c74f6781 folded before Flop (didn't bet)


Poker Hand #RC3795928999: Hold'em No Limit ($0.02/$0.05) - 2025/08/10 08:18:46
Table 'RushAndCash11064259' 6-max Seat #1 is the button
Seat 1: dca1c3af ($7.18 in chips)
Seat 2: bc8475a8 ($7.64 in chips)
Seat 3: d1364679 ($6.12 in chips)
Seat 4: 9999c04f ($4.53 in chips)
Seat 5: b1b3930a ($5.12 in chips)
Seat 6: Hero ($3.23 in chips)
bc8475a8: posts small blind $0.02
d1364679: posts big blind $0.05
*** HOLE CARDS ***
Dealt to dca1c3af 
Dealt to bc8475a8 
Dealt to d1364679 
Dealt to 9999c04f 
Dealt to b1b3930a 
Dealt to Hero [9s 5s]
9999c04f: folds
b1b3930a: folds
Hero: folds
dca1c3af: folds
bc8475a8: raises $0.07 to $0.12
d1364679: calls $0.07
*** FLOP *** [6s 9d 2h]
bc8475a8: bets $0.12
d1364679: calls $0.12
*** TURN *** [6s 9d 2h] [6h]
bc8475a8: checks
d1364679: bets $0.39
bc8475a8: calls $0.39
*** RIVER *** [6s 9d 2h 6h] [3h]
bc8475a8: checks
d1364679: checks
bc8475a8: shows [9h Ts] (two pair, Nines and Sixes)
d1364679: shows [Qc Tc] (a pair of Sixes)
*** SHOWDOWN ***
bc8475a8 collected $1.2 from pot
*** SUMMARY ***
Total pot $1.26 | Rake $0.06 | Jackpot $0 | Bingo $0 | Fortune $0 | Tax $0
Board [6s 9d 2h 6h 3h]
Seat 1: dca1c3af (button) folded before Flop (didn't bet)
Seat 2: bc8475a8 (small blind) showed [9h Ts] and won ($1.2) with two pair, Nines and Sixes
Seat 3: d1364679 (big blind) showed [Qc Tc] and lost with a pair of Sixes
Seat 4: 9999c04f folded before Flop (didn't bet)
Seat 5: b1b3930a folded before Flop (didn't bet)
Seat 6: Hero folded before Flop (didn't bet)


Poker Hand #RC3795928711: Hold'em No Limit ($0.02/$0.05) - 2025/08/10 08:17:17
Table 'RushAndCash11063971' 6-max Seat #1 is the button
Seat 1: 7c3a91fe ($7.17 in chips)
Seat 2: 59da8582 ($11.34 in chips)
Seat 3: 210c8e9b ($12.78 in chips)
Seat 4: e533c044 ($5.07 in chips)
Seat 5: Hero ($6.86 in chips)
Seat 6: dca1c3af ($3.63 in chips)
59da8582: posts small blind $0.02
210c8e9b: posts big blind $0.05
*** HOLE CARDS ***
Dealt to 7c3a91fe 
Dealt to 59da8582 
Dealt to 210c8e9b 
Dealt to e533c044 
Dealt to Hero [4h Ah]
Dealt to dca1c3af 
e533c044: folds
Hero: raises $0.07 to $0.12
dca1c3af: calls $0.12
7c3a91fe: folds
59da8582: folds
210c8e9b: folds
*** FLOP *** [2d 9s Th]
Hero: checks
dca1c3af: bets $0.23
Hero: calls $0.23
*** TURN *** [2d 9s Th] [7h]
Hero: checks
dca1c3af: bets $0.51
Hero: calls $0.51
*** RIVER *** [2d 9s Th 7h] [9h]
Hero: checks
dca1c3af: bets $1.79
Hero: raises $4.21 to $6 and is all-in
dca1c3af: calls $0.98 and is all-in
Uncalled bet ($3.23) returned to Hero
Hero: shows [4h Ah] (a flush Ace high)
dca1c3af: shows [2h 2c] (a full house, Twos full of Nines)
*** SHOWDOWN ***
dca1c3af collected $7.11 from pot
*** SUMMARY ***
Total pot $7.33 | Rake $0.15 | Jackpot $0.07 | Bingo $0 | Fortune $0 | Tax $0
Board [2d 9s Th 7h 9h]
Seat 1: 7c3a91fe (button) folded before Flop (didn't bet)
Seat 2: 59da8582 (small blind) folded before Flop
Seat 3: 210c8e9b (big blind) folded before Flop
Seat 4: e533c044 folded before Flop (didn't bet)
Seat 5: Hero showed [4h Ah] and lost with a flush Ace high
Seat 6: dca1c3af showed [2h 2c] and won ($7.11) with a full house, Twos full of Nines


Poker Hand #RC3795928693: Hold'em No Limit ($0.02/$0.05) - 2025/08/10 08:17:11
Table 'RushAndCash11063953' 6-max Seat #1 is the button
Seat 1: 63f3fdb ($5 in chips)
Seat 2: 827e3595 ($8.25 in chips)
Seat 3: 2fd706a9 ($12.59 in chips)
Seat 4: 665d5285 ($9.77 in chips)
Seat 5: 83bc5fa2 ($6.27 in chips)
Seat 6: Hero ($6.86 in chips)
827e3595: posts small blind $0.02
2fd706a9: posts big blind $0.05
*** HOLE CARDS ***
Dealt to 63f3fdb 
Dealt to 827e3595 
Dealt to 2fd706a9 
Dealt to 665d5285 
Dealt to 83bc5fa2 
Dealt to Hero [9d Jc]
665d5285: folds
83bc5fa2: folds
Hero: folds
63f3fdb: raises $0.07 to $0.12
827e3595: raises $0.3 to $0.42
2fd706a9: folds
63f3fdb: folds
Uncalled bet ($0.3) returned to 827e3595
*** SHOWDOWN ***
827e3595 collected $0.28 from pot
*** SUMMARY ***
Total pot $0.29 | Rake $0.01 | Jackpot $0 | Bingo $0 | Fortune $0 | Tax $0
Seat 1: 63f3fdb (button) folded before Flop
Seat 2: 827e3595 (small blind) collected ($0.28)
Seat 3: 2fd706a9 (big blind) folded before Flop
Seat 4: 665d5285 folded before Flop (didn't bet)
Seat 5: 83bc5fa2 folded before Flop (didn't bet)
Seat 6: Hero folded before Flop (didn't bet)


Poker Hand #RC3795928667: Hold'em No Limit ($0.02/$0.05) - 2025/08/10 08:17:02
Table 'RushAndCash11063927' 6-max Seat #1 is the button
Seat 1: c6b4a39c ($5.55 in chips)
Seat 2: Hero ($6.88 in chips)
Seat 3: f6c47f47 ($3.63 in chips)
Seat 4: 9fd1d64c ($6.29 in chips)
Seat 5: fa76288b ($5.06 in chips)
Seat 6: db22ee6f ($6.68 in chips)
Hero: posts small blind $0.02
f6c47f47: posts big blind $0.05
*** HOLE CARDS ***
Dealt to c6b4a39c 
Dealt to Hero [Jc Th]
Dealt to f6c47f47 
Dealt to 9fd1d64c 
Dealt to fa76288b 
Dealt to db22ee6f 
9fd1d64c: folds
fa76288b: folds
db22ee6f: raises $0.08 to $0.13
c6b4a39c: folds
Hero: folds
f6c47f47: folds
Uncalled bet ($0.08) returned to db22ee6f
*** SHOWDOWN ***
db22ee6f collected $0.12 from pot
*** SUMMARY ***
Total pot $0.12 | Rake $0 | Jackpot $0 | Bingo $0 | Fortune $0 | Tax $0
Seat 1: c6b4a39c (button) folded before Flop (didn't bet)
Seat 2: Hero (small blind) folded before Flop
Seat 3: f6c47f47 (big blind) folded before Flop
Seat 4: 9fd1d64c folded before Flop (didn't bet)
Seat 5: fa76288b folded before Flop (didn't bet)
Seat 6: db22ee6f collected ($0.12)


Poker Hand #RC3795928631: Hold'em No Limit ($0.02/$0.05) - 2025/08/10 08:16:50
Table 'RushAndCash11063891' 6-max Seat #1 is the button
Seat 1: Hero ($6.88 in chips)
Seat 2: 9b73cb59 ($7.87 in chips)
Seat 3: f6bf8dfb ($5.74 in chips)
Seat 4: 8b390e1e ($5.34 in chips)
Seat 5: 6ac064ee ($7.52 in chips)
Seat 6: 9999c04f ($3.8 in chips)
9b73cb59: posts small blind $0.02
f6bf8dfb: posts big blind $0.05
*** HOLE CARDS ***
Dealt to Hero [4d 7h]
Dealt to 9b73cb59 
Dealt to f6bf8dfb 
Dealt to 8b390e1e 
Dealt to 6ac064ee 
Dealt to 9999c04f 
8b390e1e: folds
6ac064ee: folds
9999c04f: folds
Hero: folds
9b73cb59: raises $0.1 to $0.15
f6bf8dfb: folds
Uncalled bet ($0.1) returned to 9b73cb59
*** SHOWDOWN ***
9b73cb59 collected $0.1 from pot
*** SUMMARY ***
Total pot $0.1 | Rake $0 | Jackpot $0 | Bingo $0 | Fortune $0 | Tax $0
Seat 1: Hero (button) folded before Flop (didn't bet)
Seat 2: 9b73cb59 (small blind) collected ($0.1)
Seat 3: f6bf8dfb (big blind) folded before Flop
Seat 4: 8b390e1e folded before Flop (didn't bet)
Seat 5: 6ac064ee folded before Flop (didn't bet)
Seat 6: 9999c04f folded before Flop (didn't bet)


Poker Hand #RC3795928606: Hold'em No Limit ($0.02/$0.05) - 2025/08/10 08:16:42
Table 'RushAndCash11063866' 6-max Seat #1 is the button
Seat 1: 5d71c963 ($8.96 in chips)
Seat 2: 5b54e251 ($11.64 in chips)
Seat 3: Hero ($6.93 in chips)
Seat 4: f3a1d090 ($24.07 in chips)
Seat 5: a57b331d ($24.17 in chips)
Seat 6: 1cc4b631 ($6.22 in chips)
5b54e251: posts small blind $0.02
Hero: posts big blind $0.05
*** HOLE CARDS ***
Dealt to 5d71c963 
Dealt to 5b54e251 
Dealt to Hero [6s 3s]
Dealt to f3a1d090 
Dealt to a57b331d 
Dealt to 1cc4b631 
f3a1d090: folds
a57b331d: raises $0.07 to $0.12
1cc4b631: folds
5d71c963: folds
5b54e251: folds
Hero: folds
Uncalled bet ($0.07) returned to a57b331d
*** SHOWDOWN ***
a57b331d collected $0.12 from pot
*** SUMMARY ***
Total pot $0.12 | Rake $0 | Jackpot $0 | Bingo $0 | Fortune $0 | Tax $0
Seat 1: 5d71c963 (button) folded before Flop (didn't bet)
Seat 2: 5b54e251 (small blind) folded before Flop
Seat 3: Hero (big blind) folded before Flop
Seat 4: f3a1d090 folded before Flop (didn't bet)
Seat 5: a57b331d collected ($0.12)
Seat 6: 1cc4b631 folded before Flop (didn't bet)


Poker Hand #RC3795928594: Hold'em No Limit ($0.02/$0.05) - 2025/08/10 08:16:38
Table 'RushAndCash11063854' 6-max Seat #1 is the button
Seat 1: cef92baa ($6.15 in chips)
Seat 2: 808de8ec ($1.79 in chips)
Seat 3: 84a6e006 ($11.91 in chips)
Seat 4: c6b4a39c ($5.5 in chips)
Seat 5: Hero ($6.93 in chips)
Seat 6: dde92c84 ($13.79 in chips)
808de8ec: posts small blind $0.02
84a6e006: posts big blind $0.05
*** HOLE CARDS ***
Dealt to cef92baa 
Dealt to 808de8ec 
Dealt to 84a6e006 
Dealt to c6b4a39c 
Dealt to Hero [Jh 7c]
Dealt to dde92c84 
c6b4a39c: folds
Hero: folds
dde92c84: folds
cef92baa: raises $0.06 to $0.11
808de8ec: folds
84a6e006: folds
Uncalled bet ($0.06) returned to cef92baa
*** SHOWDOWN ***
cef92baa collected $0.12 from pot
*** SUMMARY ***
Total pot $0.12 | Rake $0 | Jackpot $0 | Bingo $0 | Fortune $0 | Tax $0
Seat 1: cef92baa (button) collected ($0.12)
Seat 2: 808de8ec (small blind) folded before Flop
Seat 3: 84a6e006 (big blind) folded before Flop
Seat 4: c6b4a39c folded before Flop (didn't bet)
Seat 5: Hero folded before Flop (didn't bet)
Seat 6: dde92c84 folded before Flop (didn't bet)


Poker Hand #RC3795928579: Hold'em No Limit ($0.02/$0.05) - 2025/08/10 08:16:34
Table 'RushAndCash11063839' 6-max Seat #1 is the button
Seat 1: f009f5ba ($5 in chips)
Seat 2: 402f5d1a ($7.41 in chips)
Seat 3: 85e4ce3a ($15.67 in chips)
Seat 4: 2443981e ($4 in chips)
Seat 5: Hero ($6.93 in chips)
Seat 6: 6dc54533 ($39.44 in chips)
402f5d1a: posts small blind $0.02
85e4ce3a: posts big blind $0.05
*** HOLE CARDS ***
Dealt to f009f5ba 
Dealt to 402f5d1a 
Dealt to 85e4ce3a 
Dealt to 2443981e 
Dealt to Hero [Ad 9h]
Dealt to 6dc54533 
2443981e: calls $0.05
Hero: folds
6dc54533: raises $0.2 to $0.25
f009f5ba: folds
402f5d1a: calls $0.23
85e4ce3a: folds
2443981e: calls $0.2
*** FLOP *** [Tc 7s Jh]
402f5d1a: checks
2443981e: checks
6dc54533: checks
*** TURN *** [Tc 7s Jh] [Kc]
402f5d1a: checks
2443981e: bets $0.32
6dc54533: calls $0.32
402f5d1a: folds
*** RIVER *** [Tc 7s Jh Kc] [Js]
2443981e: checks
6dc54533: checks
2443981e: shows [5c 2c] (a pair of Jacks)
6dc54533: shows [Ah Ks] (two pair, Kings and Jacks)
*** SHOWDOWN ***
6dc54533 collected $1.37 from pot
*** SUMMARY ***
Total pot $1.44 | Rake $0.07 | Jackpot $0 | Bingo $0 | Fortune $0 | Tax $0
Board [Tc 7s Jh Kc Js]
Seat 1: f009f5ba (button) folded before Flop (didn't bet)
Seat 2: 402f5d1a (small blind) folded on the Turn
Seat 3: 85e4ce3a (big blind) folded before Flop
Seat 4: 2443981e showed [5c 2c] and lost with a pair of Jacks
Seat 5: Hero folded before Flop (didn't bet)
Seat 6: 6dc54533 showed [Ah Ks] and won ($1.37) with two pair, Kings and Jacks


Poker Hand #RC3795928558: Hold'em No Limit ($0.02/$0.05) - 2025/08/10 08:16:26
Table 'RushAndCash11063818' 6-max Seat #1 is the button
Seat 1: Hero ($6.93 in chips)
Seat 2: ba3893c4 ($5.21 in chips)
Seat 3: d1364679 ($6.1 in chips)
Seat 4: 279a8e9f ($5.14 in chips)
Seat 5: 12269029 ($5.76 in chips)
Seat 6: 115a6213 ($5.33 in chips)
ba3893c4: posts small blind $0.02
d1364679: posts big blind $0.05
*** HOLE CARDS ***
Dealt to Hero [9c 3d]
Dealt to ba3893c4 
Dealt to d1364679 
Dealt to 279a8e9f 
Dealt to 12269029 
Dealt to 115a6213 
279a8e9f: folds
12269029: folds
115a6213: folds
Hero: folds
ba3893c4: folds
Uncalled bet ($0.03) returned to d1364679
*** SHOWDOWN ***
d1364679 collected $0.04 from pot
*** SUMMARY ***
Total pot $0.04 | Rake $0 | Jackpot $0 | Bingo $0 | Fortune $0 | Tax $0
Seat 1: Hero (button) folded before Flop (didn't bet)
Seat 2: ba3893c4 (small blind) folded before Flop
Seat 3: d1364679 (big blind) collected ($0.04)
Seat 4: 279a8e9f folded before Flop (didn't bet)
Seat 5: 12269029 folded before Flop (didn't bet)
Seat 6: 115a6213 folded before Flop (didn't bet)


Poker Hand #RC3795928367: Hold'em No Limit ($0.02/$0.05) - 2025/08/10 08:15:27
Table 'RushAndCash11063627' 6-max Seat #1 is the button
Seat 1: 115a6213 ($5.46 in chips)
Seat 2: Hero ($7.58 in chips)
Seat 3: 7ba62247 ($16.64 in chips)
Seat 4: 12269029 ($5 in chips)
Seat 5: 2319781 ($13.54 in chips)
Seat 6: 5f0e6d7 ($4.96 in chips)
Hero: posts small blind $0.02
7ba62247: posts big blind $0.05
*** HOLE CARDS ***
Dealt to 115a6213 
Dealt to Hero [5h Ah]
Dealt to 7ba62247 
Dealt to 12269029 
Dealt to 2319781 
Dealt to 5f0e6d7 
12269029: raises $0.08 to $0.13
2319781: folds
5f0e6d7: folds
115a6213: calls $0.13
Hero: calls $0.11
7ba62247: folds
*** FLOP *** [7d Ad 6h]
Hero: checks
12269029: bets $0.25
115a6213: folds
Hero: calls $0.25
*** TURN *** [7d Ad 6h] [2s]
Hero: bets $0.27
12269029: calls $0.27
*** RIVER *** [7d Ad 6h 2s] [Kc]
Hero: checks
12269029: checks
Hero: shows [5h Ah] (a pair of Aces)
12269029: shows [Qh Ac] (a pair of Aces)
*** SHOWDOWN ***
12269029 collected $1.41 from pot
*** SUMMARY ***
Total pot $1.48 | Rake $0.07 | Jackpot $0 | Bingo $0 | Fortune $0 | Tax $0
Board [7d Ad 6h 2s Kc]
Seat 1: 115a6213 (button) folded on the Flop
Seat 2: Hero (small blind) showed [5h Ah] and lost with a pair of Aces
Seat 3: 7ba62247 (big blind) folded before Flop
Seat 4: 12269029 showed [Qh Ac] and won ($1.41) with a pair of Aces
Seat 5: 2319781 folded before Flop (didn't bet)
Seat 6: 5f0e6d7 folded before Flop (didn't bet)


Poker Hand #RC3795928340: Hold'em No Limit ($0.02/$0.05) - 2025/08/10 08:15:17
Table 'RushAndCash11063600' 6-max Seat #1 is the button
Seat 1: 2b5a7a1b ($11.11 in chips)
Seat 2: ba3893c4 ($5.28 in chips)
Seat 3: Hero ($7.63 in chips)
Seat 4: c994efb3 ($5 in chips)
Seat 5: 6412bd28 ($4.35 in chips)
Seat 6: 43f64b9b ($5.39 in chips)
ba3893c4: posts small blind $0.02
Hero: posts big blind $0.05
*** HOLE CARDS ***
Dealt to 2b5a7a1b 
Dealt to ba3893c4 
Dealt to Hero [6c 3s]
Dealt to c994efb3 
Dealt to 6412bd28 
Dealt to 43f64b9b 
c994efb3: raises $0.06 to $0.11
6412bd28: folds
43f64b9b: folds
2b5a7a1b: folds
ba3893c4: folds
Hero: folds
Uncalled bet ($0.06) returned to c994efb3
*** SHOWDOWN ***
c994efb3 collected $0.12 from pot
*** SUMMARY ***
Total pot $0.12 | Rake $0 | Jackpot $0 | Bingo $0 | Fortune $0 | Tax $0
Seat 1: 2b5a7a1b (button) folded before Flop (didn't bet)
Seat 2: ba3893c4 (small blind) folded before Flop
Seat 3: Hero (big blind) folded before Flop
Seat 4: c994efb3 collected ($0.12)
Seat 5: 6412bd28 folded before Flop (didn't bet)
Seat 6: 43f64b9b folded before Flop (didn't bet)


Poker Hand #RC3795928328: Hold'em No Limit ($0.02/$0.05) - 2025/08/10 08:15:14
Table 'RushAndCash11063588' 6-max Seat #1 is the button
Seat 1: c74f6781 ($6.67 in chips)
Seat 2: 8afb6429 ($5.94 in chips)
Seat 3: 39ec7bc7 ($5.36 in chips)
Seat 4: 69e805cf ($15.77 in chips)
Seat 5: Hero ($7.63 in chips)
Seat 6: b24cb5d8 ($10.02 in chips)
8afb6429: posts small blind $0.02
39ec7bc7: posts big blind $0.05
*** HOLE CARDS ***
Dealt to c74f6781 
Dealt to 8afb6429 
Dealt to 39ec7bc7 
Dealt to 69e805cf 
Dealt to Hero [2h 8d]
Dealt to b24cb5d8 
69e805cf: folds
Hero: folds
b24cb5d8: raises $0.09 to $0.14
c74f6781: folds
8afb6429: calls $0.12
39ec7bc7: calls $0.09
*** FLOP *** [3h 3d Kc]
8afb6429: checks
39ec7bc7: checks
b24cb5d8: bets $0.31
8afb6429: calls $0.31
39ec7bc7: folds
*** TURN *** [3h 3d Kc] [Ah]
8afb6429: checks
b24cb5d8: checks
*** RIVER *** [3h 3d Kc Ah] [As]
8afb6429: checks
b24cb5d8: checks
8afb6429: shows [Kd Ts] (two pair, Aces and Kings)
b24cb5d8: shows [6d 6h] (two pair, Aces and Sixes)
*** SHOWDOWN ***
8afb6429 collected $0.99 from pot
*** SUMMARY ***
Total pot $1.04 | Rake $0.05 | Jackpot $0 | Bingo $0 | Fortune $0 | Tax $0
Board [3h 3d Kc Ah As]
Seat 1: c74f6781 (button) folded before Flop (didn't bet)
Seat 2: 8afb6429 (small blind) showed [Kd Ts] and won ($0.99) with two pair, Aces and Kings
Seat 3: 39ec7bc7 (big blind) folded on the Flop
Seat 4: 69e805cf folded before Flop (didn't bet)
Seat 5: Hero folded before Flop (didn't bet)
Seat 6: b24cb5d8 showed [6d 6h] and lost with two pair, Aces and Sixes


Poker Hand #RC3795928314: Hold'em No Limit ($0.02/$0.05) - 2025/08/10 08:15:10
Table 'RushAndCash11063574' 6-max Seat #1 is the button
Seat 1: 8d67d790 ($11.19 in chips)
Seat 2: 9fce4835 ($6.38 in chips)
Seat 3: 72e119cc ($5 in chips)
Seat 4: bc911417 ($5 in chips)
Seat 5: bc8475a8 ($7.65 in chips)
Seat 6: Hero ($7.63 in chips)
9fce4835: posts small blind $0.02
72e119cc: posts big blind $0.05
*** HOLE CARDS ***
Dealt to 8d67d790 
Dealt to 9fce4835 
Dealt to 72e119cc 
Dealt to bc911417 
Dealt to bc8475a8 
Dealt to Hero [Td 9s]
bc911417: raises $0.05 to $0.1
bc8475a8: folds
Hero: folds
8d67d790: folds
9fce4835: calls $0.08
72e119cc: folds
*** FLOP *** [2h Jc 7d]
9fce4835: checks
bc911417: bets $0.05
9fce4835: raises $0.05 to $0.1
bc911417: folds
Uncalled bet ($0.05) returned to 9fce4835
*** SHOWDOWN ***
9fce4835 collected $0.34 from pot
*** SUMMARY ***
Total pot $0.35 | Rake $0.01 | Jackpot $0 | Bingo $0 | Fortune $0 | Tax $0
Board [2h Jc 7d]
Seat 1: 8d67d790 (button) folded before Flop (didn't bet)
Seat 2: 9fce4835 (small blind) won ($0.34)
Seat 3: 72e119cc (big blind) folded before Flop
Seat 4: bc911417 folded on the Flop
Seat 5: bc8475a8 folded before Flop (didn't bet)
Seat 6: Hero folded before Flop (didn't bet)


Poker Hand #RC3795928303: Hold'em No Limit ($0.02/$0.05) - 2025/08/10 08:15:06
Table 'RushAndCash11063563' 6-max Seat #1 is the button
Seat 1: 115a6213 ($5.46 in chips)
Seat 2: c506571 ($5 in chips)
Seat 3: 3f382755 ($6.33 in chips)
Seat 4: 18ca1e6b ($9.15 in chips)
Seat 5: Hero ($7.63 in chips)
Seat 6: 2a878e55 ($5.7 in chips)
c506571: posts small blind $0.02
3f382755: posts big blind $0.05
*** HOLE CARDS ***
Dealt to 115a6213 
Dealt to c506571 
Dealt to 3f382755 
Dealt to 18ca1e6b 
Dealt to Hero [8h 6c]
Dealt to 2a878e55 
18ca1e6b: folds
Hero: folds
2a878e55: folds
115a6213: folds
c506571: folds
Uncalled bet ($0.03) returned to 3f382755
*** SHOWDOWN ***
3f382755 collected $0.04 from pot
*** SUMMARY ***
Total pot $0.04 | Rake $0 | Jackpot $0 | Bingo $0 | Fortune $0 | Tax $0
Seat 1: 115a6213 (button) folded before Flop (didn't bet)
Seat 2: c506571 (small blind) folded before Flop
Seat 3: 3f382755 (big blind) collected ($0.04)
Seat 4: 18ca1e6b folded before Flop (didn't bet)
Seat 5: Hero folded before Flop (didn't bet)
Seat 6: 2a878e55 folded before Flop (didn't bet)


Poker Hand #RC3795928292: Hold'em No Limit ($0.02/$0.05) - 2025/08/10 08:15:02
Table 'RushAndCash11063552' 6-max Seat #1 is the button
Seat 1: ac25def9 ($6.83 in chips)
Seat 2: 79ab917c ($6.19 in chips)
Seat 3: 63f3fdb ($5.26 in chips)
Seat 4: 7a953fd0 ($5 in chips)
Seat 5: 68db1858 ($3.05 in chips)
Seat 6: Hero ($7.63 in chips)
79ab917c: posts small blind $0.02
63f3fdb: posts big blind $0.05
*** HOLE CARDS ***
Dealt to ac25def9 
Dealt to 79ab917c 
Dealt to 63f3fdb 
Dealt to 7a953fd0 
Dealt to 68db1858 
Dealt to Hero [Kh 8c]
7a953fd0: raises $0.1 to $0.15
68db1858: calls $0.15
Hero: folds
ac25def9: folds
79ab917c: folds
63f3fdb: folds
*** FLOP *** [8d 3s Ks]
7a953fd0: bets $0.19
68db1858: folds
Uncalled bet ($0.19) returned to 7a953fd0
*** SHOWDOWN ***
7a953fd0 collected $0.36 from pot
*** SUMMARY ***
Total pot $0.37 | Rake $0.01 | Jackpot $0 | Bingo $0 | Fortune $0 | Tax $0
Board [8d 3s Ks]
Seat 1: ac25def9 (button) folded before Flop (didn't bet)
Seat 2: 79ab917c (small blind) folded before Flop
Seat 3: 63f3fdb (big blind) folded before Flop
Seat 4: 7a953fd0 won ($0.36)
Seat 5: 68db1858 folded on the Flop
Seat 6: Hero folded before Flop (didn't bet)


Poker Hand #RC3795928155: Hold'em No Limit ($0.02/$0.05) - 2025/08/10 08:14:19
Table 'RushAndCash11063415' 6-max Seat #1 is the button
Seat 1: Hero ($8.15 in chips)
Seat 2: 84a6e006 ($11.75 in chips)
Seat 3: e39c6e6a ($5.5 in chips)
Seat 4: 79ab917c ($5.65 in chips)
Seat 5: 8b390e1e ($5.37 in chips)
Seat 6: 41ed372d ($6.18 in chips)
84a6e006: posts small blind $0.02
e39c6e6a: posts big blind $0.05
*** HOLE CARDS ***
Dealt to Hero [Qc 9c]
Dealt to 84a6e006 
Dealt to e39c6e6a 
Dealt to 79ab917c 
Dealt to 8b390e1e 
Dealt to 41ed372d 
79ab917c: raises $0.05 to $0.1
8b390e1e: folds
41ed372d: folds
Hero: calls $0.1
84a6e006: folds
e39c6e6a: folds
*** FLOP *** [2c 9d Js]
79ab917c: bets $0.14
Hero: calls $0.14
*** TURN *** [2c 9d Js] [2d]
79ab917c: bets $0.28
Hero: calls $0.28
*** RIVER *** [2c 9d Js 2d] [Th]
79ab917c: checks
Hero: checks
79ab917c: shows [Td Qs] (two pair, Tens and Twos)
Hero: shows [Qc 9c] (two pair, Nines and Twos)
*** SHOWDOWN ***
79ab917c collected $1.06 from pot
*** SUMMARY ***
Total pot $1.11 | Rake $0.05 | Jackpot $0 | Bingo $0 | Fortune $0 | Tax $0
Board [2c 9d Js 2d Th]
Seat 1: Hero (button) showed [Qc 9c] and lost with two pair, Nines and Twos
Seat 2: 84a6e006 (small blind) folded before Flop
Seat 3: e39c6e6a (big blind) folded before Flop
Seat 4: 79ab917c showed [Td Qs] and won ($1.06) with two pair, Tens and Twos
Seat 5: 8b390e1e folded before Flop (didn't bet)
Seat 6: 41ed372d folded before Flop (didn't bet)


Poker Hand #RC3795928123: Hold'em No Limit ($0.02/$0.05) - 2025/08/10 08:14:08
Table 'RushAndCash11063383' 6-max Seat #1 is the button
Seat 1: 4844e57f ($9.12 in chips)
Seat 2: 391d0c67 ($5.17 in chips)
Seat 3: Hero ($8.13 in chips)
Seat 4: f009f5ba ($5.14 in chips)
Seat 5: 483f17c3 ($15.69 in chips)
Seat 6: d796f1b5 ($14.49 in chips)
391d0c67: posts small blind $0.02
Hero: posts big blind $0.05
*** HOLE CARDS ***
Dealt to 4844e57f 
Dealt to 391d0c67 
Dealt to Hero [7d 4d]
Dealt to f009f5ba 
Dealt to 483f17c3 
Dealt to d796f1b5 
f009f5ba: folds
483f17c3: folds
d796f1b5: folds
4844e57f: folds
391d0c67: folds
Uncalled bet ($0.03) returned to Hero
*** SHOWDOWN ***
Hero collected $0.04 from pot
*** SUMMARY ***
Total pot $0.04 | Rake $0 | Jackpot $0 | Bingo $0 | Fortune $0 | Tax $0
Seat 1: 4844e57f (button) folded before Flop (didn't bet)
Seat 2: 391d0c67 (small blind) folded before Flop
Seat 3: Hero (big blind) collected ($0.04)
Seat 4: f009f5ba folded before Flop (didn't bet)
Seat 5: 483f17c3 folded before Flop (didn't bet)
Seat 6: d796f1b5 folded before Flop (didn't bet)


Poker Hand #RC3795928069: Hold'em No Limit ($0.02/$0.05) - 2025/08/10 08:13:50
Table 'RushAndCash11063329' 6-max Seat #1 is the button
Seat 1: 7ba62247 ($17.35 in chips)
Seat 2: Hero ($8.15 in chips)
Seat 3: d6378e6 ($7.17 in chips)
Seat 4: 2b56ac20 ($14.49 in chips)
Seat 5: 38df6650 ($5 in chips)
Seat 6: 1f81ea21 ($2.85 in chips)
Hero: posts small blind $0.02
d6378e6: posts big blind $0.05
*** HOLE CARDS ***
Dealt to 7ba62247 
Dealt to Hero [2s Kc]
Dealt to d6378e6 
Dealt to 2b56ac20 
Dealt to 38df6650 
Dealt to 1f81ea21 
2b56ac20: raises $0.07 to $0.12
38df6650: folds
1f81ea21: folds
7ba62247: folds
Hero: folds
d6378e6: calls $0.07
*** FLOP *** [9s 6h Qh]
d6378e6: checks
2b56ac20: checks
*** TURN *** [9s 6h Qh] [Th]
d6378e6: bets $0.2
2b56ac20: raises $0.5 to $0.7
d6378e6: folds
Uncalled bet ($0.5) returned to 2b56ac20
*** SHOWDOWN ***
2b56ac20 collected $0.63 from pot
*** SUMMARY ***
Total pot $0.66 | Rake $0.03 | Jackpot $0 | Bingo $0 | Fortune $0 | Tax $0
Board [9s 6h Qh Th]
Seat 1: 7ba62247 (button) folded before Flop (didn't bet)
Seat 2: Hero (small blind) folded before Flop
Seat 3: d6378e6 (big blind) folded on the Turn
Seat 4: 2b56ac20 won ($0.63)
Seat 5: 38df6650 folded before Flop (didn't bet)
Seat 6: 1f81ea21 folded before Flop (didn't bet)


Poker Hand #RC3795927756: Hold'em No Limit ($0.02/$0.05) - 2025/08/10 08:12:16
Table 'RushAndCash11063016' 6-max Seat #1 is the button
Seat 1: 3f382755 ($4.98 in chips)
Seat 2: 6bfc0170 ($5.07 in chips)
Seat 3: 5818efb5 ($7.51 in chips)
Seat 4: 65376f32 ($10.45 in chips)
Seat 5: Hero ($8.22 in chips)
Seat 6: 4328ce0 ($3.18 in chips)
6bfc0170: posts small blind $0.02
5818efb5: posts big blind $0.05
*** HOLE CARDS ***
Dealt to 3f382755 
Dealt to 6bfc0170 
Dealt to 5818efb5 
Dealt to 65376f32 
Dealt to Hero [Qh Kh]
Dealt to 4328ce0 
65376f32: folds
Hero: raises $0.05 to $0.1
4328ce0: raises $0.2 to $0.3
3f382755: folds
6bfc0170: folds
5818efb5: folds
Hero: calls $0.2
*** FIRST FLOP *** [Qd Ah Th]
Hero: checks
4328ce0: bets $0.23
Hero: raises $0.57 to $0.8
4328ce0: raises $2.08 to $2.88 and is all-in
Hero: calls $2.08
4328ce0: shows [As 5s] (a pair of Aces)
Hero: shows [Qh Kh] (a pair of Queens)
*** FIRST TURN *** [Qd Ah Th] [9s]
*** FIRST RIVER *** [Qd Ah Th 9s] [3h]
*** SECOND TURN *** [Qd Ah Th] [7d]
*** SECOND RIVER *** [Qd Ah Th 7d] [2d]
*** FIRST SHOWDOWN ***
Hero collected $3.11 from pot
*** SECOND SHOWDOWN ***
4328ce0 collected $3.11 from pot
*** SUMMARY ***
Total pot $6.43 | Rake $0.14 | Jackpot $0.07 | Bingo $0 | Fortune $0 | Tax $0
Hand was run two times
FIRST Board [Qd Ah Th 9s 3h]
SECOND Board [7d 2d]
Seat 1: 3f382755 (button) folded before Flop (didn't bet)
Seat 2: 6bfc0170 (small blind) folded before Flop
Seat 3: 5818efb5 (big blind) folded before Flop
Seat 4: 65376f32 folded before Flop (didn't bet)
Seat 5: Hero showed [Qh Kh] and won ($3.11) with a flush Ace high, and lost
Seat 6: 4328ce0 showed [As 5s] and lost with a pair of Aces, and won ($3.11)


Poker Hand #RC3795927741: Hold'em No Limit ($0.02/$0.05) - 2025/08/10 08:12:11
Table 'RushAndCash11063001' 6-max Seat #1 is the button
Seat 1: Hero ($8.22 in chips)
Seat 2: 5d71c963 ($9.25 in chips)
Seat 3: e7e9348c ($16.43 in chips)
Seat 4: 43f64b9b ($5.02 in chips)
Seat 5: 17b790ab ($5.14 in chips)
Seat 6: 32afa283 ($4.84 in chips)
5d71c963: posts small blind $0.02
e7e9348c: posts big blind $0.05
*** HOLE CARDS ***
Dealt to Hero [3s 7d]
Dealt to 5d71c963 
Dealt to e7e9348c 
Dealt to 43f64b9b 
Dealt to 17b790ab 
Dealt to 32afa283 
43f64b9b: folds
17b790ab: folds
32afa283: folds
Hero: folds
5d71c963: folds
Uncalled bet ($0.03) returned to e7e9348c
*** SHOWDOWN ***
e7e9348c collected $0.04 from pot
*** SUMMARY ***
Total pot $0.04 | Rake $0 | Jackpot $0 | Bingo $0 | Fortune $0 | Tax $0
Seat 1: Hero (button) folded before Flop (didn't bet)
Seat 2: 5d71c963 (small blind) folded before Flop
Seat 3: e7e9348c (big blind) collected ($0.04)
Seat 4: 43f64b9b folded before Flop (didn't bet)
Seat 5: 17b790ab folded before Flop (didn't bet)
Seat 6: 32afa283 folded before Flop (didn't bet)


Poker Hand #RC3795927724: Hold'em No Limit ($0.02/$0.05) - 2025/08/10 08:12:07
Table 'RushAndCash11062984' 6-max Seat #1 is the button
Seat 1: 18b1ecd7 ($5.17 in chips)
Seat 2: db3d7016 ($5.16 in chips)
Seat 3: a63176ef ($7.08 in chips)
Seat 4: 9fb5ba89 ($8.8 in chips)
Seat 5: Hero ($8.22 in chips)
Seat 6: d4249213 ($4.81 in chips)
db3d7016: posts small blind $0.02
a63176ef: posts big blind $0.05
*** HOLE CARDS ***
Dealt to 18b1ecd7 
Dealt to db3d7016 
Dealt to a63176ef 
Dealt to 9fb5ba89 
Dealt to Hero [8d Js]
Dealt to d4249213 
9fb5ba89: raises $0.05 to $0.1
Hero: folds
d4249213: folds
18b1ecd7: folds
db3d7016: folds
a63176ef: folds
Uncalled bet ($0.05) returned to 9fb5ba89
*** SHOWDOWN ***
9fb5ba89 collected $0.12 from pot
*** SUMMARY ***
Total pot $0.12 | Rake $0 | Jackpot $0 | Bingo $0 | Fortune $0 | Tax $0
Seat 1: 18b1ecd7 (button) folded before Flop (didn't bet)
Seat 2: db3d7016 (small blind) folded before Flop
Seat 3: a63176ef (big blind) folded before Flop
Seat 4: 9fb5ba89 collected ($0.12)
Seat 5: Hero folded before Flop (didn't bet)
Seat 6: d4249213 folded before Flop (didn't bet)


Poker Hand #RC3795927672: Hold'em No Limit ($0.02/$0.05) - 2025/08/10 08:11:54
Table 'RushAndCash11062932' 6-max Seat #1 is the button
Seat 1: 70573b8 ($5.43 in chips)
Seat 2: f2e3feac ($7.41 in chips)
Seat 3: Hero ($8.2 in chips)
Seat 4: 7f40418 ($5.57 in chips)
Seat 5: 2b5a7a1b ($8.65 in chips)
Seat 6: 2d1b3dec ($6.24 in chips)
f2e3feac: posts small blind $0.02
Hero: posts big blind $0.05
*** HOLE CARDS ***
Dealt to 70573b8 
Dealt to f2e3feac 
Dealt to Hero [5d 2d]
Dealt to 7f40418 
Dealt to 2b5a7a1b 
Dealt to 2d1b3dec 
7f40418: folds
2b5a7a1b: folds
2d1b3dec: folds
70573b8: folds
f2e3feac: folds
Uncalled bet ($0.03) returned to Hero
*** SHOWDOWN ***
Hero collected $0.04 from pot
*** SUMMARY ***
Total pot $0.04 | Rake $0 | Jackpot $0 | Bingo $0 | Fortune $0 | Tax $0
Seat 1: 70573b8 (button) folded before Flop (didn't bet)
Seat 2: f2e3feac (small blind) folded before Flop
Seat 3: Hero (big blind) collected ($0.04)
Seat 4: 7f40418 folded before Flop (didn't bet)
Seat 5: 2b5a7a1b folded before Flop (didn't bet)
Seat 6: 2d1b3dec folded before Flop (didn't bet)


Poker Hand #RC3795927655: Hold'em No Limit ($0.02/$0.05) - 2025/08/10 08:11:49
Table 'RushAndCash11062915' 6-max Seat #1 is the button
Seat 1: dd92de38 ($5 in chips)
Seat 2: ba3893c4 ($5.63 in chips)
Seat 3: c489ef79 ($4.97 in chips)
Seat 4: 9e0c2202 ($5.02 in chips)
Seat 5: 5c5d4a8d ($9.91 in chips)
Seat 6: Hero ($8.2 in chips)
ba3893c4: posts small blind $0.02
c489ef79: posts big blind $0.05
*** HOLE CARDS ***
Dealt to dd92de38 
Dealt to ba3893c4 
Dealt to c489ef79 
Dealt to 9e0c2202 
Dealt to 5c5d4a8d 
Dealt to Hero [Qh 8d]
9e0c2202: raises $0.06 to $0.11
5c5d4a8d: raises $0.23 to $0.34
Hero: folds
dd92de38: folds
ba3893c4: folds
c489ef79: folds
9e0c2202: folds
Uncalled bet ($0.23) returned to 5c5d4a8d
*** SHOWDOWN ***
5c5d4a8d collected $0.28 from pot
*** SUMMARY ***
Total pot $0.29 | Rake $0.01 | Jackpot $0 | Bingo $0 | Fortune $0 | Tax $0
Seat 1: dd92de38 (button) folded before Flop (didn't bet)
Seat 2: ba3893c4 (small blind) folded before Flop
Seat 3: c489ef79 (big blind) folded before Flop
Seat 4: 9e0c2202 folded before Flop
Seat 5: 5c5d4a8d collected ($0.28)
Seat 6: Hero folded before Flop (didn't bet)


Poker Hand #RC3795927626: Hold'em No Limit ($0.02/$0.05) - 2025/08/10 08:11:39
Table 'RushAndCash11062886' 6-max Seat #1 is the button
Seat 1: 63f3fdb ($5.27 in chips)
Seat 2: Hero ($8.22 in chips)
Seat 3: 5c5d4a8d ($9.96 in chips)
Seat 4: d1364679 ($7.29 in chips)
Seat 5: c994efb3 ($5 in chips)
Seat 6: 42c31e1a ($9.22 in chips)
Hero: posts small blind $0.02
5c5d4a8d: posts big blind $0.05
*** HOLE CARDS ***
Dealt to 63f3fdb 
Dealt to Hero [As 6h]
Dealt to 5c5d4a8d 
Dealt to d1364679 
Dealt to c994efb3 
Dealt to 42c31e1a 
d1364679: folds
c994efb3: folds
42c31e1a: folds
63f3fdb: raises $0.07 to $0.12
Hero: folds
5c5d4a8d: folds
Uncalled bet ($0.07) returned to 63f3fdb
*** SHOWDOWN ***
63f3fdb collected $0.12 from pot
*** SUMMARY ***
Total pot $0.12 | Rake $0 | Jackpot $0 | Bingo $0 | Fortune $0 | Tax $0
Seat 1: 63f3fdb (button) collected ($0.12)
Seat 2: Hero (small blind) folded before Flop
Seat 3: 5c5d4a8d (big blind) folded before Flop
Seat 4: d1364679 folded before Flop (didn't bet)
Seat 5: c994efb3 folded before Flop (didn't bet)
Seat 6: 42c31e1a folded before Flop (didn't bet)


Poker Hand #RC3795927593: Hold'em No Limit ($0.02/$0.05) - 2025/08/10 08:11:30
Table 'RushAndCash11062853' 6-max Seat #1 is the button
Seat 1: 8e3d15f9 ($6.84 in chips)
Seat 2: d796f1b5 ($13.43 in chips)
Seat 3: 2d1b3dec ($6.24 in chips)
Seat 4: 70f3348e ($14.25 in chips)
Seat 5: Hero ($8.22 in chips)
Seat 6: f76279b5 ($7.22 in chips)
d796f1b5: posts small blind $0.02
2d1b3dec: posts big blind $0.05
*** HOLE CARDS ***
Dealt to 8e3d15f9 
Dealt to d796f1b5 
Dealt to 2d1b3dec 
Dealt to 70f3348e 
Dealt to Hero [2s As]
Dealt to f76279b5 
70f3348e: folds
Hero: folds
f76279b5: folds
8e3d15f9: folds
d796f1b5: folds
Uncalled bet ($0.03) returned to 2d1b3dec
*** SHOWDOWN ***
2d1b3dec collected $0.04 from pot
*** SUMMARY ***
Total pot $0.04 | Rake $0 | Jackpot $0 | Bingo $0 | Fortune $0 | Tax $0
Seat 1: 8e3d15f9 (button) folded before Flop (didn't bet)
Seat 2: d796f1b5 (small blind) folded before Flop
Seat 3: 2d1b3dec (big blind) collected ($0.04)
Seat 4: 70f3348e folded before Flop (didn't bet)
Seat 5: Hero folded before Flop (didn't bet)
Seat 6: f76279b5 folded before Flop (didn't bet)


Poker Hand #RC3795927573: Hold'em No Limit ($0.02/$0.05) - 2025/08/10 08:11:25
Table 'RushAndCash11062833' 6-max Seat #1 is the button
Seat 1: d796f1b5 ($13.43 in chips)
Seat 2: 196a508f ($13.72 in chips)
Seat 3: 4b731a27 ($7.68 in chips)
Seat 4: Hero ($8.22 in chips)
Seat 5: 38df6650 ($5.02 in chips)
Seat 6: d7fd8492 ($16.59 in chips)
196a508f: posts small blind $0.02
4b731a27: posts big blind $0.05
*** HOLE CARDS ***
Dealt to d796f1b5 
Dealt to 196a508f 
Dealt to 4b731a27 
Dealt to Hero [As 3h]
Dealt to 38df6650 
Dealt to d7fd8492 
Hero: folds
38df6650: folds
d7fd8492: folds
d796f1b5: folds
196a508f: raises $0.1 to $0.15
4b731a27: calls $0.1
*** FLOP *** [3d 3s 8c]
196a508f: checks
4b731a27: checks
*** TURN *** [3d 3s 8c] [Js]
196a508f: checks
4b731a27: bets $0.11
196a508f: folds
Uncalled bet ($0.11) returned to 4b731a27
*** SHOWDOWN ***
4b731a27 collected $0.29 from pot
*** SUMMARY ***
Total pot $0.3 | Rake $0.01 | Jackpot $0 | Bingo $0 | Fortune $0 | Tax $0
Board [3d 3s 8c Js]
Seat 1: d796f1b5 (button) folded before Flop (didn't bet)
Seat 2: 196a508f (small blind) folded on the Turn
Seat 3: 4b731a27 (big blind) won ($0.29)
Seat 4: Hero folded before Flop (didn't bet)
Seat 5: 38df6650 folded before Flop (didn't bet)
Seat 6: d7fd8492 folded before Flop (didn't bet)


Poker Hand #RC3795927545: Hold'em No Limit ($0.02/$0.05) - 2025/08/10 08:11:18
Table 'RushAndCash11062805' 6-max Seat #1 is the button
Seat 1: Hero ($8.22 in chips)
Seat 2: 2b5a7a1b ($8.58 in chips)
Seat 3: c994efb3 ($5 in chips)
Seat 4: 32afa283 ($4.84 in chips)
Seat 5: 8afb6429 ($6.53 in chips)
Seat 6: 17b790ab ($5.14 in chips)
2b5a7a1b: posts small blind $0.02
c994efb3: posts big blind $0.05
*** HOLE CARDS ***
Dealt to Hero [5d Td]
Dealt to 2b5a7a1b 
Dealt to c994efb3 
Dealt to 32afa283 
Dealt to 8afb6429 
Dealt to 17b790ab 
32afa283: raises $0.07 to $0.12
8afb6429: folds
17b790ab: folds
Hero: folds
2b5a7a1b: folds
c994efb3: folds
Uncalled bet ($0.07) returned to 32afa283
*** SHOWDOWN ***
32afa283 collected $0.12 from pot
*** SUMMARY ***
Total pot $0.12 | Rake $0 | Jackpot $0 | Bingo $0 | Fortune $0 | Tax $0
Seat 1: Hero (button) folded before Flop (didn't bet)
Seat 2: 2b5a7a1b (small blind) folded before Flop
Seat 3: c994efb3 (big blind) folded before Flop
Seat 4: 32afa283 collected ($0.12)
Seat 5: 8afb6429 folded before Flop (didn't bet)
Seat 6: 17b790ab folded before Flop (didn't bet)


Poker Hand #RC3795927530: Hold'em No Limit ($0.02/$0.05) - 2025/08/10 08:11:14
Table 'RushAndCash11062790' 6-max Seat #1 is the button
Seat 1: 449b8f82 ($5.84 in chips)
Seat 2: 509dbe09 ($5.04 in chips)
Seat 3: c47206f4 ($12.48 in chips)
Seat 4: 6f8f726b ($15.79 in chips)
Seat 5: Hero ($8.22 in chips)
Seat 6: ba3893c4 ($5.68 in chips)
509dbe09: posts small blind $0.02
c47206f4: posts big blind $0.05
*** HOLE CARDS ***
Dealt to 449b8f82 
Dealt to 509dbe09 
Dealt to c47206f4 
Dealt to 6f8f726b 
Dealt to Hero [Qh 9s]
Dealt to ba3893c4 
6f8f726b: folds
Hero: folds
ba3893c4: folds
449b8f82: folds
509dbe09: raises $0.06 to $0.11
c47206f4: folds
Uncalled bet ($0.06) returned to 509dbe09
*** SHOWDOWN ***
509dbe09 collected $0.1 from pot
*** SUMMARY ***
Total pot $0.1 | Rake $0 | Jackpot $0 | Bingo $0 | Fortune $0 | Tax $0
Seat 1: 449b8f82 (button) folded before Flop (didn't bet)
Seat 2: 509dbe09 (small blind) collected ($0.1)
Seat 3: c47206f4 (big blind) folded before Flop
Seat 4: 6f8f726b folded before Flop (didn't bet)
Seat 5: Hero folded before Flop (didn't bet)
Seat 6: ba3893c4 folded before Flop (didn't bet)


Poker Hand #RC3795927495: Hold'em No Limit ($0.02/$0.05) - 2025/08/10 08:11:05
Table 'RushAndCash11062755' 6-max Seat #1 is the button
Seat 1: bfa0c2b2 ($6.31 in chips)
Seat 2: Hero ($8.24 in chips)
Seat 3: ca112d1 ($7.65 in chips)
Seat 4: 18b1ecd7 ($5.1 in chips)
Seat 5: 41ed372d ($5 in chips)
Seat 6: 5c5d4a8d ($9.91 in chips)
Hero: posts small blind $0.02
ca112d1: posts big blind $0.05
*** HOLE CARDS ***
Dealt to bfa0c2b2 
Dealt to Hero [Qc 3h]
Dealt to ca112d1 
Dealt to 18b1ecd7 
Dealt to 41ed372d 
Dealt to 5c5d4a8d 
18b1ecd7: folds
41ed372d: raises $0.08 to $0.13
5c5d4a8d: folds
bfa0c2b2: folds
Hero: folds
ca112d1: folds
Uncalled bet ($0.08) returned to 41ed372d
*** SHOWDOWN ***
41ed372d collected $0.12 from pot
*** SUMMARY ***
Total pot $0.12 | Rake $0 | Jackpot $0 | Bingo $0 | Fortune $0 | Tax $0
Seat 1: bfa0c2b2 (button) folded before Flop (didn't bet)
Seat 2: Hero (small blind) folded before Flop
Seat 3: ca112d1 (big blind) folded before Flop
Seat 4: 18b1ecd7 folded before Flop (didn't bet)
Seat 5: 41ed372d collected ($0.12)
Seat 6: 5c5d4a8d folded before Flop (didn't bet)


Poker Hand #RC3795927456: Hold'em No Limit ($0.02/$0.05) - 2025/08/10 08:10:55
Table 'RushAndCash11062716' 6-max Seat #1 is the button
Seat 1: f3a1d090 ($24.65 in chips)
Seat 2: 7a7287fd ($7.12 in chips)
Seat 3: Hero ($8.29 in chips)
Seat 4: 1eef3559 ($10.03 in chips)
Seat 5: aba6f339 ($9.81 in chips)
Seat 6: 80630135 ($6.37 in chips)
7a7287fd: posts small blind $0.02
Hero: posts big blind $0.05
*** HOLE CARDS ***
Dealt to f3a1d090 
Dealt to 7a7287fd 
Dealt to Hero [8s 3c]
Dealt to 1eef3559 
Dealt to aba6f339 
Dealt to 80630135 
1eef3559: folds
aba6f339: folds
80630135: folds
f3a1d090: raises $0.07 to $0.12
7a7287fd: raises $0.38 to $0.5
Hero: folds
f3a1d090: folds
Uncalled bet ($0.38) returned to 7a7287fd
*** SHOWDOWN ***
7a7287fd collected $0.28 from pot
*** SUMMARY ***
Total pot $0.29 | Rake $0.01 | Jackpot $0 | Bingo $0 | Fortune $0 | Tax $0
Seat 1: f3a1d090 (button) folded before Flop
Seat 2: 7a7287fd (small blind) collected ($0.28)
Seat 3: Hero (big blind) folded before Flop
Seat 4: 1eef3559 folded before Flop (didn't bet)
Seat 5: aba6f339 folded before Flop (didn't bet)
Seat 6: 80630135 folded before Flop (didn't bet)


Poker Hand #RC3795927444: Hold'em No Limit ($0.02/$0.05) - 2025/08/10 08:10:52
Table 'RushAndCash11062704' 6-max Seat #1 is the button
Seat 1: 5ab0b835 ($11.02 in chips)
Seat 2: 6e85c1d6 ($7.92 in chips)
Seat 3: 65d0d71f ($5.98 in chips)
Seat 4: Hero ($8.29 in chips)
Seat 5: 80630135 ($6.37 in chips)
Seat 6: c489ef79 ($5.79 in chips)
6e85c1d6: posts small blind $0.02
65d0d71f: posts big blind $0.05
*** HOLE CARDS ***
Dealt to 5ab0b835 
Dealt to 6e85c1d6 
Dealt to 65d0d71f 
Dealt to Hero [4d 5s]
Dealt to 80630135 
Dealt to c489ef79 
Hero: folds
80630135: folds
c489ef79: folds
5ab0b835: raises $0.08 to $0.13
6e85c1d6: folds
65d0d71f: folds
Uncalled bet ($0.08) returned to 5ab0b835
*** SHOWDOWN ***
5ab0b835 collected $0.12 from pot
*** SUMMARY ***
Total pot $0.12 | Rake $0 | Jackpot $0 | Bingo $0 | Fortune $0 | Tax $0
Seat 1: 5ab0b835 (button) collected ($0.12)
Seat 2: 6e85c1d6 (small blind) folded before Flop
Seat 3: 65d0d71f (big blind) folded before Flop
Seat 4: Hero folded before Flop (didn't bet)
Seat 5: 80630135 folded before Flop (didn't bet)
Seat 6: c489ef79 folded before Flop (didn't bet)


Poker Hand #RC3795927428: Hold'em No Limit ($0.02/$0.05) - 2025/08/10 08:10:48
Table 'RushAndCash11062688' 6-max Seat #1 is the button
Seat 1: 4cb26b71 ($5.48 in chips)
Seat 2: 8e3d15f9 ($6.89 in chips)
Seat 3: 2bd5a8b ($5.24 in chips)
Seat 4: 32afa283 ($4.91 in chips)
Seat 5: a57b331d ($21.78 in chips)
Seat 6: Hero ($8.29 in chips)
8e3d15f9: posts small blind $0.02
2bd5a8b: posts big blind $0.05
*** HOLE CARDS ***
Dealt to 4cb26b71 
Dealt to 8e3d15f9 
Dealt to 2bd5a8b 
Dealt to 32afa283 
Dealt to a57b331d 
Dealt to Hero [6d 8s]
32afa283: folds
a57b331d: folds
Hero: folds
4cb26b71: raises $0.05 to $0.1
8e3d15f9: folds
2bd5a8b: folds
Uncalled bet ($0.05) returned to 4cb26b71
*** SHOWDOWN ***
4cb26b71 collected $0.12 from pot
*** SUMMARY ***
Total pot $0.12 | Rake $0 | Jackpot $0 | Bingo $0 | Fortune $0 | Tax $0
Seat 1: 4cb26b71 (button) collected ($0.12)
Seat 2: 8e3d15f9 (small blind) folded before Flop
Seat 3: 2bd5a8b (big blind) folded before Flop
Seat 4: 32afa283 folded before Flop (didn't bet)
Seat 5: a57b331d folded before Flop (didn't bet)
Seat 6: Hero folded before Flop (didn't bet)


Poker Hand #RC3795927312: Hold'em No Limit ($0.02/$0.05) - 2025/08/10 08:10:18
Table 'RushAndCash11062572' 6-max Seat #1 is the button
Seat 1: c6b4a39c ($5.39 in chips)
Seat 2: 8b390e1e ($5.25 in chips)
Seat 3: 3f382755 ($5.11 in chips)
Seat 4: b0fd3437 ($8.34 in chips)
Seat 5: Hero ($8.22 in chips)
Seat 6: 8d67d790 ($10.24 in chips)
8b390e1e: posts small blind $0.02
3f382755: posts big blind $0.05
*** HOLE CARDS ***
Dealt to c6b4a39c 
Dealt to 8b390e1e 
Dealt to 3f382755 
Dealt to b0fd3437 
Dealt to Hero [Qd Kh]
Dealt to 8d67d790 
b0fd3437: folds
Hero: raises $0.05 to $0.1
8d67d790: folds
c6b4a39c: folds
8b390e1e: folds
3f382755: folds
Uncalled bet ($0.05) returned to Hero
*** SHOWDOWN ***
Hero collected $0.12 from pot
*** SUMMARY ***
Total pot $0.12 | Rake $0 | Jackpot $0 | Bingo $0 | Fortune $0 | Tax $0
Seat 1: c6b4a39c (button) folded before Flop (didn't bet)
Seat 2: 8b390e1e (small blind) folded before Flop
Seat 3: 3f382755 (big blind) folded before Flop
Seat 4: b0fd3437 folded before Flop (didn't bet)
Seat 5: Hero collected ($0.12)
Seat 6: 8d67d790 folded before Flop (didn't bet)


Poker Hand #RC3795927292: Hold'em No Limit ($0.02/$0.05) - 2025/08/10 08:10:14
Table 'RushAndCash11062552' 6-max Seat #1 is the button
Seat 1: Hero ($8.22 in chips)
Seat 2: 725b630e ($5 in chips)
Seat 3: 81b8bd6d ($4.94 in chips)
Seat 4: d62070dc ($6.24 in chips)
Seat 5: 3817bfda ($16.98 in chips)
Seat 6: 948d9171 ($5 in chips)
725b630e: posts small blind $0.02
81b8bd6d: posts big blind $0.05
*** HOLE CARDS ***
Dealt to Hero [Qc Kh]
Dealt to 725b630e 
Dealt to 81b8bd6d 
Dealt to d62070dc 
Dealt to 3817bfda 
Dealt to 948d9171 
d62070dc: raises $0.05 to $0.1
3817bfda: folds
948d9171: folds
Hero: folds
725b630e: folds
81b8bd6d: calls $0.05
*** FLOP *** [3c 6s 3h]
81b8bd6d: checks
d62070dc: checks
*** TURN *** [3c 6s 3h] [9d]
81b8bd6d: bets $0.08
d62070dc: calls $0.08
*** RIVER *** [3c 6s 3h 9d] [9s]
81b8bd6d: checks
d62070dc: bets $0.31
81b8bd6d: folds
Uncalled bet ($0.31) returned to d62070dc
*** SHOWDOWN ***
d62070dc collected $0.37 from pot
*** SUMMARY ***
Total pot $0.38 | Rake $0.01 | Jackpot $0 | Bingo $0 | Fortune $0 | Tax $0
Board [3c 6s 3h 9d 9s]
Seat 1: Hero (button) folded before Flop (didn't bet)
Seat 2: 725b630e (small blind) folded before Flop
Seat 3: 81b8bd6d (big blind) folded on the River
Seat 4: d62070dc won ($0.37)
Seat 5: 3817bfda folded before Flop (didn't bet)
Seat 6: 948d9171 folded before Flop (didn't bet)


Poker Hand #RC3795927216: Hold'em No Limit ($0.02/$0.05) - 2025/08/10 08:09:55
Table 'RushAndCash11062476' 6-max Seat #1 is the button
Seat 1: 4328ce0 ($3.12 in chips)
Seat 2: fa875f2b ($5.02 in chips)
Seat 3: Hero ($8.2 in chips)
Seat 4: cf24dfe4 ($7.5 in chips)
Seat 5: 6e6d6019 ($6.93 in chips)
Seat 6: 2c53d2c7 ($5.13 in chips)
fa875f2b: posts small blind $0.02
Hero: posts big blind $0.05
*** HOLE CARDS ***
Dealt to 4328ce0 
Dealt to fa875f2b 
Dealt to Hero [6s Ks]
Dealt to cf24dfe4 
Dealt to 6e6d6019 
Dealt to 2c53d2c7 
cf24dfe4: folds
6e6d6019: folds
2c53d2c7: folds
4328ce0: folds
fa875f2b: folds
Uncalled bet ($0.03) returned to Hero
*** SHOWDOWN ***
Hero collected $0.04 from pot
*** SUMMARY ***
Total pot $0.04 | Rake $0 | Jackpot $0 | Bingo $0 | Fortune $0 | Tax $0
Seat 1: 4328ce0 (button) folded before Flop (didn't bet)
Seat 2: fa875f2b (small blind) folded before Flop
Seat 3: Hero (big blind) collected ($0.04)
Seat 4: cf24dfe4 folded before Flop (didn't bet)
Seat 5: 6e6d6019 folded before Flop (didn't bet)
Seat 6: 2c53d2c7 folded before Flop (didn't bet)


Poker Hand #RC3795927191: Hold'em No Limit ($0.02/$0.05) - 2025/08/10 08:09:48
Table 'RushAndCash11062451' 6-max Seat #1 is the button
Seat 1: 85e4ce3a ($14.4 in chips)
Seat 2: Hero ($8.22 in chips)
Seat 3: c8568584 ($5 in chips)
Seat 4: 5818efb5 ($7.95 in chips)
Seat 5: fa60e706 ($5.21 in chips)
Seat 6: 9a343d90 ($8.72 in chips)
Hero: posts small blind $0.02
c8568584: posts big blind $0.05
*** HOLE CARDS ***
Dealt to 85e4ce3a 
Dealt to Hero [4h 7c]
Dealt to c8568584 
Dealt to 5818efb5 
Dealt to fa60e706 
Dealt to 9a343d90 
5818efb5: folds
fa60e706: raises $0.05 to $0.1
9a343d90: folds
85e4ce3a: folds
Hero: folds
c8568584: calls $0.05
*** FLOP *** [6d Ks Td]
c8568584: checks
fa60e706: bets $0.06
c8568584: calls $0.06
*** TURN *** [6d Ks Td] [7d]
c8568584: checks
fa60e706: checks
*** RIVER *** [6d Ks Td 7d] [6s]
c8568584: checks
fa60e706: checks
c8568584: shows [Qs Jc] (a pair of Sixes)
fa60e706: shows [As Qh] (a pair of Sixes)
*** SHOWDOWN ***
fa60e706 collected $0.33 from pot
*** SUMMARY ***
Total pot $0.34 | Rake $0.01 | Jackpot $0 | Bingo $0 | Fortune $0 | Tax $0
Board [6d Ks Td 7d 6s]
Seat 1: 85e4ce3a (button) folded before Flop (didn't bet)
Seat 2: Hero (small blind) folded before Flop
Seat 3: c8568584 (big blind) showed [Qs Jc] and lost with a pair of Sixes
Seat 4: 5818efb5 folded before Flop (didn't bet)
Seat 5: fa60e706 showed [As Qh] and won ($0.33) with a pair of Sixes
Seat 6: 9a343d90 folded before Flop (didn't bet)


Poker Hand #RC3795926975: Hold'em No Limit ($0.02/$0.05) - 2025/08/10 08:08:49
Table 'RushAndCash11062235' 6-max Seat #1 is the button
Seat 1: f6c47f47 ($4.15 in chips)
Seat 2: 146e862a ($2.29 in chips)
Seat 3: 32afa283 ($5.03 in chips)
Seat 4: 196a508f ($13.48 in chips)
Seat 5: 449b8f82 ($5.74 in chips)
Seat 6: Hero ($7.75 in chips)
146e862a: posts small blind $0.02
32afa283: posts big blind $0.05
*** HOLE CARDS ***
Dealt to f6c47f47 
Dealt to 146e862a 
Dealt to 32afa283 
Dealt to 196a508f 
Dealt to 449b8f82 
Dealt to Hero [Jh Tc]
196a508f: folds
449b8f82: raises $0.05 to $0.1
Hero: raises $0.05 to $0.15
f6c47f47: folds
146e862a: folds
32afa283: folds
449b8f82: calls $0.05
*** FLOP *** [8s Ks 6s]
449b8f82: checks
Hero: checks
*** TURN *** [8s Ks 6s] [3s]
449b8f82: checks
Hero: bets $0.29
449b8f82: calls $0.29
*** RIVER *** [8s Ks 6s 3s] [5d]
449b8f82: checks
Hero: bets $1.32
449b8f82: folds
Uncalled bet ($1.32) returned to Hero
*** SHOWDOWN ***
Hero collected $0.91 from pot
*** SUMMARY ***
Total pot $0.95 | Rake $0.04 | Jackpot $0 | Bingo $0 | Fortune $0 | Tax $0
Board [8s Ks 6s 3s 5d]
Seat 1: f6c47f47 (button) folded before Flop (didn't bet)
Seat 2: 146e862a (small blind) folded before Flop
Seat 3: 32afa283 (big blind) folded before Flop
Seat 4: 196a508f folded before Flop (didn't bet)
Seat 5: 449b8f82 folded on the River
Seat 6: Hero won ($0.91)


Poker Hand #RC3795926959: Hold'em No Limit ($0.02/$0.05) - 2025/08/10 08:08:44
Table 'RushAndCash11062219' 6-max Seat #1 is the button
Seat 1: db3b59eb ($5.2 in chips)
Seat 2: dde92c84 ($14.4 in chips)
Seat 3: d796f1b5 ($13.73 in chips)
Seat 4: 880ef146 ($5 in chips)
Seat 5: Hero ($7.75 in chips)
Seat 6: 40e1cc86 ($9.75 in chips)
dde92c84: posts small blind $0.02
d796f1b5: posts big blind $0.05
*** HOLE CARDS ***
Dealt to db3b59eb 
Dealt to dde92c84 
Dealt to d796f1b5 
Dealt to 880ef146 
Dealt to Hero [Qh 4c]
Dealt to 40e1cc86 
880ef146: raises $0.06 to $0.11
Hero: folds
40e1cc86: folds
db3b59eb: folds
dde92c84: folds
d796f1b5: calls $0.06
*** FLOP *** [Ad Ac Jd]
d796f1b5: checks
880ef146: bets $0.16
d796f1b5: folds
Uncalled bet ($0.16) returned to 880ef146
*** SHOWDOWN ***
880ef146 collected $0.23 from pot
*** SUMMARY ***
Total pot $0.24 | Rake $0.01 | Jackpot $0 | Bingo $0 | Fortune $0 | Tax $0
Board [Ad Ac Jd]
Seat 1: db3b59eb (button) folded before Flop (didn't bet)
Seat 2: dde92c84 (small blind) folded before Flop
Seat 3: d796f1b5 (big blind) folded on the Flop
Seat 4: 880ef146 won ($0.23)
Seat 5: Hero folded before Flop (didn't bet)
Seat 6: 40e1cc86 folded before Flop (didn't bet)


Poker Hand #RC3795926947: Hold'em No Limit ($0.02/$0.05) - 2025/08/10 08:08:41
Table 'RushAndCash11062207' 6-max Seat #1 is the button
Seat 1: 32afa283 ($5.05 in chips)
Seat 2: e8d6e6da ($5.21 in chips)
Seat 3: 59da8582 ($5.42 in chips)
Seat 4: 732373fb ($5.16 in chips)
Seat 5: 85e4ce3a ($14.37 in chips)
Seat 6: Hero ($7.75 in chips)
e8d6e6da: posts small blind $0.02
59da8582: posts big blind $0.05
*** HOLE CARDS ***
Dealt to 32afa283 
Dealt to e8d6e6da 
Dealt to 59da8582 
Dealt to 732373fb 
Dealt to 85e4ce3a 
Dealt to Hero [Qc 7h]
732373fb: folds
85e4ce3a: raises $0.06 to $0.11
Hero: folds
32afa283: folds
e8d6e6da: folds
59da8582: calls $0.06
*** FLOP *** [6d 2c Jd]
59da8582: checks
85e4ce3a: bets $0.12
59da8582: folds
Uncalled bet ($0.12) returned to 85e4ce3a
*** SHOWDOWN ***
85e4ce3a collected $0.23 from pot
*** SUMMARY ***
Total pot $0.24 | Rake $0.01 | Jackpot $0 | Bingo $0 | Fortune $0 | Tax $0
Board [6d 2c Jd]
Seat 1: 32afa283 (button) folded before Flop (didn't bet)
Seat 2: e8d6e6da (small blind) folded before Flop
Seat 3: 59da8582 (big blind) folded on the Flop
Seat 4: 732373fb folded before Flop (didn't bet)
Seat 5: 85e4ce3a won ($0.23)
Seat 6: Hero folded before Flop (didn't bet)


Poker Hand #RC3795926863: Hold'em No Limit ($0.02/$0.05) - 2025/08/10 08:08:18
Table 'RushAndCash11062123' 6-max Seat #1 is the button
Seat 1: Hero ($7.75 in chips)
Seat 2: fa875f2b ($5.13 in chips)
Seat 3: 6e74b676 ($5 in chips)
Seat 4: c2264157 ($7.65 in chips)
Seat 5: 562bc648 ($5.52 in chips)
Seat 6: 949b5efc ($6.23 in chips)
fa875f2b: posts small blind $0.02
6e74b676: posts big blind $0.05
*** HOLE CARDS ***
Dealt to Hero [2s 3c]
Dealt to fa875f2b 
Dealt to 6e74b676 
Dealt to c2264157 
Dealt to 562bc648 
Dealt to 949b5efc 
c2264157: folds
562bc648: folds
949b5efc: folds
Hero: folds
fa875f2b: folds
Uncalled bet ($0.03) returned to 6e74b676
*** SHOWDOWN ***
6e74b676 collected $0.04 from pot
*** SUMMARY ***
Total pot $0.04 | Rake $0 | Jackpot $0 | Bingo $0 | Fortune $0 | Tax $0
Seat 1: Hero (button) folded before Flop (didn't bet)
Seat 2: fa875f2b (small blind) folded before Flop
Seat 3: 6e74b676 (big blind) collected ($0.04)
Seat 4: c2264157 folded before Flop (didn't bet)
Seat 5: 562bc648 folded before Flop (didn't bet)
Seat 6: 949b5efc folded before Flop (didn't bet)


Poker Hand #RC3795926785: Hold'em No Limit ($0.02/$0.05) - 2025/08/10 08:07:54
Table 'RushAndCash11062045' 6-max Seat #1 is the button
Seat 1: 18ca1e6b ($8.08 in chips)
Seat 2: Hero ($7.77 in chips)
Seat 3: 8a158df0 ($4.6 in chips)
Seat 4: 7e6ca83c ($11.9 in chips)
Seat 5: d796f1b5 ($13.68 in chips)
Seat 6: d3b2bf87 ($7.06 in chips)
Hero: posts small blind $0.02
8a158df0: posts big blind $0.05
*** HOLE CARDS ***
Dealt to 18ca1e6b 
Dealt to Hero [Td 9s]
Dealt to 8a158df0 
Dealt to 7e6ca83c 
Dealt to d796f1b5 
Dealt to d3b2bf87 
7e6ca83c: folds
d796f1b5: folds
d3b2bf87: raises $0.06 to $0.11
18ca1e6b: folds
Hero: folds
8a158df0: folds
Uncalled bet ($0.06) returned to d3b2bf87
*** SHOWDOWN ***
d3b2bf87 collected $0.12 from pot
*** SUMMARY ***
Total pot $0.12 | Rake $0 | Jackpot $0 | Bingo $0 | Fortune $0 | Tax $0
Seat 1: 18ca1e6b (button) folded before Flop (didn't bet)
Seat 2: Hero (small blind) folded before Flop
Seat 3: 8a158df0 (big blind) folded before Flop
Seat 4: 7e6ca83c folded before Flop (didn't bet)
Seat 5: d796f1b5 folded before Flop (didn't bet)
Seat 6: d3b2bf87 collected ($0.12)


Poker Hand #RC3795926627: Hold'em No Limit ($0.02/$0.05) - 2025/08/10 08:07:06
Table 'RushAndCash11061887' 6-max Seat #1 is the button
Seat 1: 8a158df0 ($5.45 in chips)
Seat 2: cd3fa352 ($2.19 in chips)
Seat 3: Hero ($7.05 in chips)
Seat 4: 9aa76ee3 ($6.62 in chips)
Seat 5: 5d80bec3 ($5 in chips)
Seat 6: 26477ad1 ($5.84 in chips)
cd3fa352: posts small blind $0.02
Hero: posts big blind $0.05
*** HOLE CARDS ***
Dealt to 8a158df0 
Dealt to cd3fa352 
Dealt to Hero [Jc Jd]
Dealt to 9aa76ee3 
Dealt to 5d80bec3 
Dealt to 26477ad1 
9aa76ee3: folds
5d80bec3: folds
26477ad1: folds
8a158df0: raises $0.1 to $0.15
cd3fa352: folds
Hero: calls $0.1
*** FLOP *** [8d Tc 6s]
Hero: checks
8a158df0: bets $0.17
Hero: raises $0.53 to $0.7
8a158df0: calls $0.53
*** TURN *** [8d Tc 6s] [5h]
Hero: checks
8a158df0: checks
*** RIVER *** [8d Tc 6s 5h] [Qs]
Hero: checks
8a158df0: checks
Hero: shows [Jc Jd] (a pair of Jacks)
8a158df0: shows [8s 7s] (a pair of Eights)
*** SHOWDOWN ***
Hero collected $1.57 from pot
*** SUMMARY ***
Total pot $1.72 | Rake $0.08 | Jackpot $0.07 | Bingo $0 | Fortune $0 | Tax $0
Board [8d Tc 6s 5h Qs]
Seat 1: 8a158df0 (button) showed [8s 7s] and lost with a pair of Eights
Seat 2: cd3fa352 (small blind) folded before Flop
Seat 3: Hero (big blind) showed [Jc Jd] and won ($1.57) with a pair of Jacks
Seat 4: 9aa76ee3 folded before Flop (didn't bet)
Seat 5: 5d80bec3 folded before Flop (didn't bet)
Seat 6: 26477ad1 folded before Flop (didn't bet)


Poker Hand #RC3795926612: Hold'em No Limit ($0.02/$0.05) - 2025/08/10 08:07:02
Table 'RushAndCash11061872' 6-max Seat #1 is the button
Seat 1: da84e89d ($8.68 in chips)
Seat 2: 2bd5a8b ($5.69 in chips)
Seat 3: 210c8e9b ($12.98 in chips)
Seat 4: Hero ($7.05 in chips)
Seat 5: 55c5398 ($5 in chips)
Seat 6: c2d736f7 ($5.04 in chips)
2bd5a8b: posts small blind $0.02
210c8e9b: posts big blind $0.05
*** HOLE CARDS ***
Dealt to da84e89d 
Dealt to 2bd5a8b 
Dealt to 210c8e9b 
Dealt to Hero [Ts 4h]
Dealt to 55c5398 
Dealt to c2d736f7 
Hero: folds
55c5398: folds
c2d736f7: folds
da84e89d: folds
2bd5a8b: folds
Uncalled bet ($0.03) returned to 210c8e9b
*** SHOWDOWN ***
210c8e9b collected $0.04 from pot
*** SUMMARY ***
Total pot $0.04 | Rake $0 | Jackpot $0 | Bingo $0 | Fortune $0 | Tax $0
Seat 1: da84e89d (button) folded before Flop (didn't bet)
Seat 2: 2bd5a8b (small blind) folded before Flop
Seat 3: 210c8e9b (big blind) collected ($0.04)
Seat 4: Hero folded before Flop (didn't bet)
Seat 5: 55c5398 folded before Flop (didn't bet)
Seat 6: c2d736f7 folded before Flop (didn't bet)


Poker Hand #RC3795926601: Hold'em No Limit ($0.02/$0.05) - 2025/08/10 08:06:59
Table 'RushAndCash11061861' 6-max Seat #1 is the button
Seat 1: 9ef40456 ($5.18 in chips)
Seat 2: f0e15475 ($5.11 in chips)
Seat 3: 1cc4b631 ($6.15 in chips)
Seat 4: 7ba62247 ($6.85 in chips)
Seat 5: e7e9348c ($15.1 in chips)
Seat 6: Hero ($7.05 in chips)
f0e15475: posts small blind $0.02
1cc4b631: posts big blind $0.05
*** HOLE CARDS ***
Dealt to 9ef40456 
Dealt to f0e15475 
Dealt to 1cc4b631 
Dealt to 7ba62247 
Dealt to e7e9348c 
Dealt to Hero [3d 4d]
7ba62247: folds
e7e9348c: folds
Hero: folds
9ef40456: folds
f0e15475: raises $0.1 to $0.15
1cc4b631: calls $0.1
*** FLOP *** [5c 2c 7h]
f0e15475: checks
1cc4b631: bets $0.1
f0e15475: raises $0.4 to $0.5
1cc4b631: folds
Uncalled bet ($0.4) returned to f0e15475
*** SHOWDOWN ***
f0e15475 collected $0.48 from pot
*** SUMMARY ***
Total pot $0.5 | Rake $0.02 | Jackpot $0 | Bingo $0 | Fortune $0 | Tax $0
Board [5c 2c 7h]
Seat 1: 9ef40456 (button) folded before Flop (didn't bet)
Seat 2: f0e15475 (small blind) won ($0.48)
Seat 3: 1cc4b631 (big blind) folded on the Flop
Seat 4: 7ba62247 folded before Flop (didn't bet)
Seat 5: e7e9348c folded before Flop (didn't bet)
Seat 6: Hero folded before Flop (didn't bet)


Poker Hand #RC3795926286: Hold'em No Limit ($0.02/$0.05) - 2025/08/10 08:05:31
Table 'RushAndCash11061546' 6-max Seat #1 is the button
Seat 1: f0e15475 ($5.88 in chips)
Seat 2: Hero ($5.96 in chips)
Seat 3: 43ab8974 ($2.82 in chips)
Seat 4: db22ee6f ($6.07 in chips)
Seat 5: 5525973a ($10.2 in chips)
Seat 6: 2443981e ($5.67 in chips)
Hero: posts small blind $0.02
43ab8974: posts big blind $0.05
*** HOLE CARDS ***
Dealt to f0e15475 
Dealt to Hero [Kc Kh]
Dealt to 43ab8974 
Dealt to db22ee6f 
Dealt to 5525973a 
Dealt to 2443981e 
db22ee6f: folds
5525973a: folds
2443981e: raises $0.1 to $0.15
f0e15475: raises $0.28 to $0.43
Hero: calls $0.41
43ab8974: folds
2443981e: calls $0.28
*** FLOP *** [Ad Ks 7c]
Hero: checks
2443981e: checks
f0e15475: bets $0.34
Hero: calls $0.34
2443981e: folds
*** TURN *** [Ad Ks 7c] [5h]
Hero: checks
f0e15475: checks
*** RIVER *** [Ad Ks 7c 5h] [4h]
Hero: bets $1.58
f0e15475: folds
Uncalled bet ($1.58) returned to Hero
*** SHOWDOWN ***
Hero collected $1.86 from pot
*** SUMMARY ***
Total pot $2.02 | Rake $0.09 | Jackpot $0.07 | Bingo $0 | Fortune $0 | Tax $0
Board [Ad Ks 7c 5h 4h]
Seat 1: f0e15475 (button) folded on the River
Seat 2: Hero (small blind) won ($1.86)
Seat 3: 43ab8974 (big blind) folded before Flop
Seat 4: db22ee6f folded before Flop (didn't bet)
Seat 5: 5525973a folded before Flop (didn't bet)
Seat 6: 2443981e folded on the Flop


Poker Hand #RC3795926112: Hold'em No Limit ($0.02/$0.05) - 2025/08/10 08:04:43
Table 'RushAndCash11061372' 6-max Seat #1 is the button
Seat 1: 6366e2f ($10.79 in chips)
Seat 2: f4bb6f34 ($4.89 in chips)
Seat 3: f0e15475 ($5.98 in chips)
Seat 4: 7d1f43e4 ($4.14 in chips)
Seat 5: Hero ($5.85 in chips)
Seat 6: 7a644870 ($5.86 in chips)
f4bb6f34: posts small blind $0.02
f0e15475: posts big blind $0.05
*** HOLE CARDS ***
Dealt to 6366e2f 
Dealt to f4bb6f34 
Dealt to f0e15475 
Dealt to 7d1f43e4 
Dealt to Hero [9h 8h]
Dealt to 7a644870 
7d1f43e4: folds
Hero: raises $0.05 to $0.1
7a644870: folds
6366e2f: folds
f4bb6f34: folds
f0e15475: calls $0.05
*** FLOP *** [8s Th 4h]
f0e15475: checks
Hero: bets $0.18
f0e15475: folds
Uncalled bet ($0.18) returned to Hero
*** SHOWDOWN ***
Hero collected $0.21 from pot
*** SUMMARY ***
Total pot $0.22 | Rake $0.01 | Jackpot $0 | Bingo $0 | Fortune $0 | Tax $0
Board [8s Th 4h]
Seat 1: 6366e2f (button) folded before Flop (didn't bet)
Seat 2: f4bb6f34 (small blind) folded before Flop
Seat 3: f0e15475 (big blind) folded on the Flop
Seat 4: 7d1f43e4 folded before Flop (didn't bet)
Seat 5: Hero won ($0.21)
Seat 6: 7a644870 folded before Flop (didn't bet)


Poker Hand #RC3795926096: Hold'em No Limit ($0.02/$0.05) - 2025/08/10 08:04:39
Table 'RushAndCash11061356' 6-max Seat #1 is the button
Seat 1: b2bb8a6e ($6.93 in chips)
Seat 2: 21c45711 ($5.02 in chips)
Seat 3: Hero ($5.9 in chips)
Seat 4: b1b3930a ($5.4 in chips)
Seat 5: f01023d5 ($5.15 in chips)
Seat 6: 5818efb5 ($5.94 in chips)
21c45711: posts small blind $0.02
Hero: posts big blind $0.05
*** HOLE CARDS ***
Dealt to b2bb8a6e 
Dealt to 21c45711 
Dealt to Hero [2h 7d]
Dealt to b1b3930a 
Dealt to f01023d5 
Dealt to 5818efb5 
b1b3930a: raises $0.08 to $0.13
f01023d5: folds
5818efb5: calls $0.13
b2bb8a6e: folds
21c45711: folds
Hero: folds
*** FLOP *** [5c Qc Js]
b1b3930a: checks
5818efb5: bets $0.25
b1b3930a: calls $0.25
*** TURN *** [5c Qc Js] [9h]
b1b3930a: checks
5818efb5: bets $0.67
b1b3930a: folds
Uncalled bet ($0.67) returned to 5818efb5
*** SHOWDOWN ***
5818efb5 collected $0.79 from pot
*** SUMMARY ***
Total pot $0.83 | Rake $0.04 | Jackpot $0 | Bingo $0 | Fortune $0 | Tax $0
Board [5c Qc Js 9h]
Seat 1: b2bb8a6e (button) folded before Flop (didn't bet)
Seat 2: 21c45711 (small blind) folded before Flop
Seat 3: Hero (big blind) folded before Flop
Seat 4: b1b3930a folded on the Turn
Seat 5: f01023d5 folded before Flop (didn't bet)
Seat 6: 5818efb5 won ($0.79)


Poker Hand #RC3795926071: Hold'em No Limit ($0.02/$0.05) - 2025/08/10 08:04:33
Table 'RushAndCash11061331' 6-max Seat #1 is the button
Seat 1: e9f334c0 ($8.05 in chips)
Seat 2: 948d9171 ($5.03 in chips)
Seat 3: 725b630e ($6.51 in chips)
Seat 4: d7fd8492 ($10.03 in chips)
Seat 5: Hero ($5.9 in chips)
Seat 6: f0e15475 ($5.98 in chips)
948d9171: posts small blind $0.02
725b630e: posts big blind $0.05
*** HOLE CARDS ***
Dealt to e9f334c0 
Dealt to 948d9171 
Dealt to 725b630e 
Dealt to d7fd8492 
Dealt to Hero [As 2s]
Dealt to f0e15475 
d7fd8492: folds
Hero: folds
f0e15475: folds
e9f334c0: folds
948d9171: folds
Uncalled bet ($0.03) returned to 725b630e
*** SHOWDOWN ***
725b630e collected $0.04 from pot
*** SUMMARY ***
Total pot $0.04 | Rake $0 | Jackpot $0 | Bingo $0 | Fortune $0 | Tax $0
Seat 1: e9f334c0 (button) folded before Flop (didn't bet)
Seat 2: 948d9171 (small blind) folded before Flop
Seat 3: 725b630e (big blind) collected ($0.04)
Seat 4: d7fd8492 folded before Flop (didn't bet)
Seat 5: Hero folded before Flop (didn't bet)
Seat 6: f0e15475 folded before Flop (didn't bet)


Poker Hand #RC3795926043: Hold'em No Limit ($0.02/$0.05) - 2025/08/10 08:04:26
Table 'RushAndCash11061303' 6-max Seat #1 is the button
Seat 1: Hero ($5.9 in chips)
Seat 2: dde92c84 ($8.47 in chips)
Seat 3: d62070dc ($4.5 in chips)
Seat 4: 4cb26b71 ($5.7 in chips)
Seat 5: fa1b15ba ($13.58 in chips)
Seat 6: a64a8453 ($5 in chips)
dde92c84: posts small blind $0.02
d62070dc: posts big blind $0.05
*** HOLE CARDS ***
Dealt to Hero [Ts 4h]
Dealt to dde92c84 
Dealt to d62070dc 
Dealt to 4cb26b71 
Dealt to fa1b15ba 
Dealt to a64a8453 
4cb26b71: folds
fa1b15ba: folds
a64a8453: folds
Hero: folds
dde92c84: folds
Uncalled bet ($0.03) returned to d62070dc
*** SHOWDOWN ***
d62070dc collected $0.04 from pot
*** SUMMARY ***
Total pot $0.04 | Rake $0 | Jackpot $0 | Bingo $0 | Fortune $0 | Tax $0
Seat 1: Hero (button) folded before Flop (didn't bet)
Seat 2: dde92c84 (small blind) folded before Flop
Seat 3: d62070dc (big blind) collected ($0.04)
Seat 4: 4cb26b71 folded before Flop (didn't bet)
Seat 5: fa1b15ba folded before Flop (didn't bet)
Seat 6: a64a8453 folded before Flop (didn't bet)


Poker Hand #RC3795926028: Hold'em No Limit ($0.02/$0.05) - 2025/08/10 08:04:23
Table 'RushAndCash11061288' 6-max Seat #1 is the button
Seat 1: 2b5a7a1b ($6.1 in chips)
Seat 2: 63f3fdb ($6.15 in chips)
Seat 3: f802204 ($6.18 in chips)
Seat 4: Hero ($5.9 in chips)
Seat 5: d1364679 ($7.92 in chips)
Seat 6: bf4e2b6b ($10.28 in chips)
63f3fdb: posts small blind $0.02
f802204: posts big blind $0.05
*** HOLE CARDS ***
Dealt to 2b5a7a1b 
Dealt to 63f3fdb 
Dealt to f802204 
Dealt to Hero [4s 2s]
Dealt to d1364679 
Dealt to bf4e2b6b 
Hero: folds
d1364679: folds
bf4e2b6b: folds
2b5a7a1b: folds
63f3fdb: raises $0.1 to $0.15
f802204: folds
Uncalled bet ($0.1) returned to 63f3fdb
*** SHOWDOWN ***
63f3fdb collected $0.1 from pot
*** SUMMARY ***
Total pot $0.1 | Rake $0 | Jackpot $0 | Bingo $0 | Fortune $0 | Tax $0
Seat 1: 2b5a7a1b (button) folded before Flop (didn't bet)
Seat 2: 63f3fdb (small blind) collected ($0.1)
Seat 3: f802204 (big blind) folded before Flop
Seat 4: Hero folded before Flop (didn't bet)
Seat 5: d1364679 folded before Flop (didn't bet)
Seat 6: bf4e2b6b folded before Flop (didn't bet)


Poker Hand #RC3795926011: Hold'em No Limit ($0.02/$0.05) - 2025/08/10 08:04:19
Table 'RushAndCash11061271' 6-max Seat #1 is the button
Seat 1: f0e15475 ($5.98 in chips)
Seat 2: 85e4ce3a ($14.92 in chips)
Seat 3: 82af3a70 ($8.55 in chips)
Seat 4: accb3720 ($5.34 in chips)
Seat 5: Hero ($5.9 in chips)
Seat 6: df963cf7 ($4.94 in chips)
85e4ce3a: posts small blind $0.02
82af3a70: posts big blind $0.05
*** HOLE CARDS ***
Dealt to f0e15475 
Dealt to 85e4ce3a 
Dealt to 82af3a70 
Dealt to accb3720 
Dealt to Hero [3c Th]
Dealt to df963cf7 
accb3720: folds
Hero: folds
df963cf7: raises $0.05 to $0.1
f0e15475: folds
85e4ce3a: folds
82af3a70: folds
Uncalled bet ($0.05) returned to df963cf7
*** SHOWDOWN ***
df963cf7 collected $0.12 from pot
*** SUMMARY ***
Total pot $0.12 | Rake $0 | Jackpot $0 | Bingo $0 | Fortune $0 | Tax $0
Seat 1: f0e15475 (button) folded before Flop (didn't bet)
Seat 2: 85e4ce3a (small blind) folded before Flop
Seat 3: 82af3a70 (big blind) folded before Flop
Seat 4: accb3720 folded before Flop (didn't bet)
Seat 5: Hero folded before Flop (didn't bet)
Seat 6: df963cf7 collected ($0.12)


Poker Hand #RC3795925939: Hold'em No Limit ($0.02/$0.05) - 2025/08/10 08:03:59
Table 'RushAndCash11061199' 6-max Seat #1 is the button
Seat 1: Hero ($5.83 in chips)
Seat 2: 667b62d6 ($5.53 in chips)
Seat 3: 6f8f726b ($11.67 in chips)
Seat 4: 808de8ec ($2.83 in chips)
Seat 5: d5b42329 ($8.93 in chips)
Seat 6: f0e15475 ($6.05 in chips)
667b62d6: posts small blind $0.02
6f8f726b: posts big blind $0.05
*** HOLE CARDS ***
Dealt to Hero [Tc Ks]
Dealt to 667b62d6 
Dealt to 6f8f726b 
Dealt to 808de8ec 
Dealt to d5b42329 
Dealt to f0e15475 
808de8ec: folds
d5b42329: folds
f0e15475: folds
Hero: raises $0.05 to $0.1
667b62d6: folds
6f8f726b: folds
Uncalled bet ($0.05) returned to Hero
*** SHOWDOWN ***
Hero collected $0.12 from pot
*** SUMMARY ***
Total pot $0.12 | Rake $0 | Jackpot $0 | Bingo $0 | Fortune $0 | Tax $0
Seat 1: Hero (button) collected ($0.12)
Seat 2: 667b62d6 (small blind) folded before Flop
Seat 3: 6f8f726b (big blind) folded before Flop
Seat 4: 808de8ec folded before Flop (didn't bet)
Seat 5: d5b42329 folded before Flop (didn't bet)
Seat 6: f0e15475 folded before Flop (didn't bet)


Poker Hand #RC3795925763: Hold'em No Limit ($0.02/$0.05) - 2025/08/10 08:03:09
Table 'RushAndCash11061023' 6-max Seat #1 is the button
Seat 1: 902f8c64 ($5 in chips)
Seat 2: Hero ($5.17 in chips)
Seat 3: 9b73cb59 ($9.66 in chips)
Seat 4: 8223f77a ($5.39 in chips)
Seat 5: 6369b6bc ($5.07 in chips)
Seat 6: 9a343d90 ($9.08 in chips)
Hero: posts small blind $0.02
9b73cb59: posts big blind $0.05
*** HOLE CARDS ***
Dealt to 902f8c64 
Dealt to Hero [Ah 9h]
Dealt to 9b73cb59 
Dealt to 8223f77a 
Dealt to 6369b6bc 
Dealt to 9a343d90 
8223f77a: folds
6369b6bc: folds
9a343d90: folds
902f8c64: folds
Hero: raises $0.05 to $0.1
9b73cb59: raises $0.3 to $0.4
Hero: calls $0.3
*** FLOP *** [9c Jh Js]
Hero: checks
9b73cb59: bets $0.4
Hero: calls $0.4
*** TURN *** [9c Jh Js] [4d]
Hero: checks
9b73cb59: checks
*** RIVER *** [9c Jh Js 4d] [2c]
Hero: checks
9b73cb59: checks
Hero: shows [Ah 9h] (two pair, Jacks and Nines)
9b73cb59: shows [5h Ac] (a pair of Jacks)
*** SHOWDOWN ***
Hero collected $1.46 from pot
*** SUMMARY ***
Total pot $1.6 | Rake $0.07 | Jackpot $0.07 | Bingo $0 | Fortune $0 | Tax $0
Board [9c Jh Js 4d 2c]
Seat 1: 902f8c64 (button) folded before Flop (didn't bet)
Seat 2: Hero (small blind) showed [Ah 9h] and won ($1.46) with two pair, Jacks and Nines
Seat 3: 9b73cb59 (big blind) showed [5h Ac] and lost with a pair of Jacks
Seat 4: 8223f77a folded before Flop (didn't bet)
Seat 5: 6369b6bc folded before Flop (didn't bet)
Seat 6: 9a343d90 folded before Flop (didn't bet)


Poker Hand #RC3795925706: Hold'em No Limit ($0.02/$0.05) - 2025/08/10 08:02:54
Table 'RushAndCash11060966' 6-max Seat #1 is the button
Seat 1: b0fd3437 ($7.87 in chips)
Seat 2: db22ee6f ($5.35 in chips)
Seat 3: Hero ($5.22 in chips)
Seat 4: 41ed372d ($5.34 in chips)
Seat 5: 73990939 ($16.85 in chips)
Seat 6: a127404a ($4.47 in chips)
db22ee6f: posts small blind $0.02
Hero: posts big blind $0.05
*** HOLE CARDS ***
Dealt to b0fd3437 
Dealt to db22ee6f 
Dealt to Hero [Qs 3s]
Dealt to 41ed372d 
Dealt to 73990939 
Dealt to a127404a 
41ed372d: folds
73990939: folds
a127404a: folds
b0fd3437: raises $0.08 to $0.13
db22ee6f: raises $0.37 to $0.5
Hero: folds
b0fd3437: calls $0.37
*** FLOP *** [Kd 2c Kh]
db22ee6f: checks
b0fd3437: checks
*** TURN *** [Kd 2c Kh] [Qd]
db22ee6f: bets $0.35
b0fd3437: calls $0.35
*** RIVER *** [Kd 2c Kh Qd] [4h]
db22ee6f: bets $0.88
b0fd3437: folds
Uncalled bet ($0.88) returned to db22ee6f
*** SHOWDOWN ***
db22ee6f collected $1.6 from pot
*** SUMMARY ***
Total pot $1.75 | Rake $0.08 | Jackpot $0.07 | Bingo $0 | Fortune $0 | Tax $0
Board [Kd 2c Kh Qd 4h]
Seat 1: b0fd3437 (button) folded on the River
Seat 2: db22ee6f (small blind) won ($1.6)
Seat 3: Hero (big blind) folded before Flop
Seat 4: 41ed372d folded before Flop (didn't bet)
Seat 5: 73990939 folded before Flop (didn't bet)
Seat 6: a127404a folded before Flop (didn't bet)


Poker Hand #RC3795925692: Hold'em No Limit ($0.02/$0.05) - 2025/08/10 08:02:51
Table 'RushAndCash11060952' 6-max Seat #1 is the button
Seat 1: 3533113a ($10.67 in chips)
Seat 2: 9307ed45 ($4.69 in chips)
Seat 3: 83e19d4d ($5.48 in chips)
Seat 4: ccc2fe0 ($5 in chips)
Seat 5: Hero ($5.22 in chips)
Seat 6: 667b62d6 ($6.54 in chips)
9307ed45: posts small blind $0.02
83e19d4d: posts big blind $0.05
*** HOLE CARDS ***
Dealt to 3533113a 
Dealt to 9307ed45 
Dealt to 83e19d4d 
Dealt to ccc2fe0 
Dealt to Hero [Js 3d]
Dealt to 667b62d6 
ccc2fe0: folds
Hero: folds
667b62d6: raises $0.08 to $0.13
3533113a: folds
9307ed45: calls $0.11
83e19d4d: folds
*** FLOP *** [3s Ks Tc]
9307ed45: checks
667b62d6: bets $0.11
9307ed45: calls $0.11
*** TURN *** [3s Ks Tc] [2h]
9307ed45: checks
667b62d6: bets $0.75
9307ed45: calls $0.75
*** RIVER *** [3s Ks Tc 2h] [6d]
9307ed45: checks
667b62d6: checks
9307ed45: shows [Ac Td] (a pair of Tens)
667b62d6: shows [As 9s] (Ace high)
*** SHOWDOWN ***
9307ed45 collected $1.87 from pot
*** SUMMARY ***
Total pot $2.03 | Rake $0.09 | Jackpot $0.07 | Bingo $0 | Fortune $0 | Tax $0
Board [3s Ks Tc 2h 6d]
Seat 1: 3533113a (button) folded before Flop (didn't bet)
Seat 2: 9307ed45 (small blind) showed [Ac Td] and won ($1.87) with a pair of Tens
Seat 3: 83e19d4d (big blind) folded before Flop
Seat 4: ccc2fe0 folded before Flop (didn't bet)
Seat 5: Hero folded before Flop (didn't bet)
Seat 6: 667b62d6 showed [As 9s] and lost with Ace high


Poker Hand #RC3795925679: Hold'em No Limit ($0.02/$0.05) - 2025/08/10 08:02:47
Table 'RushAndCash11060939' 6-max Seat #1 is the button
Seat 1: 422df7c3 ($5 in chips)
Seat 2: 6e6b280f ($6.29 in chips)
Seat 3: c1d96785 ($11.35 in chips)
Seat 4: 65d0d71f ($5.24 in chips)
Seat 5: Hero ($5.22 in chips)
Seat 6: c47898d9 ($5.83 in chips)
6e6b280f: posts small blind $0.02
c1d96785: posts big blind $0.05
*** HOLE CARDS ***
Dealt to 422df7c3 
Dealt to 6e6b280f 
Dealt to c1d96785 
Dealt to 65d0d71f 
Dealt to Hero [3h 5d]
Dealt to c47898d9 
65d0d71f: folds
Hero: folds
c47898d9: raises $0.07 to $0.12
422df7c3: folds
6e6b280f: folds
c1d96785: raises $0.33 to $0.45
c47898d9: folds
Uncalled bet ($0.33) returned to c1d96785
*** SHOWDOWN ***
c1d96785 collected $0.25 from pot
*** SUMMARY ***
Total pot $0.26 | Rake $0.01 | Jackpot $0 | Bingo $0 | Fortune $0 | Tax $0
Seat 1: 422df7c3 (button) folded before Flop (didn't bet)
Seat 2: 6e6b280f (small blind) folded before Flop
Seat 3: c1d96785 (big blind) collected ($0.25)
Seat 4: 65d0d71f folded before Flop (didn't bet)
Seat 5: Hero folded before Flop (didn't bet)
Seat 6: c47898d9 folded before Flop


Poker Hand #RC3795925499: Hold'em No Limit ($0.02/$0.05) - 2025/08/10 08:01:53
Table 'RushAndCash11060759' 6-max Seat #1 is the button
Seat 1: edfd9c9a ($13.82 in chips)
Seat 2: bf51b512 ($5.09 in chips)
Seat 3: 6e6b280f ($6.57 in chips)
Seat 4: 79ab917c ($5.59 in chips)
Seat 5: cf3b419d ($6.09 in chips)
Seat 6: Hero ($4.94 in chips)
bf51b512: posts small blind $0.02
6e6b280f: posts big blind $0.05
*** HOLE CARDS ***
Dealt to edfd9c9a 
Dealt to bf51b512 
Dealt to 6e6b280f 
Dealt to 79ab917c 
Dealt to cf3b419d 
Dealt to Hero [Td Qh]
79ab917c: folds
cf3b419d: folds
Hero: raises $0.05 to $0.1
edfd9c9a: folds
bf51b512: folds
6e6b280f: calls $0.05
*** FLOP *** [8h 6h Jd]
6e6b280f: checks
Hero: bets $0.18
6e6b280f: calls $0.18
*** TURN *** [8h 6h Jd] [4s]
6e6b280f: checks
Hero: bets $0.28
6e6b280f: folds
Uncalled bet ($0.28) returned to Hero
*** SHOWDOWN ***
Hero collected $0.56 from pot
*** SUMMARY ***
Total pot $0.58 | Rake $0.02 | Jackpot $0 | Bingo $0 | Fortune $0 | Tax $0
Board [8h 6h Jd 4s]
Seat 1: edfd9c9a (button) folded before Flop (didn't bet)
Seat 2: bf51b512 (small blind) folded before Flop
Seat 3: 6e6b280f (big blind) folded on the Turn
Seat 4: 79ab917c folded before Flop (didn't bet)
Seat 5: cf3b419d folded before Flop (didn't bet)
Seat 6: Hero won ($0.56)


Poker Hand #RC3795925477: Hold'em No Limit ($0.02/$0.05) - 2025/08/10 08:01:48
Table 'RushAndCash11060737' 6-max Seat #1 is the button
Seat 1: Hero ($4.94 in chips)
Seat 2: 336dc8b4 ($9.08 in chips)
Seat 3: 4cd607b4 ($7.8 in chips)
Seat 4: e8d6e6da ($5.16 in chips)
Seat 5: ee66d68d ($5 in chips)
Seat 6: 8d7849e9 ($5 in chips)
336dc8b4: posts small blind $0.02
4cd607b4: posts big blind $0.05
*** HOLE CARDS ***
Dealt to Hero [4d Ac]
Dealt to 336dc8b4 
Dealt to 4cd607b4 
Dealt to e8d6e6da 
Dealt to ee66d68d 
Dealt to 8d7849e9 
e8d6e6da: folds
ee66d68d: folds
8d7849e9: folds
Hero: folds
336dc8b4: folds
Uncalled bet ($0.03) returned to 4cd607b4
*** SHOWDOWN ***
4cd607b4 collected $0.04 from pot
*** SUMMARY ***
Total pot $0.04 | Rake $0 | Jackpot $0 | Bingo $0 | Fortune $0 | Tax $0
Seat 1: Hero (button) folded before Flop (didn't bet)
Seat 2: 336dc8b4 (small blind) folded before Flop
Seat 3: 4cd607b4 (big blind) collected ($0.04)
Seat 4: e8d6e6da folded before Flop (didn't bet)
Seat 5: ee66d68d folded before Flop (didn't bet)
Seat 6: 8d7849e9 folded before Flop (didn't bet)


Poker Hand #RC3795925367: Hold'em No Limit ($0.02/$0.05) - 2025/08/10 08:01:20
Table 'RushAndCash11060627' 6-max Seat #1 is the button
Seat 1: bbe9b1b1 ($6.42 in chips)
Seat 2: Hero ($5.04 in chips)
Seat 3: db3b59eb ($8.3 in chips)
Seat 4: 3533113a ($8.73 in chips)
Seat 5: b5d00661 ($4.87 in chips)
Seat 6: ee66d68d ($5 in chips)
Hero: posts small blind $0.02
db3b59eb: posts big blind $0.05
*** HOLE CARDS ***
Dealt to bbe9b1b1 
Dealt to Hero [Td Jc]
Dealt to db3b59eb 
Dealt to 3533113a 
Dealt to b5d00661 
Dealt to ee66d68d 
3533113a: raises $0.05 to $0.1
b5d00661: folds
ee66d68d: folds
bbe9b1b1: folds
Hero: calls $0.08
db3b59eb: raises $0.52 to $0.62
3533113a: calls $0.52
Hero: folds
*** FLOP *** [2c 9d Qh]
db3b59eb: bets $0.34
3533113a: calls $0.34
*** TURN *** [2c 9d Qh] [3h]
db3b59eb: bets $0.44
3533113a: calls $0.44
*** RIVER *** [2c 9d Qh 3h] [9c]
db3b59eb: bets $0.73
3533113a: raises $4.57 to $5.3
db3b59eb: folds
Uncalled bet ($4.57) returned to 3533113a
*** SHOWDOWN ***
3533113a collected $4.14 from pot
*** SUMMARY ***
Total pot $4.36 | Rake $0.15 | Jackpot $0.07 | Bingo $0 | Fortune $0 | Tax $0
Board [2c 9d Qh 3h 9c]
Seat 1: bbe9b1b1 (button) folded before Flop (didn't bet)
Seat 2: Hero (small blind) folded before Flop
Seat 3: db3b59eb (big blind) folded on the River
Seat 4: 3533113a won ($4.14)
Seat 5: b5d00661 folded before Flop (didn't bet)
Seat 6: ee66d68d folded before Flop (didn't bet)


Poker Hand #RC3795925139: Hold'em No Limit ($0.02/$0.05) - 2025/08/10 08:00:21
Table 'RushAndCash11060399' 6-max Seat #1 is the button
Seat 1: 8a1cdc04 ($4.91 in chips)
Seat 2: d5bb3acb ($4.21 in chips)
Seat 3: Hero ($4.77 in chips)
Seat 4: f802204 ($5.12 in chips)
Seat 5: bbe9b1b1 ($6.69 in chips)
Seat 6: c47206f4 ($10.84 in chips)
d5bb3acb: posts small blind $0.02
Hero: posts big blind $0.05
*** HOLE CARDS ***
Dealt to 8a1cdc04 
Dealt to d5bb3acb 
Dealt to Hero [Jh 7h]
Dealt to f802204 
Dealt to bbe9b1b1 
Dealt to c47206f4 
f802204: folds
bbe9b1b1: raises $0.07 to $0.12
c47206f4: folds
8a1cdc04: folds
d5bb3acb: folds
Hero: calls $0.07
*** FLOP *** [9s 8h 9c]
Hero: checks
bbe9b1b1: checks
*** TURN *** [9s 8h 9c] [Qs]
Hero: checks
bbe9b1b1: bets $0.15
Hero: raises $0.44 to $0.59
bbe9b1b1: folds
Uncalled bet ($0.44) returned to Hero
*** SHOWDOWN ***
Hero collected $0.54 from pot
*** SUMMARY ***
Total pot $0.56 | Rake $0.02 | Jackpot $0 | Bingo $0 | Fortune $0 | Tax $0
Board [9s 8h 9c Qs]
Seat 1: 8a1cdc04 (button) folded before Flop (didn't bet)
Seat 2: d5bb3acb (small blind) folded before Flop
Seat 3: Hero (big blind) won ($0.54)
Seat 4: f802204 folded before Flop (didn't bet)
Seat 5: bbe9b1b1 folded on the Turn
Seat 6: c47206f4 folded before Flop (didn't bet)


Poker Hand #RC3795925127: Hold'em No Limit ($0.02/$0.05) - 2025/08/10 08:00:17
Table 'RushAndCash11060387' 6-max Seat #1 is the button
Seat 1: 665d5285 ($10.62 in chips)
Seat 2: f8933a7f ($20.11 in chips)
Seat 3: d5b42329 ($6.3 in chips)
Seat 4: e38aa1e7 ($5.55 in chips)
Seat 5: Hero ($4.77 in chips)
Seat 6: c47206f4 ($10.84 in chips)
f8933a7f: posts small blind $0.02
d5b42329: posts big blind $0.05
*** HOLE CARDS ***
Dealt to 665d5285 
Dealt to f8933a7f 
Dealt to d5b42329 
Dealt to e38aa1e7 
Dealt to Hero [4h 3s]
Dealt to c47206f4 
e38aa1e7: folds
Hero: folds
c47206f4: folds
665d5285: folds
f8933a7f: raises $0.1 to $0.15
d5b42329: raises $0.3 to $0.45
f8933a7f: folds
Uncalled bet ($0.3) returned to d5b42329
*** SHOWDOWN ***
d5b42329 collected $0.29 from pot
*** SUMMARY ***
Total pot $0.3 | Rake $0.01 | Jackpot $0 | Bingo $0 | Fortune $0 | Tax $0
Seat 1: 665d5285 (button) folded before Flop (didn't bet)
Seat 2: f8933a7f (small blind) folded before Flop
Seat 3: d5b42329 (big blind) collected ($0.29)
Seat 4: e38aa1e7 folded before Flop (didn't bet)
Seat 5: Hero folded before Flop (didn't bet)
Seat 6: c47206f4 folded before Flop (didn't bet)


Poker Hand #RC3795925113: Hold'em No Limit ($0.02/$0.05) - 2025/08/10 08:00:14
Table 'RushAndCash11060373' 6-max Seat #1 is the button
Seat 1: a4b58f11 ($11.8 in chips)
Seat 2: 147849a7 ($5.01 in chips)
Seat 3: c59a8aab ($10.29 in chips)
Seat 4: 7b419a6a ($7.59 in chips)
Seat 5: 4b731a27 ($6.1 in chips)
Seat 6: Hero ($4.77 in chips)
147849a7: posts small blind $0.02
c59a8aab: posts big blind $0.05
*** HOLE CARDS ***
Dealt to a4b58f11 
Dealt to 147849a7 
Dealt to c59a8aab 
Dealt to 7b419a6a 
Dealt to 4b731a27 
Dealt to Hero [4d Jc]
7b419a6a: folds
4b731a27: folds
Hero: folds
a4b58f11: raises $0.07 to $0.12
147849a7: raises $0.43 to $0.55
c59a8aab: folds
a4b58f11: folds
Uncalled bet ($0.43) returned to 147849a7
*** SHOWDOWN ***
147849a7 collected $0.28 from pot
*** SUMMARY ***
Total pot $0.29 | Rake $0.01 | Jackpot $0 | Bingo $0 | Fortune $0 | Tax $0
Seat 1: a4b58f11 (button) folded before Flop
Seat 2: 147849a7 (small blind) collected ($0.28)
Seat 3: c59a8aab (big blind) folded before Flop
Seat 4: 7b419a6a folded before Flop (didn't bet)
Seat 5: 4b731a27 folded before Flop (didn't bet)
Seat 6: Hero folded before Flop (didn't bet)


Poker Hand #RC3795925098: Hold'em No Limit ($0.02/$0.05) - 2025/08/10 08:00:10
Table 'RushAndCash11060358' 6-max Seat #1 is the button
Seat 1: 4b731a27 ($6.1 in chips)
Seat 2: 21c45711 ($5 in chips)
Seat 3: 38df6650 ($5.1 in chips)
Seat 4: c59a8aab ($10.29 in chips)
Seat 5: Hero ($4.77 in chips)
Seat 6: 9b73cb59 ($5.07 in chips)
21c45711: posts small blind $0.02
38df6650: posts big blind $0.05
*** HOLE CARDS ***
Dealt to 4b731a27 
Dealt to 21c45711 
Dealt to 38df6650 
Dealt to c59a8aab 
Dealt to Hero [2c 5d]
Dealt to 9b73cb59 
c59a8aab: folds
Hero: folds
9b73cb59: folds
4b731a27: folds
21c45711: folds
Uncalled bet ($0.03) returned to 38df6650
*** SHOWDOWN ***
38df6650 collected $0.04 from pot
*** SUMMARY ***
Total pot $0.04 | Rake $0 | Jackpot $0 | Bingo $0 | Fortune $0 | Tax $0
Seat 1: 4b731a27 (button) folded before Flop (didn't bet)
Seat 2: 21c45711 (small blind) folded before Flop
Seat 3: 38df6650 (big blind) collected ($0.04)
Seat 4: c59a8aab folded before Flop (didn't bet)
Seat 5: Hero folded before Flop (didn't bet)
Seat 6: 9b73cb59 folded before Flop (didn't bet)


Poker Hand #RC3795925084: Hold'em No Limit ($0.02/$0.05) - 2025/08/10 08:00:07
Table 'RushAndCash11060344' 6-max Seat #1 is the button
Seat 1: 946378a8 ($5.23 in chips)
Seat 2: 6412bd28 ($5.14 in chips)
Seat 3: e38ce9f1 ($18.8 in chips)
Seat 4: 8124f7fc ($7.67 in chips)
Seat 5: Hero ($4.77 in chips)
Seat 6: 2a76f9f5 ($6.88 in chips)
6412bd28: posts small blind $0.02
e38ce9f1: posts big blind $0.05
*** HOLE CARDS ***
Dealt to 946378a8 
Dealt to 6412bd28 
Dealt to e38ce9f1 
Dealt to 8124f7fc 
Dealt to Hero [Jd 2h]
Dealt to 2a76f9f5 
8124f7fc: calls $0.05
Hero: folds
2a76f9f5: folds
946378a8: raises $0.05 to $0.1
6412bd28: folds
e38ce9f1: folds
8124f7fc: calls $0.05
*** FLOP *** [7c 8d Jc]
8124f7fc: bets $0.09
946378a8: raises $0.45 to $0.54
8124f7fc: calls $0.45
*** TURN *** [7c 8d Jc] [3c]
8124f7fc: bets $0.45
946378a8: calls $0.45
*** RIVER *** [7c 8d Jc 3c] [4h]
8124f7fc: bets $0.75
946378a8: calls $0.75
8124f7fc: shows [9c 8c] (a flush Jack high)
946378a8: shows [7h 7s] (three of a kind, Sevens)
*** SHOWDOWN ***
8124f7fc collected $3.53 from pot
*** SUMMARY ***
Total pot $3.75 | Rake $0.15 | Jackpot $0.07 | Bingo $0 | Fortune $0 | Tax $0
Board [7c 8d Jc 3c 4h]
Seat 1: 946378a8 (button) showed [7h 7s] and lost with three of a kind, Sevens
Seat 2: 6412bd28 (small blind) folded before Flop
Seat 3: e38ce9f1 (big blind) folded before Flop
Seat 4: 8124f7fc showed [9c 8c] and won ($3.53) with a flush Jack high
Seat 5: Hero folded before Flop (didn't bet)
Seat 6: 2a76f9f5 folded before Flop (didn't bet)


Poker Hand #RC3795924961: Hold'em No Limit ($0.02/$0.05) - 2025/08/10 07:59:33
Table 'RushAndCash11060221' 6-max Seat #1 is the button
Seat 1: e8380f03 ($5 in chips)
Seat 2: Hero ($5.17 in chips)
Seat 3: 6412bd28 ($4.68 in chips)
Seat 4: 946a295c ($10.29 in chips)
Seat 5: c47898d9 ($5.04 in chips)
Seat 6: 72f7d641 ($7.7 in chips)
Hero: posts small blind $0.02
6412bd28: posts big blind $0.05
*** HOLE CARDS ***
Dealt to e8380f03 
Dealt to Hero [Tc 8c]
Dealt to 6412bd28 
Dealt to 946a295c 
Dealt to c47898d9 
Dealt to 72f7d641 
946a295c: folds
c47898d9: raises $0.05 to $0.1
72f7d641: folds
e8380f03: folds
Hero: raises $0.3 to $0.4
6412bd28: raises $0.9 to $1.3
c47898d9: folds
Hero: folds
Uncalled bet ($0.9) returned to 6412bd28
*** SHOWDOWN ***
6412bd28 collected $0.86 from pot
*** SUMMARY ***
Total pot $0.9 | Rake $0.04 | Jackpot $0 | Bingo $0 | Fortune $0 | Tax $0
Seat 1: e8380f03 (button) folded before Flop (didn't bet)
Seat 2: Hero (small blind) folded before Flop
Seat 3: 6412bd28 (big blind) collected ($0.86)
Seat 4: 946a295c folded before Flop (didn't bet)
Seat 5: c47898d9 folded before Flop
Seat 6: 72f7d641 folded before Flop (didn't bet)


Poker Hand #RC3795924942: Hold'em No Limit ($0.02/$0.05) - 2025/08/10 07:59:28
Table 'RushAndCash11060202' 6-max Seat #1 is the button
Seat 1: 5bde674d ($6.83 in chips)
Seat 2: 8d1c252c ($6.25 in chips)
Seat 3: Hero ($5.22 in chips)
Seat 4: 560bbe0d ($7.77 in chips)
Seat 5: d6a2912 ($5.36 in chips)
Seat 6: f38b69c2 ($10.1 in chips)
8d1c252c: posts small blind $0.02
Hero: posts big blind $0.05
*** HOLE CARDS ***
Dealt to 5bde674d 
Dealt to 8d1c252c 
Dealt to Hero [4d Jc]
Dealt to 560bbe0d 
Dealt to d6a2912 
Dealt to f38b69c2 
560bbe0d: folds
d6a2912: raises $0.05 to $0.1
f38b69c2: raises $0.21 to $0.31
5bde674d: folds
8d1c252c: folds
Hero: folds
d6a2912: folds
Uncalled bet ($0.21) returned to f38b69c2
*** SHOWDOWN ***
f38b69c2 collected $0.26 from pot
*** SUMMARY ***
Total pot $0.27 | Rake $0.01 | Jackpot $0 | Bingo $0 | Fortune $0 | Tax $0
Seat 1: 5bde674d (button) folded before Flop (didn't bet)
Seat 2: 8d1c252c (small blind) folded before Flop
Seat 3: Hero (big blind) folded before Flop
Seat 4: 560bbe0d folded before Flop (didn't bet)
Seat 5: d6a2912 folded before Flop
Seat 6: f38b69c2 collected ($0.26)


Poker Hand #RC3795924925: Hold'em No Limit ($0.02/$0.05) - 2025/08/10 07:59:23
Table 'RushAndCash11060185' 6-max Seat #1 is the button
Seat 1: Hero ($5.22 in chips)
Seat 2: fd12bd66 ($3.07 in chips)
Seat 3: 65376f32 ($3.81 in chips)
Seat 4: ca112d1 ($9.57 in chips)
Seat 5: 74f4cd20 ($9.02 in chips)
Seat 6: 5d71c963 ($7.26 in chips)
fd12bd66: posts small blind $0.02
65376f32: posts big blind $0.05
*** HOLE CARDS ***
Dealt to Hero [7c 4d]
Dealt to fd12bd66 
Dealt to 65376f32 
Dealt to ca112d1 
Dealt to 74f4cd20 
Dealt to 5d71c963 
ca112d1: folds
74f4cd20: folds
5d71c963: folds
Hero: folds
fd12bd66: raises $0.05 to $0.1
65376f32: raises $0.2 to $0.3
fd12bd66: calls $0.2
*** FLOP *** [9s 8h 9d]
fd12bd66: checks
65376f32: checks
*** TURN *** [9s 8h 9d] [2d]
fd12bd66: checks
65376f32: bets $0.21
fd12bd66: calls $0.21
*** RIVER *** [9s 8h 9d 2d] [5d]
fd12bd66: checks
65376f32: bets $1.02
fd12bd66: folds
Uncalled bet ($1.02) returned to 65376f32
*** SHOWDOWN ***
65376f32 collected $0.97 from pot
*** SUMMARY ***
Total pot $1.02 | Rake $0.05 | Jackpot $0 | Bingo $0 | Fortune $0 | Tax $0
Board [9s 8h 9d 2d 5d]
Seat 1: Hero (button) folded before Flop (didn't bet)
Seat 2: fd12bd66 (small blind) folded on the River
Seat 3: 65376f32 (big blind) won ($0.97)
Seat 4: ca112d1 folded before Flop (didn't bet)
Seat 5: 74f4cd20 folded before Flop (didn't bet)
Seat 6: 5d71c963 folded before Flop (didn't bet)


Poker Hand #RC3795924910: Hold'em No Limit ($0.02/$0.05) - 2025/08/10 07:59:20
Table 'RushAndCash11060170' 6-max Seat #1 is the button
Seat 1: ca112d1 ($9.57 in chips)
Seat 2: 3bd13722 ($7.56 in chips)
Seat 3: fc1e46cd ($5.96 in chips)
Seat 4: db22ee6f ($5.42 in chips)
Seat 5: 26231614 ($2.19 in chips)
Seat 6: Hero ($5.22 in chips)
3bd13722: posts small blind $0.02
fc1e46cd: posts big blind $0.05
*** HOLE CARDS ***
Dealt to ca112d1 
Dealt to 3bd13722 
Dealt to fc1e46cd 
Dealt to db22ee6f 
Dealt to 26231614 
Dealt to Hero [5c 7c]
db22ee6f: folds
26231614: folds
Hero: folds
ca112d1: folds
3bd13722: raises $0.1 to $0.15
fc1e46cd: folds
Uncalled bet ($0.1) returned to 3bd13722
*** SHOWDOWN ***
3bd13722 collected $0.1 from pot
*** SUMMARY ***
Total pot $0.1 | Rake $0 | Jackpot $0 | Bingo $0 | Fortune $0 | Tax $0
Seat 1: ca112d1 (button) folded before Flop (didn't bet)
Seat 2: 3bd13722 (small blind) collected ($0.1)
Seat 3: fc1e46cd (big blind) folded before Flop
Seat 4: db22ee6f folded before Flop (didn't bet)
Seat 5: 26231614 folded before Flop (didn't bet)
Seat 6: Hero folded before Flop (didn't bet)


Poker Hand #RC3795924897: Hold'em No Limit ($0.02/$0.05) - 2025/08/10 07:59:16
Table 'RushAndCash11060157' 6-max Seat #1 is the button
Seat 1: 948d9171 ($5 in chips)
Seat 2: 7a6d1984 ($9.04 in chips)
Seat 3: dca1c3af ($3.34 in chips)
Seat 4: Hero ($5.22 in chips)
Seat 5: f009f5ba ($5.89 in chips)
Seat 6: db22ee6f ($5.42 in chips)
7a6d1984: posts small blind $0.02
dca1c3af: posts big blind $0.05
*** HOLE CARDS ***
Dealt to 948d9171 
Dealt to 7a6d1984 
Dealt to dca1c3af 
Dealt to Hero [7d 2c]
Dealt to f009f5ba 
Dealt to db22ee6f 
Hero: folds
f009f5ba: folds
db22ee6f: folds
948d9171: folds
7a6d1984: folds
Uncalled bet ($0.03) returned to dca1c3af
*** SHOWDOWN ***
dca1c3af collected $0.04 from pot
*** SUMMARY ***
Total pot $0.04 | Rake $0 | Jackpot $0 | Bingo $0 | Fortune $0 | Tax $0
Seat 1: 948d9171 (button) folded before Flop (didn't bet)
Seat 2: 7a6d1984 (small blind) folded before Flop
Seat 3: dca1c3af (big blind) collected ($0.04)
Seat 4: Hero folded before Flop (didn't bet)
Seat 5: f009f5ba folded before Flop (didn't bet)
Seat 6: db22ee6f folded before Flop (didn't bet)


Poker Hand #RC3795924857: Hold'em No Limit ($0.02/$0.05) - 2025/08/10 07:59:05
Table 'RushAndCash11060117' 6-max Seat #1 is the button
Seat 1: f3a1d090 ($30.4 in chips)
Seat 2: 70573b8 ($4.88 in chips)
Seat 3: 2d1b3dec ($5.07 in chips)
Seat 4: 7536a717 ($5.69 in chips)
Seat 5: a6551a2a ($9.77 in chips)
Seat 6: Hero ($5.22 in chips)
70573b8: posts small blind $0.02
2d1b3dec: posts big blind $0.05
*** HOLE CARDS ***
Dealt to f3a1d090 
Dealt to 70573b8 
Dealt to 2d1b3dec 
Dealt to 7536a717 
Dealt to a6551a2a 
Dealt to Hero [Ad 5d]
7536a717: raises $0.1 to $0.15
a6551a2a: raises $0.3 to $0.45
Hero: folds
f3a1d090: folds
70573b8: folds
2d1b3dec: folds
7536a717: calls $0.3
*** FLOP *** [Ts 3s 8c]
7536a717: checks
a6551a2a: checks
*** TURN *** [Ts 3s 8c] [Ah]
7536a717: bets $0.33
a6551a2a: calls $0.33
*** RIVER *** [Ts 3s 8c Ah] [Jd]
7536a717: bets $0.54
a6551a2a: raises $8.45 to $8.99 and is all-in
7536a717: folds
Uncalled bet ($8.45) returned to a6551a2a
7536a717: shows [As] (a pair of Aces)
a6551a2a: shows [4d 4h] (a pair of Fours)
*** SHOWDOWN ***
a6551a2a collected $2.51 from pot
*** SUMMARY ***
Total pot $2.71 | Rake $0.13 | Jackpot $0.07 | Bingo $0 | Fortune $0 | Tax $0
Board [Ts 3s 8c Ah Jd]
Seat 1: f3a1d090 (button) folded before Flop (didn't bet)
Seat 2: 70573b8 (small blind) folded before Flop
Seat 3: 2d1b3dec (big blind) folded before Flop
Seat 4: 7536a717 folded on the River
Seat 5: a6551a2a showed [4d 4h] and won ($2.51)
Seat 6: Hero folded before Flop (didn't bet)


Poker Hand #RC3795924767: Hold'em No Limit ($0.02/$0.05) - 2025/08/10 07:58:43
Table 'RushAndCash11060027' 6-max Seat #1 is the button
Seat 1: 8223f77a ($5.09 in chips)
Seat 2: Hero ($5.17 in chips)
Seat 3: d7fd8492 ($11.07 in chips)
Seat 4: cb83453e ($5.05 in chips)
Seat 5: 5b54e251 ($11.32 in chips)
Seat 6: 48192790 ($2.06 in chips)
Hero: posts small blind $0.02
d7fd8492: posts big blind $0.05
*** HOLE CARDS ***
Dealt to 8223f77a 
Dealt to Hero [8c 8h]
Dealt to d7fd8492 
Dealt to cb83453e 
Dealt to 5b54e251 
Dealt to 48192790 
cb83453e: folds
5b54e251: folds
48192790: folds
8223f77a: folds
Hero: raises $0.05 to $0.1
d7fd8492: folds
Uncalled bet ($0.05) returned to Hero
*** SHOWDOWN ***
Hero collected $0.1 from pot
*** SUMMARY ***
Total pot $0.1 | Rake $0 | Jackpot $0 | Bingo $0 | Fortune $0 | Tax $0
Seat 1: 8223f77a (button) folded before Flop (didn't bet)
Seat 2: Hero (small blind) collected ($0.1)
Seat 3: d7fd8492 (big blind) folded before Flop
Seat 4: cb83453e folded before Flop (didn't bet)
Seat 5: 5b54e251 folded before Flop (didn't bet)
Seat 6: 48192790 folded before Flop (didn't bet)


Poker Hand #RC3795924746: Hold'em No Limit ($0.02/$0.05) - 2025/08/10 07:58:38
Table 'RushAndCash11060006' 6-max Seat #1 is the button
Seat 1: 9ef40456 ($6.05 in chips)
Seat 2: 562bc648 ($5 in chips)
Seat 3: Hero ($5.22 in chips)
Seat 4: 70573b8 ($4.93 in chips)
Seat 5: 196c1899 ($16.34 in chips)
Seat 6: 7b419a6a ($6.95 in chips)
562bc648: posts small blind $0.02
Hero: posts big blind $0.05
*** HOLE CARDS ***
Dealt to 9ef40456 
Dealt to 562bc648 
Dealt to Hero [Qc 3s]
Dealt to 70573b8 
Dealt to 196c1899 
Dealt to 7b419a6a 
70573b8: folds
196c1899: raises $0.05 to $0.1
7b419a6a: raises $0.1 to $0.2
9ef40456: folds
562bc648: folds
Hero: folds
196c1899: calls $0.1
*** FLOP *** [8d 8c 3c]
196c1899: checks
7b419a6a: bets $0.16
196c1899: folds
Uncalled bet ($0.16) returned to 7b419a6a
*** SHOWDOWN ***
7b419a6a collected $0.45 from pot
*** SUMMARY ***
Total pot $0.47 | Rake $0.02 | Jackpot $0 | Bingo $0 | Fortune $0 | Tax $0
Board [8d 8c 3c]
Seat 1: 9ef40456 (button) folded before Flop (didn't bet)
Seat 2: 562bc648 (small blind) folded before Flop
Seat 3: Hero (big blind) folded before Flop
Seat 4: 70573b8 folded before Flop (didn't bet)
Seat 5: 196c1899 folded on the Flop
Seat 6: 7b419a6a won ($0.45)


Poker Hand #RC3795894636: Hold'em No Limit ($0.02/$0.05) - 2025/08/10 07:58:13
Table 'RushAndCash11059896' 6-max Seat #1 is the button
Seat 1: Hero ($5.22 in chips)
Seat 2: 9a120dc3 ($9.63 in chips)
Seat 3: 55c5398 ($6.65 in chips)
Seat 4: 56c36787 ($5.17 in chips)
Seat 5: bbfaf9f3 ($5 in chips)
Seat 6: ed99f05f ($7.54 in chips)
9a120dc3: posts small blind $0.02
55c5398: posts big blind $0.05
*** HOLE CARDS ***
Dealt to Hero [2s 6d]
Dealt to 9a120dc3 
Dealt to 55c5398 
Dealt to 56c36787 
Dealt to bbfaf9f3 
Dealt to ed99f05f 
56c36787: folds
bbfaf9f3: folds
ed99f05f: folds
Hero: folds
9a120dc3: raises $0.1 to $0.15
55c5398: raises $0.3 to $0.45
9a120dc3: calls $0.3
*** FLOP *** [8s 8c 6s]
9a120dc3: checks
55c5398: checks
*** TURN *** [8s 8c 6s] [3h]
9a120dc3: bets $0.3
55c5398: calls $0.3
*** RIVER *** [8s 8c 6s 3h] [4h]
9a120dc3: bets $1.13
55c5398: calls $1.13
9a120dc3: shows [Js Jh] (two pair, Jacks and Eights)
55c5398: shows [6c Ac] (two pair, Eights and Sixes)
*** SHOWDOWN ***
9a120dc3 collected $3.54 from pot
*** SUMMARY ***
Total pot $3.76 | Rake $0.15 | Jackpot $0.07 | Bingo $0 | Fortune $0 | Tax $0
Board [8s 8c 6s 3h 4h]
Seat 1: Hero (button) folded before Flop (didn't bet)
Seat 2: 9a120dc3 (small blind) showed [Js Jh] and won ($3.54) with two pair, Jacks and Eights
Seat 3: 55c5398 (big blind) showed [6c Ac] and lost with two pair, Eights and Sixes
Seat 4: 56c36787 folded before Flop (didn't bet)
Seat 5: bbfaf9f3 folded before Flop (didn't bet)
Seat 6: ed99f05f folded before Flop (didn't bet)


Poker Hand #RC3795894466: Hold'em No Limit ($0.02/$0.05) - 2025/08/10 07:57:30
Table 'RushAndCash11059726' 6-max Seat #1 is the button
Seat 1: a63176ef ($7.88 in chips)
Seat 2: 55c5398 ($6.75 in chips)
Seat 3: 9fd1d64c ($5.34 in chips)
Seat 4: ed99f05f ($5.95 in chips)
Seat 5: eaca1ea ($7.23 in chips)
Seat 6: Hero ($5.32 in chips)
Cash Drop to Pot : total $0.5 
55c5398: posts small blind $0.02
9fd1d64c: posts big blind $0.05
*** HOLE CARDS ***
Dealt to a63176ef 
Dealt to 55c5398 
Dealt to 9fd1d64c 
Dealt to ed99f05f 
Dealt to eaca1ea 
Dealt to Hero [Ks 8d]
ed99f05f: raises $0.05 to $0.1
eaca1ea: folds
Hero: calls $0.1
a63176ef: folds
55c5398: calls $0.08
9fd1d64c: raises $1 to $1.1
ed99f05f: raises $4.85 to $5.95 and is all-in
Hero: folds
55c5398: folds
9fd1d64c: folds
Uncalled bet ($4.85) returned to ed99f05f
*** SHOWDOWN ***
ed99f05f collected $2.69 from pot
*** SUMMARY ***
Total pot $2.9 | Rake $0.14 | Jackpot $0.07 | Bingo $0 | Fortune $0 | Tax $0
Seat 1: a63176ef (button) folded before Flop (didn't bet)
Seat 2: 55c5398 (small blind) folded before Flop
Seat 3: 9fd1d64c (big blind) folded before Flop
Seat 4: ed99f05f collected ($2.69)
Seat 5: eaca1ea folded before Flop (didn't bet)
Seat 6: Hero folded before Flop


Poker Hand #RC3795894220: Hold'em No Limit ($0.02/$0.05) - 2025/08/10 07:56:22
Table 'RushAndCash11059480' 6-max Seat #1 is the button
Seat 1: ed99f05f ($6.31 in chips)
Seat 2: dca1c3af ($3.28 in chips)
Seat 3: b2bdc278 ($4.48 in chips)
Seat 4: Hero ($4.93 in chips)
Seat 5: b1b3930a ($5.55 in chips)
Seat 6: 14157496 ($6.98 in chips)
dca1c3af: posts small blind $0.02
b2bdc278: posts big blind $0.05
*** HOLE CARDS ***
Dealt to ed99f05f 
Dealt to dca1c3af 
Dealt to b2bdc278 
Dealt to Hero [Qh Jh]
Dealt to b1b3930a 
Dealt to 14157496 
Hero: raises $0.05 to $0.1
b1b3930a: folds
14157496: folds
ed99f05f: raises $0.26 to $0.36
dca1c3af: folds
b2bdc278: folds
Hero: calls $0.26
*** FLOP *** [8h 4c 6h]
Hero: checks
ed99f05f: checks
*** TURN *** [8h 4c 6h] [9d]
Hero: bets $0.94
ed99f05f: folds
Uncalled bet ($0.94) returned to Hero
*** SHOWDOWN ***
Hero collected $0.75 from pot
*** SUMMARY ***
Total pot $0.79 | Rake $0.04 | Jackpot $0 | Bingo $0 | Fortune $0 | Tax $0
Board [8h 4c 6h 9d]
Seat 1: ed99f05f (button) folded on the Turn
Seat 2: dca1c3af (small blind) folded before Flop
Seat 3: b2bdc278 (big blind) folded before Flop
Seat 4: Hero won ($0.75)
Seat 5: b1b3930a folded before Flop (didn't bet)
Seat 6: 14157496 folded before Flop (didn't bet)


Poker Hand #RC3795894193: Hold'em No Limit ($0.02/$0.05) - 2025/08/10 07:56:16
Table 'RushAndCash11059453' 6-max Seat #1 is the button
Seat 1: 9fb5ba89 ($4.46 in chips)
Seat 2: 6f47abe1 ($5.13 in chips)
Seat 3: 8124f7fc ($7.47 in chips)
Seat 4: bf4e2b6b ($10.87 in chips)
Seat 5: 4328ce0 ($4.82 in chips)
Seat 6: Hero ($4.93 in chips)
6f47abe1: posts small blind $0.02
8124f7fc: posts big blind $0.05
*** HOLE CARDS ***
Dealt to 9fb5ba89 
Dealt to 6f47abe1 
Dealt to 8124f7fc 
Dealt to bf4e2b6b 
Dealt to 4328ce0 
Dealt to Hero [6h Qs]
bf4e2b6b: folds
4328ce0: folds
Hero: folds
9fb5ba89: folds
6f47abe1: folds
Uncalled bet ($0.03) returned to 8124f7fc
*** SHOWDOWN ***
8124f7fc collected $0.04 from pot
*** SUMMARY ***
Total pot $0.04 | Rake $0 | Jackpot $0 | Bingo $0 | Fortune $0 | Tax $0
Seat 1: 9fb5ba89 (button) folded before Flop (didn't bet)
Seat 2: 6f47abe1 (small blind) folded before Flop
Seat 3: 8124f7fc (big blind) collected ($0.04)
Seat 4: bf4e2b6b folded before Flop (didn't bet)
Seat 5: 4328ce0 folded before Flop (didn't bet)
Seat 6: Hero folded before Flop (didn't bet)


Poker Hand #RC3795894164: Hold'em No Limit ($0.02/$0.05) - 2025/08/10 07:56:07
Table 'RushAndCash11059424' 6-max Seat #1 is the button
Seat 1: Hero ($4.93 in chips)
Seat 2: 9091f5 ($13.89 in chips)
Seat 3: 7a644870 ($5.12 in chips)
Seat 4: 8d7849e9 ($5.45 in chips)
Seat 5: d796f1b5 ($15.3 in chips)
Seat 6: 999a0f96 ($5.83 in chips)
9091f5: posts small blind $0.02
7a644870: posts big blind $0.05
*** HOLE CARDS ***
Dealt to Hero [3s Tc]
Dealt to 9091f5 
Dealt to 7a644870 
Dealt to 8d7849e9 
Dealt to d796f1b5 
Dealt to 999a0f96 
8d7849e9: folds
d796f1b5: folds
999a0f96: folds
Hero: folds
9091f5: folds
Uncalled bet ($0.03) returned to 7a644870
*** SHOWDOWN ***
7a644870 collected $0.04 from pot
*** SUMMARY ***
Total pot $0.04 | Rake $0 | Jackpot $0 | Bingo $0 | Fortune $0 | Tax $0
Seat 1: Hero (button) folded before Flop (didn't bet)
Seat 2: 9091f5 (small blind) folded before Flop
Seat 3: 7a644870 (big blind) collected ($0.04)
Seat 4: 8d7849e9 folded before Flop (didn't bet)
Seat 5: d796f1b5 folded before Flop (didn't bet)
Seat 6: 999a0f96 folded before Flop (didn't bet)


Poker Hand #RC3795894138: Hold'em No Limit ($0.02/$0.05) - 2025/08/10 07:55:59
Table 'RushAndCash11059398' 6-max Seat #1 is the button
Seat 1: cca00b8a ($5.9 in chips)
Seat 2: Hero ($4.95 in chips)
Seat 3: ccc2fe0 ($5.91 in chips)
Seat 4: 15b37264 ($10.3 in chips)
Seat 5: 9a343d90 ($9.75 in chips)
Seat 6: 26477ad1 ($2 in chips)
Hero: posts small blind $0.02
ccc2fe0: posts big blind $0.05
*** HOLE CARDS ***
Dealt to cca00b8a 
Dealt to Hero [4c Jc]
Dealt to ccc2fe0 
Dealt to 15b37264 
Dealt to 9a343d90 
Dealt to 26477ad1 
15b37264: raises $0.05 to $0.1
9a343d90: raises $0.25 to $0.35
26477ad1: folds
cca00b8a: folds
Hero: folds
ccc2fe0: folds
15b37264: folds
Uncalled bet ($0.25) returned to 9a343d90
*** SHOWDOWN ***
9a343d90 collected $0.26 from pot
*** SUMMARY ***
Total pot $0.27 | Rake $0.01 | Jackpot $0 | Bingo $0 | Fortune $0 | Tax $0
Seat 1: cca00b8a (button) folded before Flop (didn't bet)
Seat 2: Hero (small blind) folded before Flop
Seat 3: ccc2fe0 (big blind) folded before Flop
Seat 4: 15b37264 folded before Flop
Seat 5: 9a343d90 collected ($0.26)
Seat 6: 26477ad1 folded before Flop (didn't bet)


Poker Hand #RC3795894100: Hold'em No Limit ($0.02/$0.05) - 2025/08/10 07:55:48
Table 'RushAndCash11059360' 6-max Seat #1 is the button
Seat 1: 147849a7 ($4.69 in chips)
Seat 2: e248cbd0 ($3.31 in chips)
Seat 3: Hero ($5 in chips)
Seat 4: accb3720 ($6.22 in chips)
Seat 5: 25c3aebf ($5.17 in chips)
Seat 6: 779ef097 ($5.07 in chips)
e248cbd0: posts small blind $0.02
Hero: posts big blind $0.05
*** HOLE CARDS ***
Dealt to 147849a7 
Dealt to e248cbd0 
Dealt to Hero [Tc 3d]
Dealt to accb3720 
Dealt to 25c3aebf 
Dealt to 779ef097 
accb3720: folds
25c3aebf: raises $0.08 to $0.13
779ef097: folds
147849a7: folds
e248cbd0: folds
Hero: folds
Uncalled bet ($0.08) returned to 25c3aebf
*** SHOWDOWN ***
25c3aebf collected $0.12 from pot
*** SUMMARY ***
Total pot $0.12 | Rake $0 | Jackpot $0 | Bingo $0 | Fortune $0 | Tax $0
Seat 1: 147849a7 (button) folded before Flop (didn't bet)
Seat 2: e248cbd0 (small blind) folded before Flop
Seat 3: Hero (big blind) folded before Flop
Seat 4: accb3720 folded before Flop (didn't bet)
Seat 5: 25c3aebf collected ($0.12)
Seat 6: 779ef097 folded before Flop (didn't bet)


